00000000000000000000000000000000000000000000000000000000000000000000000000000000000000000000000000000000000000000000000000000000000000000000000000000000000000000000000000000000000000000000000000000
00000000000000000000000000000000000000000000000000000000000000000000000000000000000000000000000000000000000000000000000000000000000000000000000000000000000000000000000000000000000000000000000000000
00000000000000000000000000000000000000000000000000000000000000000000000000000000000000000000000000000000000000000000000000000000000000000000000000000000000000000000000000000000000000011000000000000
00000000000000000000000000000000000000000000000000000000000000000000000000000000000000000000000000000000000000000000000000000000000000000000000000000000000000000000000000000000000000011000000000000
00000000000000000000043330000000000000000000005555500000000000333300000000335330000003333000000000000000000000000000003333000000000000000000000000000000000003333300040000000000000500011000000000000
00000000000000000000000000000000000000000000000000000000000000000000000000000000000000000000000000000000000000000000000000000000000000000000000000000000000000000000000000000000000000011000000000000
00000000000000000200000000000000000000000000000000000000000000000000000000000000000000000000000000000000000000000000000000000000000000000000000000000000000000000000000000000000000000011000000000000
00000000000000000100000000000000000000000000000020000000000000000000000000000000000000000000000020000000000000000000200000066000000000000000000000000000000000000000000000000000000000011000000000000
00000000333000001100040000010000000000066000004555500000000003000006600055550055500000000000000066000000000000000006600000066000000000000000000000000000005000000005000000000000003300011000000000000
00000000000000011100000000010000000000066000000000000000000000000006600000000000000000000000000066000000000020000006600660066000000000000000000000010000000000000000000006600000000000011000000000000
00000000000000111100000000011000000000066000000000000000000000000006600000000000000000000000000066000000000066000006600660066000000000000000000200010000000000000000000006600000000000011000000000000
00000000000001111100002200011000220000066000000000000220000202220006600000000000022200000000000066000000000066002006600660066000002000000000000000010000022000000020200006600000000200011000000001000
11111111111111111111111111111111111111111111111111111111111111111111111111111111111110000111111111100011111111111111111111111111111100011111111110011111111111111111111111111111111111111111111111111
11111111111111111111111111111111111111111111111111111111111111111111111111111111111110000111111111100011111111111111111111111111111100011111111110011111111111111111111111111111111111111111111111111
