000000000030000000000000000000003000000000000000000200000003000000000000000030300000000000000030000003000000001000000000003000000010000000001000000330000000000001000000
000000000000000000000000000000000000000003000000000003000000030000000005000020000000000010000000000000000000030000000000000000000000000030000003000000000000033000000000
000000000000000000000000000000003000000010000001000000000000000000050000000000000000000000000000000000000030000600000030103000000000000000000001000000001100030000000500
000000000000000000000000000001000000000000001000000000030000000000000000000100000000000000000000000000000000000000000000005000000000000000050000000000000000010000000000
000000000000000000000000000000050000000000000000000000000000000000000005020000000000000000000100000000000000000000000001000000000000000000030104000000000000000000000003
000000000000000000000000000000000000000001000000000000100100000000000000000000503000000000300000100100000030000054000000300001000001000030000000000020000003000000000000
000000000000000000000000000001000100000000000000100001000000000000100036000000003000100000000030000000000033300000000000000000600000000000003300010000010003300030000000
000000000000000000000000000000000110000000000000000000000000030010000300030100000000000000000003000000000000000000000000000000100000000000000003000000010000000000000000
000330000000000000000000000000033010000000000000000000106000010000330000300000000000003000000000030000000001100000000055600000000333000010000000000000000000000000000000
000000000000000000000000000000000000000030010000000000000100000001000000010000001000010000000000000001000000000001000000000000000000000000000000000000000160000000100000
000000000000000000000000000020050000000000000000000300000000000300000300100000000000000000000000000000000000000000000000000000010000004000100000000000000000000000000000
000000000000000000000250000000000000000000050000000000000000000000600000000000300000250000000000000600000000000025000000000001000000000300000000003100000000000000000000
030000000000000000000000000003300000000000100000000010100000000030010000000000000000000000000000000000000000001400003000000300000000000000400000000000000000001000000000
033000330000000000000330000003300000000000330000000000000000000033000300000000000000330000000000003000000030000033000130000001030000300000000000000030000000003053000000
