000030000000000000000000000000000000000000030000100000000000000010000000000000000000000000000000000000001000000000000000000300000000000000002030003000000000000000003000
000000000000000000000000000000000000000000000000100000000000000000000000000030000000000000000003000000000000000000000300300000000000000000000000000000000000010000000000
000000000000000000000000000001400010000000000000000000000000000000000000000000040000000000010000000000000000000050000000000030000000005400013000000000000000000000300000
000000000000000000000000000000000000000031000000002000000200000030000000500000300000000000000000130000001000000000000004000000030000300000000000000000000000000600000100
000000000000000000000000000000010000000000000000001000006600000010000000000000000000003000066000000000000050000000000005000200000010033000000000000000000066006500000000
011101100000000000000000000000000200000000000000066000006631000310020201110110021000000006000000002000000000120320100000101001000000010000000000000500000066010000000000
000000000000000000000000000033033030000000000000133030003303000033033300100000334333000000006330003333333033303333333330000000000000033003030000000000000633035000000000
000000000000000000000000000000000000000310000000000000000000000000000100000000300000003000000000010000300000000000300000000000300300000000000100000000030000000003000000
000000000000000000000000000000000000000000600000000100000100000000000030000000100000003000030000000000000300000000000000000001000000000000000000000001000010000000000000
044000100000000000000000000000000000000000000000500000000020000000000000010000000000000000014000010003000030000300000000000000000000030000000000000000000001000000440001
000000000000000200000000000000000000000000000400100000002000100000000000010000000000000000300000000000005000000000000005000000100000002000000000000001000001001000000000
000000000000006600000000000000000000000000000000030010000000000000000000000000000000000000000000030000000000000000000000003000000010030000000000000000000000000000000000
002002020000006600000000020200000000010011200000000000006000000000000000000000001000000000000200100111610020000050030000000202100000066000030000202110603020500000120020
333333333333333333000033333300000000000000333303213333303300033000030100000000000000030000033333000000000001000000300000303033000000033330300033033000000033300333333331
