003000000000000000000000000000000000030000100050001000000300000000000000300000000000000010000000000000000000550000000000010100000006000000000000200000000403000000010001
000000000000000000000000000000000030003000000000000100000300003030000000300101000000050000000000000000000002000000000000000000005000000000000000000000000000000000000000
000000000000000000000000000003333200006000300200000000000000000000300000002030203000003310300000000000000000000000000000000050000000000030000000000000002000000000033000
000000000000000000000000000000003010000300000300000000033000000000000001003210000000000030000000000000303300010000000000300330000000013000000000001300000033000010000300
000000000000000000000000000000033000000000040001001100000000010006000000000000003000000333000004003000000000000000000000000001000000000000000000000000000000000010003630
000000000000000000000011111100003000000000000000001111110000000000100000000000060100005030000010000000000000000000000000501200011101100000000001102003000000000000000300
000000000000000000000000000030300330050000033533300000000033333010400003050013001033303033303001330000000000000000030500310020000000000303333330300000000000303300033031
000000000000000000000000000000000000000000000000000000000000000000000000000000030000035000000306000000000000000000000000000010000000000100000000000000000000000000000000
000000000000000000000000000000000000050000000000000000100000006100000000003000000000000000000000000100000000000000000003000000000000000000000000000000000000000000000000
003330000002000000000000000000002000000000000000000000000006001003331000000000010000000000100300000000000000000000330000000000050000000001000000005000001000001000030200
000030000003333300000000000000603330000000000000033000000000000006130000000000003000005000000000003000000030000000003000000000000000000100000000000000000000000000000330
000333000000000000000000000000000100000000000000000000000000000000333000100000000000000000000000000000003000000060003300000000000000001000060000000000000000000000000600
000030000000000000000000000200040000000000000000000003000000000000030001110100000000011110102000000003001000000000000000004102000000000000000115111000013000000000000000
303333303000000033333333033300001303000000000000000033330000000300330000000000000100030000000010000000600303333330333333000330000000000000000100000300000000100000300000
