000000000000000000000000000300000060000000000100000000000000000000000003000000000003001000000000000000000000001000000000000000000000300000000000000000000030000030040000
000000000000000000000000000000100000000000000000001000000000000000000000320100003000000000000100000233000000000000000000000000000000000000000000000000003000000500000000
000000000000000000000000000030000000000000000000000601000000000000000000000000000000000000300000003010000000000000000000000000000001030000000030000000000000000003006000
000000000000000000000000000030000000000000000000100000330006063000000000000000000000000003300000003000000000005104000000000400000000030000000000000000000000000000500000
000000000000000000000000000030000300000003000050000033300003003000000000000000000005000003300000003000000031000000040000000000000000100010330300000000000000000003000031
000000000400000000000000000030000300000000000003000000330000033000000000000000000000000030000400003000000000000000400000000000000000010000300005000000000000000003000030
000000000000000000000000000030000333030333333303030303033310333333333300000000003000033330300000000100303333333300000000030000060000030003010660333000000000000003000303
000000000000000000000000000010000010000000010330000000000000000000000300000000000000000000000001000000000000000000000000000305000000100000100000000000000000000000000030
000000000000000000000000000000000000000000030000300000010010000000300010001000000000010000000000000003100000000020000030000000000000010000003000000000000000000000000300
000000000000000000003300000000010000030000000000000000000000030000300000300003000000000600000000000000000000000000000000004003000000000000000300000000010000000000000006
000000000000000000033300000000000000000000000000000300000200000000000000000000000000010000000000000000001000010003000100000005500000000015005000000000000003000300000033
000000000000000000333300003020000000000000000000000054000000000000003100000003002030000300000001000000000000000000000000000333000000000000003100000000000030050000000333
000000000000000003333300003000000000500000204000000000006040030000000000010003000000000010000000000000000000000000000000000303004000000000000000000000000000000000000333
333333333333333333333300033300100000000000000000000000000001000000000033333333000330333303300000000000360000000003333303333333000000033050320000000000030033030300100303
