000000000000000000000000000300006003333330060000300000000501010000000000000000030000333031003003000001000100010000000030040033333311000000000003010000000000000000003003
000000000000000000000000000300000030000000001000300005000000310000000030032000000000000000000000000000003001000000300000000000000003000000000000000000000000000000000003
000000000000000000000000000000000000000000000000000000300004000000000000000000000030033000000000000000030030000000300000000000000000000000000000031001000000000000000000
000000000000000000000000000000000000020000000000000000000000000000000030000000000000000000000000000000000000000000000000000002002000000003000500000100000000000000000000
000000000000002000000000000020000000300100005000000000000000000000000000000002000000000000020000000000001600010000000000000000000300000000000000000000000320000000000000
000000000000000000000000000000003000000000010003001000000100300000000000000100000000000000000000010000001001000000003010300000000000000000000000000000000000000000000000
000000000000000000005500000000600000000000500000600005000003331000000000301000000005000000003000155000000000330300420000000000000000000001000010401000333303000055000000
000000000000333333330000000000000000000000000303000000500000300333333000000130001003000000300000330000100000500000000030000000000000000003000301010333330051001030000000
000000000000000000000000000000000300000000000000100000000000000000000000000000000000000000000000000000000000000000003000000000300000000001000000500000000300003000000000
000000000000000000000000000000000000030300001300000000000030000000000001000000000003000000000000000003000000000000000000000000000000000000400000030000000000000000006000
000000000000000020000000000000000003000000010050000000000000000000000000000000303010000000001000000003000010000000006000500000000000000000000000000032000000000000000001
000000000000000000000000000000001000000000000000000000000010000000000000000000110000000000000100000000000000000000000000000000000000020000000000000000000050000000000000
000030303000000000000000000000003030100001030001000004000000303000003000000000000000000300003000030000000000030300001000000000000000000000000000003000000003000000001000
000000000000000000000000333300000000003303000000000001006000000000000030000000003000000000000160000000000000010000300000003333000000000000050000000000000000000000000000
