000000000000000000000000000000000000001000000303000000000000000000000000000000000000300000030000000000000500000030000000000200300000000000000000000510000000000000000000
000000000000000000000000000000000000500000300000000303000000000000000000000030000000304000000300000300000003000030330000000000000000300000000300003000000000000000000000
000000000000000000000000000030100000000500300000130003020000000000000034000130000000003030000060000000000000000000000000000000000000300330000000033000000000330100000002
000000000000000000000000000003333000000000000000000000660300066000000000003030010000300000000000000000010000000006000000000000000003303033000000333000400003333000030066
000000000000000000000000000003331000000000300006000000600000066000000001200300000000100000000020010000000000000030100003010000000033303333000000330000000003333000001060
000000000000000000000000000003333000000000300000001000660000066000000000333333000000340000000000000000000000000030000003000000000330313163000033333000000003333330050066
000000000000000000000000000033333000000000353333330333433113330000000030333330003000303330300000000000002300000003303000030000303333330333033030333000000003033030033003
000000000000003000000000000000003000000005000000102030003000000000000000000300000000000000000000000000000000000100000000000600000000000000000001000300030000000000000000
000000000000033000000000000000000330000000000000500000003000000100500001000030000006000003001000000000300000000000103000060000000000000000000000000000000000000000000010
003300000000333000000000000200000330060000003000000000000000000001000101000500033000010003300000020030010000000000000000000000000000000000000000000300100010000000000000
033330000003333000000000006603000330000000000000000060003000000000000000030000333600000030300000660330300000000000500000000000050001000000660000000000030000000000000010
033330000003333000000000006600003300000000000050000000103000000000000000000000033300410003301000000331300000000000000000100030000000000000660000010300000000000000000000
033330000333333000000000006600310300100000000100000000003000005001000330000001330300000300000000060033300001000000000600030000000000000000060000000300000060000000000000
333333333333333333333333333303303000000000000000053000003013303000000000000003333033333333303303130330302000000000000000000000000000033330300001002333330300000001000000
