000000000000000000000030303300000000000000000000000003000000030300000050000000000000031300300300050000000000000000000000000030000000000000000000000000000000003006000000
000000000000000000000000000330000000000000000000100000000000000010030000000660000000300000300010000000000000100000000000005000000000000000000000010000000000000000000000
000000000000000000000000000005000010000000000333300000000004000000000001000000003000000000033000000000000000060000000003300000000333300000000000000000000000000000100300
000000000000000000000000000000000000030000000000000000000000000000000300000000010060000013000005060000000000000000400000004000010000000000000010000000000010000000000000
000000000000000000000055500500000003000000000000000000000040000000000030000300000000055000500000000100000300000030000000000000000300000000003000000001000006000000000000
000000000110000000200033000000001060000200000000000000110000000000000012230000001000033000000000000011000122000000003000000000000001000110201220000000100000001000000000
000000000000000000000000000000000000000050303103300000000000000000000025030300010000000000033033000000000333333000300003333300600300300000000333333000000003030003000003
000000000000000000000000000000000000000000000000003030300001000000000003030030000000000000000000000000000000060003003330000000030003000000000000010000041003030030000000
000000000000000000000000000000000000000003001000000000030000000000000000000000000000100000000000000003000000000000001030000130000000000000000000000000000000000030000000
000000000033333300000000000030000000000000001000000000600300000000333300000000000000000000000003000003313000000000000003000000000000000000000030000000000000000000000000
000000000000000000000000000000000000000000000100000010000000000000000000000000000000100000000000000000500000000000005500000000003000000000000000000000030000000000000300
300000000000000000000000000010000000000000300000005550050010050000010005503050001000000000000000300000000101000005550000000040000030030060000000000000030000500000010000
122000000000000000000000000030000000011000122000003300000000000003000003000000000000000020000000000100000000030013100000000000000000012200000000000001000003300000000200
333333330300033333300000000033003000000000033300300010003033300303000300000000000000000000000000003030030000000000000600000000000000034303330000000000000000000000001000
