000000000000000000000000000000013000003000000000000000000000000000000000000000010000213000000000010000004000100000001000000000000001000000000000000010001010003000000000
000000000000000000000000000000000100000000000000000000000000000000006000000003000000000000000100000000000330000005000001000000000020000000000000000000000300000000010000
000000000000000000000000000000000000000000010000000000000000100000000000100100000150000010000500000200000000000000000000000000000000000000000000000000000000000000000000
000000000000000000000000000000000000020000000300000000000000000003000000000000002000002040000063000000100000001000000000000010002010000020000000000500000000000000100300
500000000000000000000000000000000000000001000000150000005000000001000000000300066001000000200600005000000000000000000000100000000300200660100000000000000060000000000002
000000000000000000000000000000000000302026000000030000000000000000020000060002060000000202620160000000000004000003000020000000000202030660000000200000010000000000000020
000000000000000000000000000000303331300003000000000050000000000300333300333333030003333333333033330000000010000033330330000000333003333300003033630003133300100003303333
000000000000000000000000000060000030030001000000000000001000000000000000000000000000000000000005000000000600000300000001000000000000000000000000000000500000030000010000
000000000000000000000000000030000300003000003300000000000000200000000000000000000300400010000000000000000060000000000000000000310000000000000100000000000000000040000000
000000000000000000000000000000000000000000200000600000000100003000000000000000000030000000000100000000000010000000000000000000000000200000100000001000100000010050000000
000000000020000000000002000000000000000003000250000000000300000001000000200000010000300010000000000000000000000000000000000000200003000530000000000000000000020000000000
000000000660000000000000000200000000300000106600000000000000000000000400100030200103030000000100000000000100000050000000000000000000000100000000000000000000660001000303
000020220660000000000000202630000000000000200000000002000000000000000000020260000000000020200000000000000003000006000000000020000000000000000000000000000020660030030000
333333333333330033333333333300000000000000333333333330330000000000000033303330010000333303000000010033133000000004000040000000003033300000000000000000000030030330000000
