000000000000000000000000000000000000000000000000040000010000000000000030000000000000000000000000000300000000000000000000000000000000000000000000100006000000003010000000
000000000000000000000000000000000000001000000000100000000000000000000000000000000000000000000000000000010000000000000315000000000000005000300000000000000000000050000000
000000000000000000000000000000010500001001000000000040400000000000444000000000002004000000000013000000000100230001020000000000000000000010000030000000200000000000000440
000000000000000000000000000000020000066000000000000000000000000000005030000100006000000000000000000000010006600000660000000000000300100000000002000006600000000000000000
000000000000000000000000000030600000066000000000000000000000003000000000630000060000000000000050006000000001600000660016050000006600000000000000000500600000110000000000
000000000000000000000000000000660200066020000000010022000000000000220060160200060000000000000000000000000006000000660000000030000602000030000063020005602000000000002200
000000000000000000000000000000333333300333000010030335000000000330333333100040033633000000010000000003001333330330330030000100333303000100003133033330003010000003303033
000000000000000000000000000000000000000000000000000000300000000100000000000000003000000000000000000000000000000001000000400000130003100000000100000000000000000000000000
000000000000000000000000000000000030004000010003010000000000001000000000050000030000000000100000000000001000000000000000000000000000000000000000000000501000000300000000
000444000020000000000000200400000000000000000001400000000000000000200000000000000000000440000000000000000000200400044400002204000001000000000000000031200000000000000000
000000000660000002000006600000000000000003000600003000000000001006000005000000000003000000000025000300000006600000000030066000000000000000000000000006600000000000000000
000000000660000066000006600030300000000000006600000000600000000006600000000000000000000000000660000000300006603000000000006003100000000005000000000136001000000000000000
000220000660200066020006600000000000000200006000000000000003000026002000003000000000000220000600200000000100600000022000066000000000000000000010000306610000000000000000
333333333333333333333003333330000000000000043333300030002500000033003300000000001000303333333301330000000013033333330330003303000000000030000000001003333300000000003000
