000000000000000000000000000000003000000000000000000000000020000000000000000000001000000000000000000000010000000003000000100000060000100000000000000000000000000000000031
000000003000000000000000000002001020050011000000000000000300000000000000000000000600030006102000000000000030000000000000000010000000000000000300000000003000000000000000
000000000000000000000000000016300003000000010300000050000000000000020000000000000000000000046200000000200000000000002000000000000000000000000000000000003000002000000000
000000000000000000000000000060000000000300000000000100000000000000660010600000100000000000016000000006610000000000066000000000100000000000000000000000000000066000030000
000000000000000000000000000066000100000000010100000000000000000000060000000000000000030003066000000006660000000000066000010100300100000000000040000000000000046000000000
000000000000000000000000000066000000050000000030000000100000000200660002003000000000000050066050002006600000000000066000000000060000000002000000000001000000366000005000
000000000000000000000000000033333001353333333030300000000000000333350300600003133303000000103333000333333020000003331303003303000000003330330000300333300330033330000000
000000000000000000000000000010000000001300000000003000000000000000000000000000000000000000000000050000000000000000000000000000004000000000050000002000000000000000001000
000000000000000000000020000003000000000000100010000001010300000000003030000000200003000000000002000000000000000000000000000031000006002000000000000000000000000000000003
000000000002000000000660000000000300000010000020000000003100000000000000000000600002000000000000000000000000002000000000000010030000016005006600000000600000000000003010
000000000066000000000660000000003000000000000600000000000011010110000030000006600300000000000000001000000000300000100000000000000000060000006600000000000000004000000000
000000000066000000000660000000000000003000000660000000000000000000000000000006600000000000003000000100000000000000000000000000010000006300006600000030100000000000000000
000020020066000000000660000000000000000000200660000000000000600000030000002006600103000000050060500003000030026010530000050000340000060000006600000000024000000000000000
333333333333333333303333330000000000000030033336300000100010000001050033333330033300333300300000000003000333030000000000001000000010033333000333301030333000001000000010
