000000000000000000000000000000000000000000000000000000000000000000000100000000000000000000000000000000000000000000000000000000000000000000000000000000003000000000000000
000000000000000000000000000000000000000003000000000000000000000500000000000000000003000000000000050000000000000600005000201000000000300300000000000000000000003000000000
300000000000000000000000000000000000000003000000030000013300000000000000000000000000000000000000000400000300000000001000010000300000030300000000003000004000000200000000
000000000000000000000000000000000103001330000000000000003000000000000010000000000300020000000000000000000000600002500000000006001334300000003030000050000000000000000000
000000000000000000000000000000000000001300000000000000003000000000000000000000000200661000110030303000010000000000000000000001000030300000000000000060000000000000000000
000000000000000000000000000000000000003330000000200030003000030030000000000000100000060300000000000000005000000160000000000000030303300300010000003660003030000000000000
000000000000000000000000000000000003333333333333030000603333333000000000000000333303033333300000000000000000000033313000000000303334300000300000010333333300000000000003
000000000000000000000300000000000003000000000010000000020100000000000000000000100000300000000000000000010000400000000000000301010000000000000000100000000000000003000000
000000000000000000003300000000000003000000000000000000500000000000000000300000000001300000330000000000003030000000001000000000000000000000000000000000100000000000000000
000000000000000000003300000000000003000000000050100000000000000000000030000000000000300000000000000000003000000100000000000000000030030000003000000000000030000030000000
020000000000000003333300000002000003600000100000000000300000000000303300000000010333330000000000000003310003000000000050000000000000030000000000000000000000030300000000
660000000000000003333300000010000603000000000000000000006601000000313300000000000000300000000030000000303003000000000000030000000300030000300000000000000000000030000000
660000000000020003333300003060000000000030000000000000000600000000303000000000000100300003000000000063303000000206060000000102000000030000000000003000300010033330000030
333333333333333333333333333303333030333333000000000000003033303333333300000001000000330033300000003033333033330300000003333330000000013133330000000334300133033333330333
