000000000000000000000000000000000000000000000000000000060000000000000000003003000000000000000000000000000103000000000000000000000000000000000000000000000000000000000000
000000000000000000000000000010003000000000000000030000000003000000000006000000040000000000000000600000500300000020000000000000000000001000000300000000000000000000000040
000000000000000000000000000000000400003102000000000000000000000000000000000000003000300600000320000464440000000000000000000002000200000000000000000000000200020030000000
000000000000000000000000000010000001060060002000000010003000000000000000500000000030100100000460000000600000100000000000000366006630003000000300000003006600610000000000
000500000000000000000000000000000000605366000000003000020000005000030000000000005000300000000660000013000000000000000001100006000600000050000000000030006303600000040010
000000000000000000000000000000000000006066030000000000000000000101000000000000033000000000600060200000000000000100000005061036206002000000000000000000206620600000000000
000000000000000000000000005533003335033003000000300000000030000000305500000330000000010000031330303030030000000002000303333333003333000000000000055233333333333300000030
000000000000000000000000000000000000000000000000000000000000050000000000000000000000000000000000000000100000000000000000000000000000040000000000000010000000000000000000
000000000000000000000000000000301003000300030000000000010000000100000000600000000000000000010000000000000000000000300000000160000000000060000000000000000000001000000020
000444000000020002000000000000010002002000000000000000000000002000000000034000002000000000000003000000002000000000034401000100000000000000050000000000044000000000000000
000000000000660066000000000000000003066000010000000000000000000000020000000000060000000000000000003000066000100000000000000000000010000000000000000000000000031000030000
000000000000660066000000000000000100066010000500000000000000066000001000000000006001000000000100000000330000000000000000000000000000003000010001000000000030050000000000
000000000020662066020000000000000001060020000000000000000000066000000000000002066021010000030000006000066000000000000000000000000000000000000000000000000000000000300000
333333333333333333330000003300000000333030000000000000333036300000000031333303333330130000000000053333300000003333301030000000000010010000500000000033033300000000000000
