000000000000003000000000303330000000000033000310000303300300000003333300030030000010000000000000000001000000300300100330000000003333330000003000000000000000000000031000
000000000001000000000000003000000000000000000000000000000000003000000000000000000100000002000001010000000003000000030000000000001000000000000000000000002000000003000000
000000000000000000055000000000000550000020000100000062000000000000030000601000003005300000000000000000000000030000000000000000000000000010550100050300000000400002000000
000000000000000000033000000000000300000300000000000000303000000000000000000000000003000000000000001030005000000000010000000000300000000000130000003000000000000000000000
000002000000000000000000333000000000000330000005001000000003330000000000030346001000000000300000000053300000100000033300000000000000040000000000000000000000000200006000
333300033333000000000030000000000003330000000033000000000000000000300001000000000000000000033330000000000500000003000003333000030000000300000000001000010013330030000030
000000000000000000000000000000000000400010000300300000010000000000030000060000000000000000000000010000100000000000000000010000000000000000000100000000000000000000100300
000000000000000033333003330000000000030000000000000000000000000000000000000003033000000000000303000003033300000600033000300000000000000000000003033000333330500010000000
000002000000000000000000000000000000000100000106003000000000020001000040003000000030000000003000000000030000000000000000000426000010000300000000030000500013100000000100
300000000000000000300000000000000000000000330000000000003000000004000000000000000000000000000300000000000000004500000003000000000513000030003000000000000000000000010010
000000000000000000000000000003000005000000000000000000000000002000000000000000000000000000000000000000000000003300000000000000000000000000001000000000000100100002000000
000000000033300000000000005030033300010000000000000000000000000001002000000003000050100002400000000003330000000000003300100000000000000033300003330000000000033300600000
000000000000000000000000033300000000033000000000003330000000000333300233330000000303303300000003030300000000000000003330000000333330300000000300003000000000001003303300
000000000000000000000000000000000000000000000000130000000000000000003000000000001000000000000000000000000000000000000000000000000000000300000050000003001005000000000000
