000300000000000000000000000000000030000000000000100000000000000000000000000000000000000000000000000000010000000000001000000000000000000000000030000000000000000010000001
000000000000000000000000000000000000000000000000000003000000000000000000000000000000000000600000100030000120000000000000000000020000000000000000000000003000000000000000
000000000000000000000000000000005003111000011110000005003300000000000000000000131100000000000031003010000330000600000000000000330000000000000310000010000001311000000003
000000000000000000000000000000100000000000000000000000003300000000000000000000000000000000000000030000000330001000000001000000333000000600003000000000000000000000000000
000000000000000000000000000010001000000000000000000000003300000000000000000000103300000000003005010000001330000040000000300000330030000003000000000000340060000000000000
000000000000000000000011110000000000000000000000000000003300000100000010000000000000000010000000050000000300000000000000000000130000003000300000003110000000000000000003
000000000000000000000000000040000003303300333333330000000030303300000600000003033030000000000016133330333303333040000000103000033313300000003310333000000005130000000000
000000000000000000000000000000003000010000000300300000000000001040000000030000010020100000000030000000000000000000030000110000000000000000000000000000000200000060000000
000000000000000200000000000003000000000000020000000000000100050000000000000003000000001000000000000000000000000000030000000000100030000000000200000000000030000040000000
331100000000003300000011110000000000000200330000000000000300000000000000000030311000000000000000000000000000000300100000101300331000000000003100000000000000000013000000
000000000000003300000000000000000000000000330000500000050000000130000003000000000006000000000000000100000000000000000000001000000000000003003300000000000000300000030000
000000000000003300000000000000000003000000330000000010000000000000000000003000060000000000000000000000000000100000003000000000000000004000003300000000000000000000000000
000000000000003300000000000001011000000000330000000000000100100000000000000000000000010000000000000110100000000000300000000000000000001011003000000000000000000000000000
333333330000003333333333333300000000000000303303300000000000000100000000000003300033000060000000000000600000000001000003333333330330300000003330333000000006000023050000
