000000000000000000000000000000300000000500000000000000000000010001000000000003000000000000000000000000000003000000000000000000000005003000000000000000000000000000010000
000000000000000000000000000000000000010000000000003000300000000100000000030000000000000003000000000000040000000040000300010000000000000010000000000000003000000010000006
000000000000000000000000000000000030000000000200000000000000000000000000000000000010100100000000000000000000000000020000000100000003000000000000000000000000000000000000
000000000000000000000000000000000100000060000200000000000020000060000010100000000000000200000200030000000000000100320000020000000030000000000000010001000000000000000000
500000000000000000000000000005000000000000003020000000000000000400006000000001000000000000000000000000000000000000000000000000001000000000000030003000000100000000010000
000000000000000000000000000000000000200200002200000000000000003000000002002000000020202200110000030200000000000020220001000000000000000100220000100300000000000001000000
000000000000000000000000005500000550333330333333300000001330033000000063303030303033333330330000330033330000000033333303330334000000003330330000000000105030033330010000
000000000000000000000000000000300000200010000010000000010000001000000000000000000000000000000100000000030000300000601000000000000000000000000000000000000000100001000000
000000000000000000000000000000000000000010010000000000000000001000000000006000000000000000000000003000000000000000000000000030000000030000000000030000000000000000020000
000000000020000000000000000000000000000000000000000000010002000020000300000000000000000000000000100000050000000000000000000000000600002000001000000000000000000000000000
000000000020000000000002000000000000000000100000000200000002000000100000300000000001000006000000000003000000000000000000000000000030000004000000000000000003000000000000
000000000000000000000000000050000000000000010000000000000030000005000000000005000000500000000000000000030000100051000000000000000000000000010000000500000000000060000000
020020020220000000022000000300000000000000000000201000002022000000000010000000000000000000000000003000000000100200000003200200130003600300002002003000001002102000000002
333333333333333333333333333300000000000000303303103333013330033000000300000550000600000000000031100010055333333300000003333333000000500300013030333000000033333330313333
