000000000000000000003000000300000000000010006300000000000000000000000000000000000003000000300000000500000000000000000002000000000000000030000400000000000000003000000000
000000000000000000003000000000000000000000000000000000000003000000000000000000000003055400000100003306000000000006000006300003000030000000000030000000000003600000000000
000000000000000000000000000000000000000000000300000030300000300000000000000300005000000000000033300000000000000000000010000000000300000000000360000000000000000000000000
000000000000000000000000000000000000000000000000330000000003000000000000000000000003000000033000200000003010020000000001000000000000000000000000000000003000000033000000
000000000000050000000000030000000050500000000000000100600000000000500003003000000300000030000000600000001000000000000000013000000000000001050000000000000000010000000000
300050000033355000000000044000033150000000300050000000001003005300050000034400000000000043000000000000000300550300000005000300300000300033350000000000000000600003000530
000000000000000000000000000000000000000000000000000000030000010000000000300000000000000000000010000000001000000000000000010100000000000000000600000000000005000000100000
000000000000000000000000000000010000000000000000100000030001000000000000060000000000000010300000000006000000010000000003100000000000000000000000000000005300000030010000
033000000000033300000000000000000000100000000000033000000000000000000033000000130000000000333300001000000000000000000000000003000000033000000000000000000000000030100000
000000000000000000000000333010030000000000000000000006003000030000000000600000000003300000000000200000000000100000000000000000000303000030000003000000000001000000000030
000000000000000000003330000000120000000000000001000300033300000001000000000030033000001000000000000000000630000000000300000600330000000000033300003001000000000060000000
000000000000000000000000000000000003000000000000000000000030000000000300000030000000000003001000000000000010000530003000000000060000000000000000000000050000000003000001
000000000000000000000000000050000000050000000044100000000000000000001003000000100400500000000005000030000000330500000403000000000000000000000035000003000002000000003300
000000000000000000000000000000000030000000310000000000030010000000000000000000006002000000000000000000000000000100060000030000000030000610000000000000000010050000010000
