000000000000000000000000000000003020000000001000000300000000000100000000000000000010000000003000301000000000001000000010000000300001000000000000000000000000000000100000
000000000000000000000000000000000000030000000000000000000010000000000033000000000000000010310000000000000000000000000000000000000000000000000000000000000030000100000000
000000000000000000000000000000000000000000003000010000000000044400000000001000000000030000000000000000000400050000300000000000400000001000000000000000000000000000000041
000000002000200000000000000002000000000000010002000000000103000000000000000000000000000000130030200000000000000000000006000100000000000000000300030030000001000000001000
000000003333030000000000000003303030000000000000000000000300000000000500000000030000000000000100000010000000030000000000000000000001000000000000060000000000000000000000
000000000000000000000000000000000000030000300000000000002000060000020200000000000000005060000000000004000000020200000000001000000020200300011000000000600000000000000000
000000000000000000000000000000300000000000030533333330353033303033003300000000000000000010033300330000000335333330000000000000033330303333300000000001303300000003033043
000000000000100000000000000000000002330000000001003000000000000000000000000000000000000000000100300050000000000000000000000000000050000003000100310000000000000301001000
000000000000000000000000000000000000000020000000000000040000000000001000000000000001000000000000000000000000000000000000003000003000000000000000000000000000000000000000
000004440000000000000000000000000000000010000000000000430000000000000100000000000000003000000000000300044000301100005000005044000000000000004000000000000000000000000003
000000000000000000000000002000000000000060600000000100004000000000000002300200000000000000002000200000003000000000000000001000020002003000200000000000000000000000200020
000000000000000000000000000000000000000030000000001000000000000005000003000030001000000000003013100000000100006300300000000000033330300300000000000000000010060000333303
000000000002020000000000000000000000000000000020200000001000000010000000005000530010000000000001000000030000000000300000000000000000000000005000202000000000100000000000
333333333333333333333333333300000000000000033333033305030333333333333300000100000000330303300000003033303000000000000003363333000000033300330033001333333300000000000000
