000000000000000000000000000060000000000000000000300000000000003300006000000003000000000403000000000000010000003010000013000000210000005000300000001000600000000000001000
000000000000000000000000000033000000000000003003300000000001033310000000000000016000000000010000000000001030303300000000000000300000001000000000000005000000000000000000
000000000000000000000000000033000000000000000030300000000000033000000000000000000000000000000030030500000000003300010000000000330000002000000000000020000000000000000000
000000000000000000000000000033000000000050003033300000000033333030000060020030000000003000000030000000000003330011000030000000330000066000000000000660003000000000000000
000000000000000000000000000033000103000000033303300030000333333300300060000006000005000000000000000000000033330300000000000000330000010000000000000663000000000000000010
000000000000000000000330000033000000100100343333000300133303331030000160020000000000330000030000000010000033333300000000030000030100130020000000000660231000000000000000
000000000000000000003330000013133330100003333010300030033033300330030003303500030030330000000303030000000330353300000100000300033333033333300000003633133000303300000000
000000000000000000033300000000000001000000400000000000000023000030000100000000000000000100030000000000000001000000000000003000000000000000130034003000000030000000000000
000000000000000000333330000000000000000000000100000000005000010000000000005010001000000030033000000000000000000000000000000000000300000003030000001300000033000000000000
020000000000000000333330000010001000000000320000000000000000000000000000000000010000000000003000000000000030413000000000005000000000000003330000330000000030000400001000
660000000000000033333330000060000000000000660000000000000000000000000000000000000000000000333000000000060660000000000000000000000000000333330333103001000010000000100000
660000000000000333333330000000600000000000600000000000000000000000000000000000000000005100033030000000000100000000040000030000000100000333330303333000000030000000000300
660200000000003333333330000000000000000000660200033000000000000000000000000003330000000000033000300000000660000030000000000000000000033333333333303000001003000403000006
333333000333333333333333333300000000000000333133033000000003000000000300000003300000000000433330330000000330303013000000113333000000003030003033000000000033333303001000
