000000000000000000000000000000000000000000003000000000000000000000000000000100000000000000000100000000000300000000000000000000000000000020000000030003000030000000000000
000000000000000000000000000010000000000000000000000000000000000000000000000000000000000003000000000101000000000011000000001000030000100003000100000000000000000000000000
000000000000000000000000000005000001000000001000000000000100000000000000000001030500000000032000000003000000000030000000000200000000001000000000000000010000000000100000
000000000000000000000000000000000000000000000000000000000000000000000000000000000000000000060000023003000000000000000000030300000300000000000000000000000140000001000010
000000000000000000000000000000000030000000000000050000050000030000000300000033000000010000066000000000000000000000000000000003000001000000000310300000000000100000000000
000011100000000000000000000000010060000000000000000000200000000000001600000000202000000000013000000000000000010000000000000006600000000000110000510000000000000000000006
000000000000000000000000000033033303333503100300000010000000000033333006030000333003000000003000300003000000000000000003033330000030000000020000000000000030000003303330
000000000000000000000000000000000000000000001001000000000000000000000000000000000000000000000000000000004000000000000000000000000000000000000000000000000000000000060000
000000000000000000000000000000000300000000000000000010000000000001000000000000030000010000003000000000000000000000000000000000001000000000000000000003000030000000000000
010011110000000200000000000002000000000000000000001001100000000010311120000000000000000000000003000100111000000060000001000000051000001002011000000000000001001110000000
000000000000006600002000000060000020000000000000060000006600002000000000000000100003000000000000000000010000000006000020000000000000063000000000000030050000100006600002
000000000000006600000000000306000000000000000000300006006530001100000000000001000000000000300000000000010000000300000000000000000000000000600000000000000103000006600000
000000002020006600000000000660000000000000005010000000006600000000000000001000000000030000000531110000000020200066000030212003000000000000000203000000000000000003603000
333333333333033330033333333333300300000000000000033033033330003333303000000000000600303303300300023333334333330033000303313303000000030330303333303000000033333316300033
