000000000000000000030000000020000000000001000003001000000000000000000033333510000000000000033013000500000000000001000000000000303335000000300000000000000000000330000000
000000000000000000000000000000000000010000000006003000000030510000001000000000000004000000500000000006000300000000000000000005300000000000000000005000000000000000303000
000000000000000000000000000000000000000004000000030000000000000000000000024000000000000000000024000000000000000000000000000000010240300000000000000000100000000000000000
000000000000000000000000000000010003000000000000000000000000000000000000500000000000000000000000501001020000001000000000000000000000000000300000001000000500100000000000
000000000000000000000000000000000300000000001000000000000000000000000000000000003000000000030006000000000000300000000001000000000000101000000000000030000000000000000000
300000000000000000000000011100020003201000300000004033030300001000000000000400000000000000000000003000000000011101001010000000000000030005003000000303000100000000000000
000000000000000000000000000000000000000000000300000000100003000000000000000033333336030333000000030000000000000000000000333333000000303000003333333000000000001000000001
000000000000333333350000000033330000000000000000000000300000030000030000000001010000000003000006000000033001600000002000000003000003000110000000000000000000000003333350
000000000000000000000000000530000000000000000000500050000000000001000000000000000000000000000000000000000000000300000000303000000000200000000000000303000000000000000004
300000000000000002400000000000114000000000000000010000000003000000000000000003000000000000030000000000000000000030000000000000000000000000000000000000000000025000002000
000000000000000000000000000000000000000000000003000000010000100030000000000000100000000000001000200000001000000000050000030000000010000000000000000001000003000000000000
000000000000000000000000000000000200000000000000000000000060000000000000000000000000000000000000000000000000000300300000030000000000000000000000003000000000000000030000
003333330000000000000000000000050000000111000000000300000000000000310000000000003300000200000333335000000030000000000330000000000030030000000032300000000000000110000000
000000000000000000003333333350000000000000333300300010000300000010000000300000000000000030100000000000000000000000000000000000000030000000060000000003000000000000020003
