300000000000000000000000000000000000000000000000000000000000100000030000000000000100000000000001000000000001030000000000000000000000000000000000000000000000000000000000
000000000000000000000000000000000000300010000000000000002000000000000000000000000000000000000000002000000000000000000000001000000000010000000000000000000000000002000000
000000000000000000000000000000033000000000011000000202000000000000000000033000000000000000000000000000060000000000220000000000000000001100000010200005000000000000000300
000000000000000000000000000000313000000000000000000010030003300000000000333303000000300100000000000000000010000000003000000000330000000043330000330000000000001000000330
000000000000000000000000000033033000060000000000000000001000000000100033033000000000000000000000000000000001000000000000000000000040000000000100000000000000000103333300
000000000003300000000011111100003000001110001001000000010100033000030000001000000000001011100101300000000000010001110110000000000000000000000000000030033000030000000300
000000000000000555000000000000313330000030333333330530000050000000000500333300303303000000000000000000100055500000000036555000130331303000003000000000000005550003333033
000000000000000000000000000000000000000000300000000000000000001000100033000001600000000000005000010001000000000000000000000000000000030000000000500000000030000000000000
000000000000000000000000000003000000000300010000000000000000000001010000000000000000000300000000000100000000000000000000000000000000000050000010000000010006000000000003
000330000002000000000011000000000000003100000000000000400000000010000000000000000210011000000500000003301000020401300000003300000000000000000130000000000000000000000000
003330000003333300000000000000000003300000000000010000000000000000000000010000000333000300000000000033300050333300000000000000300001000000100000000000010040000000000001
333330000000000000000000000000000000000000000000000000000000000000000000000000000000000000000000003330300000000100000003333301000003003003040000500000000000000000000000
000030000000000000000000000000000000100000000006000100000000100000100000000000000000010301000030000000000000000001000000000010010003000000000000000300111000000000000000
333333333000000333333333333300000000303331000000005550000552000333330300000000000000033036303333303033330000000032303333303330000000030000003333330000000003000000003333
