000003000000000000000000003000000000200000203000000033330000030000100033333301000000330000600000000000000000000000000000000600333303300000000331305000003000000003333033
000000000000000000000000000100000000000000000000000000000000000001030000200000030000000001001100030000300100003000000010000000000030000000310000000000000000000000000000
000066000000000000000000000030000000100000000000000000500000000100001001000003000500300000000000000000000000000000000000010000000000000000000000000000066000000003000000
000063000000000000000000000000000000000000000000000000000200000000030000000000000000000000000000000301000000000000000000000000300001100000000000000000063000000000000000
000066000000552000000000055000000030000055360000030000000000055000000000100000000000002020330000003050000000005000030003000000000000000005500010000000063020100000000100
330033330003330000000000033000000103000336060000000000003000303030001000003000000000000000300003030000000000333100000000000000000010000000300000000330030300000000000000
000000000000000000200050000000000000000000000000000000330000000000020000300030000000000000000000000000030000000000002000001030000003005000100333310000000000012130000001
300000000000003333333333330000000300000000000003003030200000000030003000000003533000333333300050001333300000003000000000001030003330030300000000000000000030000000000000
000000000000000000000000000000000000000000000000060003000003010000000000000300000000100000000000000000000006000100000000000000000000000000000003000010000100000000000000
300000000000000000000000000000000600000000000600000000000130000000000000006600000250000000003006600000000000000000060101000610000000010000000000000000000030000000500000
000000000000000000000000000001006000000100000500000000000000000000000000036300000000000000100000301000000000000010000000000630000000000000000100000000630000300000000000
000000330000000000000000000000106602000000000055000000003000000000055000006660000000103000000006600000000000050000000553000660000000000000030000055030055000000033000010
000000000000000000000000000033403030000035000030000000000000000000033060000330000000000000003003330000000000003030103334300033000000000000013000300000003000003030000000
000000000000000000033333333300100001000200650000003330030000000030000600000003333330000020300000003333130030031000000000100000303033000100000060010053000000000000000000
