000000000000000000000000000000000003000000000000000000100000100010300000000000003000000000050000300000000000000000000000000000000000003000000003000000000030010000300000
000000000000000000000000000000000000000000030300000000005001000010000000000000000000000003050000000000030000000000000000010000000000000000000000000000000000000000000000
000000000000000000000000000044400010000000003000000000030003000000434044440010000000000000000044300060000000000000044400000000010000000000000000000000050040144400000000
000000000000000000000000000001000103000000020000000000000000000000000000000000000000000000000000000200000000030060000000050000020000000000000000050000004000100000050000
000000000000000000000000000000000000000205660000000030300000000000000000000000000000003000000000006600010000000000000000000000360300000003000000003000000005000000000100
000000000000000000000000000000020200000000660050000000060000000210000000223200000000060000020000000000000000000020000000000000660000000000005001006000000020000000000000
000000000000000000000000000033333300000000333000000333030000000060033333033300000100000000003333331300000000000003033033030000033000000000000003303000000033333330000000
000000000000000000000000000000006006000000030000000050000000000000000000000031000300003000000000000000000001030100000000000060100000000010000000000000000100000000000000
000000000000000000000000000000000000000000000000000000100300000000000000000000000000000000600100000000003000000003000000600000000000000000230000000000000100000003000000
444000100044400000000000000000440000000000000000000000000000500000000010000000000000410000100000000000000000000000000000000030000000044020000440001000000010000000110000
000000000000000200000000000000000001000000000000000000500203000000100000000000000000000006000010000100000000000000000000000000000000100000000000500040000030000000000006
000000000000006600000000000300000000030200000010001300106600000000003000300000000000000000000000030000000000000600000000000000010000300000000000000600000000000000000000
002222020000006600000000000620100010000000000010000000000600000000000000000000000006000202000000060000001013000000000000005061000000600222200022020660000000000000000000
333333333333333330000003333333333300000000000000000000000330000000000000300000033333333333300603330000000000000000000000300000000333330333333321330033000000000000300000
