----------------------------------
----------------------------------
----------------------------------
----------------------------------
----------------------------------
----------------------------------
----------------------------------
----------------------------------
----------------------------------
----------------------------QQ----
---S-----E----------E-------------
--->---------------<>-------------
XXX]----------EE---[]----------XXX
XXXXXXXXXXXX-XXXXXXXXXXXXXXXXXXXXX
