---X-------------------X----------
-----------------------X----------
----------------------------------
----------------------------------
----------------------------X-----
-----------------X----------??----
---E-o----------------------------
----------------------------------
-------------ooo----o-------------
----------------------------XX----
----------------------------------
----------------------------------
XXX----------------------------XXX
XXX------XXXXX-XXXXXXXXXXXXXXXXXXX
