--------------------------------------------------------------
--------------------------------------------------------------
--------------------------------------------------------------
--------------------------------------------------------------
--------------------------------------------------------------
--------------------------------S???---------------SSSSSS-----
--------------------------------------------------------------
--------------------------------------------------------------
----------------------XXX-----------E-------------------------
----------------------XXX-------E?<?X??S<X--oSXE?E------------
----E---------------XXXXX----X-EX-[-oX-S-X?-<?o?XX-<So-S<E----
--->>---------------XXXXX----X--o-[-X-SS<Xo-oX?o-oSE?SE<oS?---
XXX]]--------EE-E--XXXXXX----X-<-ESX?--X-SS?E-<S-?SS<-?-??<XXX
XXXXXXXXXXXXXXXXXXXXXXXXX--X-XXoXX<??oo?-ESS?EX?<?E?EXSX?-SXXX
