----------------------------
--X-------------------------
----------------------------
----------------------------
----------------------------
------------------------X---
------XXX---------------XX--
-------------------------X--
-------------oo---------XX--
--------------------XX-XXXX-
-----------------X--XXXXXX--
----------------XXXXXXXXXX--
---------------XXXXXXXXXXX--
XX-XXXX--XXXXXXXXXXXXXXXXXXX
