----------------------------------
----------------------------------
----------------------------------
-----------E----------------------
-----------XXXX-------------------
----------------------------------
----------------------------------
--------------SS------------------
--------------SS------------------
----------------------------------
---------------------XXX----------
----------------------XX----------
XXX----------EE-E----XXX-------XXX
XXXXXXXXXXXXXXXXXXXXXXXXXXX-XXXXXX
