--------------------------------------------------------------
--------------------------------------------------------------
--------------------------------------------------------------
--------------------------------------------------------------
---o----------------------------------------------------------
--------------------------------------------------------------
--------------------------------------------------------------
------------------------------------------------------XX------
----------------E------------------------------------XXX------
----------------E------------------------E----------XXXX------
---------------<>----------E------------<>---------XXXXX------
---------------[]---------<>------------[]--------XXXXXX------
XXX---------E--[]-----E---[]-E--E-------[]-E-----XXXXXXX--XXXX
XXXXXXXXXXXXXXXXXXXXXXXXXXXXXXXXX?X?XXXXXXXXXXXXXXXXXXXXXXXXXX
