------XX--------------------------------------------------X-----------X---------------------------------------------------------------------------
-------------------------------------------X---------------X-XX----------------X-X----X-----------------------------------------------------------
--------------------------------------------------------------------------------------------------------------------------------------------------
--------------------------------------------------------------------------------------------------------------------------------------------------
--------------------------------------------------------------------------------------X-----------------------------------------------------------
--------------SSSSSS---------------o---XXXXoo-----------??----------X-----------S------------------Q--------------X-------------------------------
----------------------------------------------------------------------------------------------------------------XXX-------------------------------
---------------------------------------------------------------------------------------------------------------XXXX-------------------------------
---------------------------E------XXX-------XX--------------SSXXX--------X------------X-----------------------XXXXX-----------E---E--------E------
------SSS--------SSSS-----<>----------XX----XX-----X-XXXXX-------------------XXXX----XX----QQ----o-----------XXXXXX----------<>--<>-------SS------
----------------------E---[]-------------------------------------------------------XXXX--------------------XXXXXXX-----------[]--[]---------------
--------------------------[]------------------------------------------------------XXXXX-------------------XXXXXXX------------[]--[]---------------
XXX-----------------------[]---XX------------------------------------------------XXXXXXEE-------EE-E-----XXXXXXX--X-----EEE--[]E-[]------------XXX
XXXXXXXXXXXX-----XXX--XXXXXXXXX----------------------------XXXX---------------------XXXXXXXXXXXXXXXXXXXXXXXXXXXXXXXXXXXXXXXXXXXXXXXXXXXXXXXXXXXXXX
