---------------------------XXXXX-------------------------------------------------X-X------
---X-----------------------------------------------X--------------------------------------
------------------------------------------------------------------------------------------
------------------------------------------------------------o-----------------------------
-----------ooo--------------X---------------------------X-----------oo--------------------
---X-------XXXX------oo------X-----o------X-XX----------??--------XXXXX-------------------
--------------------------------o------------------oo----------------------------XXX------
-------------------------------X------------------XX--------------------------------------
----------------------XX-----------------ooo-------------E--------------------------------
----------XXXXXXXX---------XXXX-------------------------------XXXXXXXXXXXX----------------
---------------------------------------------------X------------X-------------------------
---X---------------------------------XX--------------------X------------------------------
XXX------------------------------------------------------------------------------------XXX
XXX-------------------------------------------X-X--XXXXX--XXXXX---------XXXXXX-----XXXXXXX
