----------------------------
----------------------------
----------------------------
----------------------------
----------------------------
--------------S-S-------E---
-----------------------<>--X
-----------------------[]--X
---oo------------E-----[]---
---SSS----------SSS----XX---
----------------------------
----------------------------
---------------------------X
XXXXXXXXXXXX-XXXXXXXXXXXXXXX
