----------------------------------------------------------------------------------------------X-----------------X---------------------------
----------------------------------------------------------------------------X---------------X-------------------X---------------------------
--------------------------------------------------------------------------------------------------------------------------------------------
--------------------------------------------------------------------------------------------------------------------------------------------
-----------------------------------------------------------------oooooooo--------X?-------------------------------------ooooooo----------ooo
--E-SSS-----------------------------------------------------------XXXXX----------XXXEo----------------------------------XXXX--X----------XXX
--------------------------------------------------------------------------------------------------------------------------------------------
--------------------------------------------------------------------------------------------------------------------------------------------
--E------------E----------------------------------------------------------XX--------E---------------------------XX-----------------XX-------
-SSSSSS-------<>-------------------------------------------------XX--------------XXX----------------------E------------XXXXX-------------XXX
--------------[]---SS---E---------E------E----------------XXXX-?-----------------------------------------<>-XXXX----------------------------
--------------[]-------<>--X--B--<>-----<>------------------------------------------------E--------------[]---------------------------------
E-------------[]-------[]-----b--[]-----[]---------------------------------------------------------------[]---------------------------------
XXXXXXXXXXXX-XXXXXXXXXXXXX-XXXXXXXXXXXXXXXXXXXXXXXXX-XXX-------------XXX-----XXXX---XXXXXXXXXXXXXXXXXXXXXXX-------------------------------XX
