-------------------------------o-------S------------o-S-
-----------------------------o-S--<-------S-<-o-------X-
----------------------------------S<ES------S---S-X-----
----------------------------S---X-<-------------S--S----
------------------------------Xo-S-------<---X----------
-----SSS-----SS--------S---SX-S---------X--------SS-----
---------------------------------------------------<----
------------------------------S---------X-SS-------X----
---------------E--------E------EE?-------------SS-----E-
--SSSS--SS----<>-------<>-----------S-X----<o-----------
--------------[]-------[]------S--------E-------<-------
--------------[]-------[]------SS-S-----o----XS-S-----<-
--------------[]-------[]-----------S---S--S-----S------
XXXXXXXXXXXX--XXXXXXXXXXXXX-o--S-S---SS--X-----------S--
