--------------------------------------------------------------
--------------------------------------------------------------
--------------------------------------------------------------
--------------------------------------------------------------
--------------------------------------------------------------
--------QQX----------S----------------------------------------
-----------------------------------------------------E--------
----------------------------------------------------<>--------
-----------------SSSS-------------------------------[]--------
---XXX-----------------------XXQ----------E---------[]--------
----------------------------XXX----E-----<>---------[]--------
---------------------------XXXX---<>-----[]---------[]--------
XXX----------XX------------XXXX---[]--E--[]---E-----[]-----XXX
XXX---XXXXXXXXX---XXXXXXXXXXXXXXXXXXXXXXXXXXXXXXXXXXXXXXX--XXX
