----------------------------
----------------------------
----------------------------
----------------------------
----------------------------
-------S?S------------------
----------------------------
----------------------------
--------E----------S-SS-----
---X---SSSSS---X------------
------------------------E---
----o----------X------------
---S----------XX-----------E
XXXXXXXXXXXXXXXXXXXXXXXXXXXX
