----------------------------------X--------------------SS---------------X----------S--XX-----------S---------X---X----S-----X-X-XS-----S-----S----------XS--------------
---------------------------------XXS----S----------------------X--X-------------S---------------S---------S------E--------------------------S---X----------------X------
----------------------------S-------------------------S-------X-------SX--------------------o--S----------S--------------X-XS-----XS?-----------------------------------
--------E---------------------X-SS--E----S-S-o-----------o-----X-S------X----S--------------E-X--------------S----------E--X-S----------------X--S--E-----o-----E----X--
--------XXXX-------------------------XX------o--S--X-----------S-XX----X----------o---------X--X---?-----------S--------XXXX--SX----S---------------XX-------X--------XX
----------------------------------------XX----------X-----X---X---------S---------------------S-X---------------------X---o--S-----------------------S------S-------X---
----------------------------------?-----X--------o----S-S----X-------o----------------S--SS----S---------------X-X-----S---------X------------X-------------------------
-----------SS----------------------X---SS-X-----------X------------S--S----S--------------------S-o--------------------S---SS------------X---------X----S-X---XX-------S
-----------SS-----------------X----X---SS-------------------X?-----S----------------------o----SS-?----S---------X---S-----S--------S-------X----------SS-------------S-
-------------------------------S---------S-------------------------S----X---S----X---------------------------oX-S---------X---------------X------S----------------------
------------------XXX---------------------X---XXX-------X---X----X------SXXX------X----S-SS------S----XX---S-------X--------------X-X-----S---------S---------XX-S------
-------------------XX---------------S-----------X---------------X-S--o-X---XXS------------------------S---?----------o---X-------S-X-----------------X----S-E--X--------
----------EE-E----XXX---------------X--E------XX--------------X------E-----XXX----------------E--------XXo----------------EEo-----XXX-----------------EE---X--X-X-------
XXXXXXXXXXXXXXXXXXXXXXXX-XXXXXXXXX-XX-XSXXX---XXo-XXSX----XXX-X-XXXX?XoXXXX-XXX--XXXX-XX-X--XXXXXX-XX---XXX--XX-X-X-XXXXX-X-XXX--X-XXX-X--X--XXXXXXXXX-XoXXX--XXXX-X-X-X
