----------------------------------
----------------------------------
----------------------------------
----------------------------------
----------------------------------
------------Q---------------------
---------------E------------------
----------------------------------
----------------------------------
--------??---------------E--------
------------------------<>---E----
------------------------[]--------
XXX---------------E-----[]-----XXX
XXXXXXXX-----XXXXXXXXXXXXXXXXXXXXX
