----------------------------------
----------------------------------
----------------------------------
----------------------------------
------------XXXX------------------
----------------------------------
----------------------------------
----------------------------------
--------------------ooo-----------
----------------------------XXX---
----------------------------------
----------------------------------
XXX-----------E-E--------------XXX
XXXXXXXXXXXXXXXXXXXXXXXXXXXXXXXXXX
