--------------------------------------------------------------------------------------------------------------------------------------------
--------------------------------------------------------------------------------------------------------------------------------------------
--------------------S-----------------------------------o---SSSS----------------------------------------------------------------------------
----------------------S---------------------------------------------------------------------------------------------------------------------
EE---------------------SS--S----------------------------------------------------------------------------------------------------------------
--------------------SSSSSS-S---------------------XXX----------------------------------------------------------------------------------------
------------------------------------------------XXXX--------------------------------------------------------------------------------------XX
------------------------------------------------XXX--------------------------------------------------------------------------------------XXX
-------------------?-ooo---o-------------------XXXXX--------------------------oo--------------------------------------------------------XX--
XXXX--------XXX---S??SS------------------------XXX-------------------------------?SS------------------E--------------------E-----------XXXXX
-----------E-XX-----------------E------------XXXXXX-------E---E------E--------------E---E-----------------E---------------<>---------XXXXXXX
-----B----X-XXXX-----------------------------XXXXXXX-----XX--<>-----<>-----------------B-----------------<>---------------[]--------XXXXXXXX
-----b----XXXXX----E------------------------XXXXXXXX-----XX--[]-E---[]--------------E--b-------E---------[]----------E-E--[]-------XXXXXXX-X
XXXXXXXXXXXXXXX---XXXXXXXXXXXXXXXXXXXXXXXXXXXXXXXXXXXXXXXXXXXXXXXXXXXXXXXXXXXXXXXXXXXXXXXXXX-XXXXXXXXXXXXXXXXXXXXXXXXXXXXXXXXXXXXXXXXXXXX--X
