----------------------------------
----------------------------------
----------------------------------
----------------------------------
----------------------------------
----------------------------------
----------------------------------
----------------------------------
-----------------o----------------
-------------------------XXX------
----------------------------------
-----------------------X-----XX---
XXX-----------E--------------XXXXX
XXXXXXXXXXXXXXXXXXXX-XXXXX---XXXXX
