--------------------------------------------------------------------------------------------------------------------------------------------S-----
---------------------------------------------------------------------------------------------------------XX--------X------------------------------
--------------------------------------------------------------------------------------------------------------------------------------------------
--------------------------------------------------------------------------------------------------------------------------------------------------
-----------------------------------------------o---------------------------------------E----------------------------------------------------------
------------------------------------XXXXX-------------------------S------SSS-------------SS-----SS------------------------------------o-----------
-------X---------------X-------X------------------------------------------------------------------------------------------------------------------
----------------------XX--------------------------------------------------------------------------------------------------------------------------
---------------------XXX-----------------------SSSSSSSS------E------------E--------E--------------------------------------------------------------
---S-----------------XXX----------------SSSS----------------SSSSSSSSS----SSS------<>-------------E-------------E-----------QQQQ--------XXXX-------
----E---------------XXXX-------XX--X-------------------------------------SS---SS--[]------------<>------------<>------------------E---------------
---<>--------------XXXXX-------XX-----------------------------------------S-------[]------------[]------------[]-----------------------------XX---
XXX[]--------EE-E-XXXXXX-----------X--------------------E-----------------S-------[]--E---------[]------------[]-E-EEE-----E----------------XXXXXX
XXXXX--X-XXXXXXXXXXXXXXXXXXXXXXXX-XXXXXXXXXXXXXXXXXXXXXXXXXXXXXXXXXXXXX-XXXXXXXXXXXXX-XXXXXXXXXXXXXX--XXXXXXXXXXXXXXXXXXXXXXXXXXXXXX-------XXXXXXX
