--------------------------------------------------------------------------------------------------------------------------------------------------
--------------------------------------------------------------------------------------------------------------------------------------------------
---o------o-----------------------------------------------------------------------------S---------------------------------------------------------
--------------------------------------------------------------------------------------------------------------------------------------------------
--------------------------------------------------------------------------------------------------------------------------------------------------
----------------------------SSS--------------------------X--SS------------------------------------------------------------------------------------
--------------------------------------------------------XXX----------------------------------------------------------------------------------oo---
-------------------------------------------------------XXXX---------------------------------------------------------------------------------------
----------------X-------ooo---------------------------XXXXX---------------------------------------------------------------------------------------
----XX---------XXX-----SSS----------------------------XXXXX-S----S-------------XXXX-----------SES---------------------QQ-----E------------X---X---
---XXXX--------XXX---------------E-----------------XXXXXXXX---------------E---------------------------XX-------XX-------------------E---XXX---X---
---XXXX--------XXX--------------<>-----------------XXXXXXXX--------------<>-----------X>--------------XX-----XXXX------------------<>-<>XXX---X---
XXXXXXX-XXXE-XXXXX--------------[]-------EE-E------XX-XXXXXE-E-EE-E------[]-----------[]--------------XX-----XXXX---E--E----EE-E---[]-[]XXX---XXXX
XXXXXX--XXXXXXXXXXXXXXXXXXXXXXXXXXXXXXXXXXXXXXXXXXXXXXXXXXXXXXXXXXXXXXXXXXXX------XXXXXXXXXXXX--XXXXXXXXXXXXXXXXXXXXXXXXXXXXXXXXXXXXXXXXXXX-XXXXXX
