--------------------------------------------------------
--------------------------------------------------------
--------------------------------------------------------
--------------------------------------------------------
--------------------------------------------------------
--------------------------------------------------------
--------------------------------------------------------
--------------------------------------------------------
-E----------------XX----------E------------E------------
>>--------------XXX---------SSSSS---------<>-----------E
]]-------------XXXXX----------------------[]-----S----<>
]]------------XXXXXX-------------------X--[]----------[]
]]-----------XXXXXXX-------------------XX-[]------o<?E[-
XXXXXXXXXXXXXXXXXXX--XXXXXXXo?EE??EXXS?-S?[o<S?XE<X?oESo
