-------------E-------------X-----o--S-S-----SX----S-------
--------------------S------------<S---S---S-S<-----X------
------------------------------SS--X------S-<-S-S-X--------
------------------------<----S----------E---------------X<
--------------------------------S---------So------------S[
--------SSS------------------<S-----oS------S--<--S------S
--------------------------------E----X--X---S?SS-S-S--X-S-
---------------------X--------X<--oS-S-----o---S----------
---------------------?---------[---X---S------S-X--S------
---???----E------E------E--------S-----------S----S-------
---------<>--E--<>-----<>---S-----------S-----------------
---------[]-<>--[]-----[]-------S---------X--<?------E-S--
---------[X-[]--[]-----[]------X---X---------X------S-----
XXXXXXXXXXXXXXXXXXXXXXXXXXXX----S-X-------ooS-<X-----<---o
