----------------------------------
----------------------------------
----------------------------------
----------------------------------
----------------------------------
---XXX--QQSQS---------------------
----------------------------------
----------------------------------
-------------------XXXXXXSS-------
----XX------XXXS------------------
---XX-----------------------------
---X------------------------------
XXX----------------------------XXX
XXXXXXXXXXX--XX----XXXXXXXXXXXXXXX
