---------------------------------------S-----------------------------S---S----S-------------------------E----------o--------X-------------------------------------S-----
-------------------------------------X-S---------XX---S--------------------------X--------------------------S---------------?-------------S--S---------X-----------X----
---------------------------------------------S--------?---X------X---------------o------S----o---------o----------------S------X-X--XX---------o----E---S---------------
--------------------------------S-------XX---------S--------S---------------------------------------S---X---------------------------------X-----E-----------S--------X--
---------------------------------------S-----X--------------X-S--X---S--------------------------------------S---------X---------------------------X----E-------X-----X--
-----------------------------------------X------X-----------------X----S-------------------------o--X------------------X------------------------X-------------o---------
-------------------------------------------------X---------S---------------S-o----------------X--------SSS-------------------------------------------X------------------
----------------------------------X---------------------------X------S------------------------S--------SX---X----X-----X--S--S------S------X---S-----X-X--XX----S-------
-------------------------------X----------S---------------------------------o------------------S-----------------------------------S--X-------X------------------------X
-------------------------??--------------------------?-X-------------X-----------??---------------------------?-----------------X-X-------?--------------S-----------?--
S-----E----------E----------S-----EX---------Eo-S-----?-S-----E----------E---------So------------X---?----S-----S-X-----So----------S-------S-----E----------E---S------
X---------------XX----------X---------------XX-S--------X-----X-----S---X--------X--X---S----S------XX----------X---S------S----XX----------S-----------X---XSX---------
X----------EE---XX----------X-------X--E----XX----------X------S-S-SE---X----------XX----X-----EE---XX---S------X--------X-E--X-XX-----o----X------X----E----X----------
XXXXXXXXX-XXXXXXXXXXXXXXXXXXX--XSX-XX-XXX-XX---XXXX-XX-XX---X-XXX-XXXXXXXXXX-X--X-SXXX-XXX-XX-XXXX--X----XXXXXXXX-XXXXXXS-XXXX--XXXXXX-XXXXXXXX-XXXXX-XXXXXXXXXX--XXX-XX
