-------------------------------------X-----o------------S------X--------------X-S-E--------SXX------------S-------------------------X--------S------X------------S------
------------------------------------------------o-----------S---------------oo--------------------------------------------XXS--SS------S--X--------S---S--o-----S-X--X--
-----------------------------X----------------------X-X-----o-------------------X-----------X-X----S-X-------------------XX------S-------------X-X--XXX-----------------
----------------------------S---S-?--X---------------------------S-----------X--------------------------------------------------------X--------X----S----------XX------S
--------------------------------------------------------S--S-----------------------X------------XX-S-X--X-----------S-------XX--------------------o-----XX------X-------
----------------------------------X------------S------o--S------------------------------E----X-----X-------------------------X-------------------------XXX--------------
----------------------------------------?--XX--SS-X-XX-?--XXXXX---------------XX-XXXX--X-XXX----XXXo--------------------X-S-XX--------------X------XS---XXXXX-XSX-------
--------------------------------------------------S-----------------X-------------------------o---------------------------------------------X--------S-----?o-----X-----
--------------o------------------------------X------------------------o-----X-------------------S---------------o-------------------------------------------------------
----------------------XXX---o------XXX----------------?---------X-----------------------------------X----------------------------X---------X-------------S---X-S--------
--------------------------------?----------------------------S--------------o-----------S---X---------------S----------------------X-----------------------X----X-----X-
--------------------X-----XX---oS-X-----XX-X--X---------------------XX--------------------X----------------S----S-X---X-S--------------------------------------S--X-----
-----------E--------------XX---S--------XX---------S--------E-----S-X--------------------------------------------S----------------------------------------X-------------
XXXXXXXXXXXXXXXXX-XXXXX---XXXXX--X--X---XS--------------X-XX-XXX-----X---X----------XXX----X--------------XSXXXXXX----X-------XXX-XXX-XXXXXX-------XXXo-XX-------XX-XX-X
