--------------------------------------------------------------
-------------------------------S------------------------------
-------------------------------S------------------------------
--------------------------------------------------------------
-------------------------------SE-----------------------------
------------SS-----------------S---------------SSSS-SSS-------
--------------------------------------------------------------
-------------------------------------------------SS-----------
-------E---------------------------SSS------------?--?----E---
------<>----------------------?XXX----------XX----?SSS---SX---
------[]------------E---------------------E--X----------------
------[]-----------<>-----------------------XXX-o-------------
XXX---[]----E-EE---[]---------------X-X------------------XoXXX
XXXXXXXXXXXXXXXXXXXXXXXXX-XXXXX?oo-XXXXX--XXX-----XXXXXXXXXXXX
