X-------------------------------------------------------------------------------------------------------------------------------------------
--------------------------------------------------------------------------------------------------------------------------------------------
SSSSSSSSSSSSS?X---S-SSSSSSSS----------------------------------------------------------------------------------------------------------------
--------------------------------------------------------------------------------------------------------------------------------------------
--------------------------------------------------------------------------------------------------------------------------------------------
-------------------------QQQ---SSS----------------------------------------------E----------------------------------------------------------S
-------------------------------------------------------------------------------<>--X--------------------------------------------------------
-------------------------------------------------------------------------------[]--X-----------------------------XXX------------------------
------------------------------E------------------------------------------E-----[]--Xooo---------------oo--------X-XX---------X--------------
--------?S---------SSQ-?S?SS---SSS---------E---------------QQQ-------E--SSS----XX---------------------------------XX--------XXX------------E
------------------------------------------<>----E---E---------------<>------------------------------------------XXXX-------XXXX------------X
X---------------B---------------------B---[]-----------X------------[]------------------------------------------XXXXX-------XXX-----------<>
----------------b----------------E----b---[]--------E--[---------E--[]---------------------E---E-E-----------EEEXXXX-----XXXXXX-----------[]
XXXXXXXXXXXXXXXXXXXXXXXXXXXXXXXXXXXXXXXXXXXXXXXXXXXXXXXXXXXXXXXXXXXXXXXXXXXX---XXXXXXXXXXXXXXXXXXXXXXXXXXXXXXXXXXXXX---XXXXXXXXXXXXXXXXXXXXX
