--------------------------------------------------------
--------------------------------------------------------
--------------------------------------------------------
--------------------------------------------------------
--------------------------------------------------------
----SSSSS-SS--------------------------------------------
--------------------------------Xo------------------X---
------------------------------------------------X---X---
-----------------------------------------------XXX--X---
----------------------------<>-----------------XX-------
----------------------------[]---------------XXXXX--X---
---------------------------X[]--------------XXXXX-------
---EEEE-E---------------E--<]]--------EE-E-XXXXXX---X---
XXXXXXXXXXXXXXXXXXXXX-XXXXXX[-X<oSoE<>S?XX?XXEEoXXXXXXXX
