-----------------------------X--------------------------------------X--------------------------------------X-----X----------------X---------------
---X-------------------S-----X-----------------------------------------X-----------------------------------X-------X------------------------------
--------------------oo-----------------------------------------------------------------------------------ooX--------------------------------------
--------------------X-----------------------------------------------------------------------------------------------------------------------------
--------Eooo-----------XXXXXX-----------------------------------------------------------------------------------X---------------------------------
--------XXXX---Xoo-----------------------------------------------------------EoEoXX----XX---XXXXXXXXoo----------??X--------------------SS---------
----X--------------------------------------------------------------------------XXXXX-------------------------------------------------------E------
----X-------------------------------------------------------------------------------------------------------------------------------------<>------
----XX-----------XXXXXX-----------------------------------------------------------------X-----------XXX---------------------------E-------[]------
-----------XXX--------------------------------------------------------XXSSS-------------------XXXX------------XXXXXSSSS----------<>------XXXX-----
----XX---------------------------------------------------------------------------------------------------------------------------[]---------------
--------------------------------SS-------------------------------------------------------------------------------------------<>--[]---------------
XXX-------------------------XX--S-----E--E-EE--E---------E-XEESS---------------------------------------------------------EE--[]--[]-----------QXXX
XXX-----XXXXXX----------XXXXXXXXXXXXXXXXXXXXXXXXXXXXXXXXXXXXXXXXXXXXXXXXXXX----------------------------------------XXXXXXXXXXXX--XXXXXX--------XXX
