----------------------------------
---X------------------------------
----------------------------------
----o-----------------------------
----------------oo--E-------------
-----------XS--?-------E------X---
-------------------XXXXXXXXX------
----------------------------------
----------------------------------
-----XXXXXXXXX--XXX----------X----
----------------------------------
----------------------------------
XXX----------------------------XXX
XXX------------XXXX------X-X---XXX
