------------------------------------------------------------------------------------------
------------------------------------------------------------------------------------------
------------------------------------------------------------------------------------------
------------------------------------------------------------------------------------------
------------------------------------------------------------------------------------------
-----SSSSS--------------------------------------------------------------------------------
-----------------------------o-----oo------------------------------------------XXX--------
-----------------------------------------------------------------------------XXXX---------
------------------oo-------------E-------------------------------------------XXXXX--------
-------------------oS-----------<>-------------------------<>---------------XXXXX---------
-------------E------------------[]-------------------------[]---------------XXXXX---------
------------<>----------------XX[]---------<>--------------[]---------------XXXXX-X-------
XXX-----E---[]----------------XX[]---------[]--------------[]--------EEE-E-EXXXXXXX----XXX
XXXXXXXXXXXXXXX---XXXXXXXXXXXXXXXX--XXXXXXXXXXXXXXXXXXXX-XXXXXXXXXXXXXXXXXXXXXXXXXXX-XXXXX
