---X---------------------------?EXSXoSo[o-[XS-?[?S?oS?oX?X--------------------------------
-------------------------------<--ooo<E?-S[ES?<S--o?SX?S?SoX----------X-----X-------------
-------------------------------[-XE??EE?oSS-<>-XSS<Eo-S<E?o-------------------------------
-------------------------------XoE-<E--?oX-<??<SEXXXS-XoXo?-------------------------------
-------------------------------XE?oo-E??SESEES?ESS<oEXX-S<--E----E------------------------
------------------------X------E-SE?<?<S-?SE<o<SESX??EEo--XS---SSS--------------SS--------
-------------------------------<>?XE[?SS?Xo-ooooo<EE?E?Eo-E-------------------------------
-------------------------------X?oE?[??-ES<XXSE--?-o-<EXXX?-------------X-----------------
-------------------------------SSS<?[?o--X-E<?SoEXSS?Eo??-oSSS-SS---------------------E---
----------?---------X----------S<>]oX<-X-<ooo?X<>S-?S?X-SX?XXX---------------XXX-----<>---
--------------------XXX-X------X-o??EE?--EXXSSXoEEEo-?E-o<---------------------------[]---
--------------------XXX-X----X-EEoS<EXEo<-<o<?EoS<SS<???XEo------------XXXXX---------[]---
XXXE---------EE-E-E-XX--X----X-S?So?SXXo--[E?oX<---?oo?<oSE--------------------------[]XXX
XXXXXXXXXXXXXXXXXXXXXXXXXXXXXXX-X??E<Eo?EoEo<-oo?S?<----<o--o?<E?-o<-XE?XS<?<Eo---XXXXXXXX
