----------------------------------
----------------------------------
----------------------------------
----------------------------------
---oo-o---------------------------
----------------------------------
----------------------------------
----------------------------------
----------------------------------
-----E-QQ------------------E------
----<>----------E---E-----<>------
----[]---------<>--<>-----[]------
XXX-[]-E-------[]--[]-E---[]---XXX
XXXXXXXXXXXXXXXXXXXXXXXX--XXXXXXXX
