-------X---------------------X----------------------------------------------------------------------------------------
----------------------------------------------------------------------------------------------------------------------
----------------------------------------------------------------------------------------------------------------------
----------------------------------------------------------------------------------------------------------------------
---------------------------------------------X------------------------------------------------------------------------
--------------------------------------------------------XXX--------------------------------------------SSS-----E------
-------XX-------------------------------XXX---o---------------------------------------X-----------------------<>--X---
--------------------------------------------XXXX-------------------------------------XX-----------------------[]--X---
---------------------X---------------------------------oo---------------------------XXX---oo------------E-----[]------
---?------------------------------------------------------S-------------E-----------XXX---SSS----------SSS----[-------
----E---------------XX-------E-----------------------------------------<>----------XXXX-------------------------------
-------------------XXX---------------X-----------------------X---------[]-------XXXXXXX-------------------------------
XXXX--------------XXXX---------------------------------------X---E-EE--[]------XXXXXXXX----------E----------------XXXX
XXXXX--X--XXXXXXXXXXXXX-XXXXXXX---------------XXXXXXXXXXXXXXXXXXXXXXXXXXXXXXXXXXXXXXXXXXXXXXXXXXXXX--XXXXXXXXXXXXXXXXX
