--------------------------------------------------------
------------------------------X-----------------------X-
--------------------------------------------------------
--------------------------------------------------------
--------------------------------------------------------
--------------------------------------------------------
--------------------------oX-------XX------------X------
---------------------------X-------------------XX-------
----?------------E---------X------------------XXXX------
---S??----------<>---------X-X---------------XXXX-------
----------------[]---------X-<--------------XXXXX-------
----------------[]-<>--X-------------------XXXXXX-------
---------EE-----[]-[]-------E---------E---XXXXXXX-------
XXXXXXXXXXXXXXXXXXXXXX---XXXo?ES-?---XXXXXXXXXX---XXXXXX
