000000000000000000000000000000000050000000000000000000000030000001000060000030000000000600400600000000300000003000000000000001000000000000000000000000000000000000000000
000400000000000000000000000000040000000000030010000000000000000000000000040000000000300000000000000300000050400000000000001000000010000300000000000000000010000001000000
000000000000000000000000000000000000000300000000000000000000000104000000000000000030000000001000000000000000000100000000003000444000000000604040001000000000000000000000
000000000000000000000000000000000000000000100200002000000100000000000000010000000000300000000000000000030000000000000000000000000000000100000000000000000002000000002300
000000000000000000000000000000000000030000006000003000000000000000001001000000000000000010000006036000000600000000000010000000050000000000000000000000030066000000000000
111110000000000000000000000011111000000000000000066100000000000000202011111000000005000000000000006000000110110016200000300000000203010010000002020000000066000000066000
000000000000000000000000000030000000000000033333030333300000000333003300100000004000000000000000003330330000000033033303333130030033300000003303330000000033300300033003
000000000000000000000000000000000000000000600000010000001000000000000000000000000005000000100050000000000000000000000000000000000000001000000000000000000000010000000100
000000000000000000000000000000000000000001002000000000010000000000000000000000000000000000000001000000000000030000000000000000000000000000000000100000400000000000000000
444000000000000000000000000003500000000000410001030000000000006000000000000000000000000000003000000000000404000000000000000000000000000000000000000035000000000000001000
000000000000000200000000200000000000015000000000000003000000000300000501000000002030000000600020000050000000000000000000000000000000100001000010000000000001030000000000
000000000000006600000006600000000000005000000000000001000000000000000066000000060000000000010660013000000000001000000001300010000000000060000000000000000000000100000000
000202000000006600000006600000021010000100000300006000000000000000000066000000006000000300500600000000000001202000100000000000005010000660000000000111010000000000000000
333333333333333333330033333333333336000010330303300000000000000353330330333000103003000000003033333033303333033300000000000010000030003333330000010000000030000300000000
