000000000000000000000000000000001303000400000000000000000000000000006010000100000000000000000000000000000000000000000000000000000000000000001003030000000200000100030000
000000000000000000000000000000500300000003060001103000300000023000001000000030004000002000000000000000010000000000004100000000100000000000000000000010000010000000000000
000000000000000000000000000000000000000030000000000000000000000300000000000300000000030000000000000000030000010030000000000000300030300000003000003000000000000000000000
000000000000000000000000000000050000000303100001000000000000010000000000003000210101020030000100000000000002000000000000000000300000030100001000000000400000000000200000
000000000000000000000000000000000000103303000000300001000000000300000003033330000000000000010000000000000000000000010000000000330000000000601000000000003000000601000000
000000000000000000000000000000000000003330000000000000003000030300013100030332000000200000000000000000000000000050000000030000300003000000003001030000000000000002000000
000000333000000000000000000000000603333300000003000000003301000330031333331333335333633333300300030000000330303333000000002003330030300000003300330000000000000603330333
000000000000000000000000000000000000000000000001000000000000001000200000030000001000000006000010000000100000000000000000000000000000100030000000000050000000000000300000
000000000000000000003000000000000000000201000010000030000000000000000000060000000000010000001000000000100010000000003030000030000301000000000000000000000300030000000030
000000000000000000033300000030000003000000000000030000000000010600000000000000300000300006000000000000005000000000001330000000000000100000000000000001003300011000000030
020000000000000000333300000000140000000000000000033000000000000000006000001000000000300000060010000000033000300000003330000000020100000000000000000003030302000010000000
100000000000000003333300000000300000000000100000030010010000000100030000005001000000300000000000000303033300000000033330003000000000000000060000100000333000000500000040
200000000000000033333300003000000100000000200004030100600330000000000000000000000000300003000300003030333000000000353130000000000000000000000300500000033301000000000000
333333333333333333333330033333000003030333330330333020330010000033333050000030000000330033300300003303053300000033300333303303333333300010003300001103333000000013120303
