000000000000000000000000000000000030000000000000000000300000000000000000000000000000002000000000001000006000000000000050000000000063000000000000010003000000000000000000
000000000000000000000000000030003000000000000000000300000000000000000000000300000000000000000000000030000000000003000000000000000000000000000000000050000000000000005030
000000000000000000000000000032001001000003000610000050000000000000000000003000030000000100000000000000000000000030000000030000006000300000000100000300000000000020000000
000000000000000000000000000000003002000002000000000020000000000600000000000000030030000100000540000020000000030000000000000066000300000000000002000000030300000662000002
000000000000000000000000000000000000003036100000000030001000000060000000020000000000000000006000001000000011000000000000000060100000000000000023000000000000100160010006
000000000000000000000000000020300000000066000000031240000000000000000000000000000000000000000000000000000100010000000000000066000000000500300021000000000000000663000106
000000000000000000000000000000000103303333000000030303033000000000000000000040000300000000000000003303330000050000000003333303333033000000503343303000000033336033333003
000000000000000000000000000000000000000000050001000000000000000002000000002000003000000000000000500000000000300000000000000000000000000000003000000000000000000000000000
000000000000000000000000000000000000000000100000001000000000000010000000000000000015000000000000010000001000000000000000000003000000000003000300010000000400000000100000
200000000000020000000004000000100000040000001000000300120040000000010000000013300000000000003000000000002000300001000002000030100000000030000000000004000500003000000000
200000200000660002000000000000000230000000000000006000060000301010200000000662000002200200200020000000066000000000000002000002000000000000000000000000000000060000000000
000006600000660003000000000030000000000060000000000000060000000000306000000060000060030006601030000000006000000000030000000166020000000000000000000000000000000000000000
300006600000660024000000000001000000004003000001000000000000000002400130000603000006000006600040000000330000000030240000000066000010100001000000000000000000000000000000
333333333333333333333333333000000003333330000000003003330333301333033303333130103333133033303333333333331000000033300333333333000000003100300100010303333000000000000003
