300000000000000000000000000000000000000000000400000050000000300031003000000000000000000000000000000000000300000000060000000003000010000000000000000000030000000000000000
300000000000000000000000000100000003000000000000000000000000000000000030000030000001000000000000000000300300100000000003000002000000000000000000000000000400000000000001
300000000000000000000000000000000000000000000000000303301000330000000033000003000000000000000000000013050300010000300000000000003013000330000116000030000000000000000000
000000000000000000000000000033000000000000000000000100000000000010000000300000000000300000000000005000000000000000000000000600000000000000400003000000000033030000000005
000000000000000000000005500000000000000000000000000000000000000000000000003000055000000000000100000000000000000000000000000030000000003003000000000030000000000300055003
330000333330000000000033330000003000300002003010000000030000100000000033000000333350000000133310000000000300000333330030000002010303003003000000000030000000000003000300
000000000000000000000000000003303000303230000000000000500000000000000000000000010000003333000100000000000000000000000000303333030500033033310000030300133313330310000000
000000000000000000000000000000000010000030300001000360000000000000000100000000001010000000000000000000000003000000000000000300000000030000010000000000000030000000000000
000000000000000000000300000000000004003001101000000000000000000000000030000000000030000003000000000000001000000000000000000100000000030000000000000112000030000000000000
033300000333300000000000000000001000000100300000003330000000000030000000000000333000000000000000000000000003000000000000000000000000130000030033330000000030000010000000
000000000000003300000000000030030000000000000000000000030003000030000000000300000010000000000000000000001300000000000000000000000000000000012000000000000000010000000000
030000000000000000000000000000000100005000000000003000000000000000100010000000300000000000000000000003000000000000000000000000000000301010000000000000000000000000100000
030030000000000000000000000200300000353600300300303003001033030000000300000020300330033330000000020000000000303000000000000000033330030000030000000000010030000033331000
333333300000000333333330333300100400000000000000036333500000000033300003033133335330000000033000330000000333333300133330000100000060000000000000000031331300000000000000
