000030000030000000000000000000000000000000000000000000310000101000400303000013300000000030000000000003000000000000000000000300001300000030000000000310000006000000000300
000000000000000000000000000000000060000000000000000000000000000000000303000000000000100000000000000000000000001001000000000000000000400000000000000000000000000000000000
000000000000000000000000000000000000002101000011100000000001111000000000000000000111000000001000000000000010000000001110000000000000000000000030000010111100000000000004
000000000000000000000000000000000000000000000000300000000030000000010000000000000000000300330006000000000050000100000000005000004050060000000010000000000000001010010000
000000000000000000002000000000000000000060000000000000000010030000000000000000000001000000000000000001030000000204000000000000000000000000000000102000000000000000000000
000000000000000000011000011100000300010002020000003000110100000000003010000040000032000000000301110000003300000100000420000000000000000000113003011000000200000000000030
000000000000000000000000000010003330333130033533030000000333330300045300000033333003000000000000300000000000000133303030000000000000000300400000300333333000000000154000
000000000000000000000000000000000000503000000030000000000000000001010000000000000000000000000000103030300000000003000000040100000300010000300000010000001000500000000000
000000000000000000000000000001000000000000110000000000000000000000000000000000000000000000000000000010000300000000000000000600000000000100000010000000000000000000001000
000000000000000000111000111100000100020001010000000300000030000050000000000000000000000000000001010000300001111000000000000000300110000000000000000000000000011110000000
000000000000000000000000000000000005003000030000000000000000300010000000000100000000001000050000000000000000000000000000060000000000501006000000000000001000000000000000
000000000000000000000000000000000000000000030000000110060001000000000000300300000000000000000000100000000000000000020020000000000000000000000000001000010000000100000000
000003000000000000002020000000010000000100006000000000100000010000000000000110000000600300000100020000000120001000000100000030113030000000000000000000003100000006000030
300033300000033333333333333360000030000000300003000000000000000000050020000000000000300033323330030000000330333330000103000133333333300100030300500000000033333303000333
