000000000000000000000000000000010000000000000000000000000000000000000000000300000000000000000000000000000000000001000303000000100030000000000000000000000300000030010000
000000000000000000000000000000000000000000000000130000100000000000000000000030000030000000300030000000000000010000000003001000030000000000001000001050000050000030000000
000000000000000000000000000000030000000000020000036000000110000000000000003330000005000003000000000003000000300000030003300000000000000000003300000011000500000330000000
000000000000000000000000000000333000000000000000030000050000000000030000003130000010000333300000000000000003300030333000310000000020000000003300000000010000003330000300
000000000000000000030000000000303300000030000020056010000000000030303030003330000030000033300003001000001303333000330300300000000030000000103300000000000000001030000030
000000000141000000000001111103330300000000001410033100200000000033003000333330000000030030300000000000000033303003033003300220000000000000000000220014000000033300000000
000000000000000000000000000033313300000000000000033333363332130333333003330310000000030333300000000000000333333033313303333333100000033303333333030030333033303330000000
000000000000003000000000000000000000000000000000003000000000000000000000000300300100000000030010000000000300000100000000040000030110000000000000000000000030000000000000
000000000000033000000000000010000000000000000000000000030010000300000000000000000000001000000000000000200300000000000000030030000030000000030000000003100000000000000000
000300000000333300000011000000000000100001000000001001300000000010000000001000000000011000000010000000000330000000000000001000000000000010330000000000300000000000000000
003330000003333300000000000000000000000000300000000003330060000300000000000000004000000100000000000000000300000000000100000000000000000003030000000003330000000000000000
003333000003333300000000000000000000000010000000000003330000000330000000000000003000001030000000060000000300000000000000000040000003000003331000000013300000000000000000
033333000033333300220000000000000000000000001310000133030001111030022500151000000002000031000341010003111300022004140300011113000000000033030013111633333003141000000000
333333033333333333333333333300000000333330000000030331030000000333030300000000000000000333300000300000003303333300600001000000000000033031331000000003303000000000000000
