000000000000000000000000000000000000000000100300300000000000030000000000000000000000000000000060000000010000000000000000000000031000000000010000000030000000000000000000
000000000000000000000000000000600000000000000000000000000000000000100500300000002000000000000010000000000000000000000000000000000000000000000000000000200000020000000000
000000000000000000000000000044000000000000100000300000000000000000004404003000000000400030003000000000000020000100000400030000000000010006000003000000000002000000000000
000000000000000000000000000000000000000000000000000000001003300000000000001000010003100000000000000001000610102000000000600001100000000000100000000000000066000200001300
000000000000000000000000000000000000010100000000000004000000000000000000030000000000000000000010000005000660000000000000000000010000000000000000000000300010310000000000
000000000044004400000000000002003000000000440000000000004400003000300002300000130003030000014000000000000660000400000034406000000000000000000000060000400360000000006300
000000000000000000000000000030330303003333000000000000000000000300330333333330000000333333310060000000000333010003303333000000000001033030003330033603000003303300000004
000000000000000000000000000000600000000000300000000000000001000000000000000000000000000000100004000000004030000000000000000000000030000000030000010000000000000000000000
000000000000000000000000000000000000000000000003000030000000000010000000010010000100000000000003000001000000000200000000000030000000000030000000000000000000000000000060
000000000000444400000020000002000400000044000000000000000200000000000000000100000000000300010000140000060003003000000000000000440000000000000003000030000100000444400000
000000000000000000000660002006003200000000103000000000000610020000000000000000000000000000000000000000030010000000000000600020000006000060000001001000000000000000000150
000000000000000000000660000060000000300000000000000000016000000000000000000000030000010000000000000000000000000300000006600000600000000000000000000000000100000000100000
000000000000000200000660000046000000000000000000000040006600000000000000044000000000000000013000000004000000000000004006600000100000000100000000000000000000010000200000
333333333333333333333333330033333033303333000000300005003335000330333300000000000000033333333330330300300010000000000003033300030333300000100000000000000033030000330633
