010000000000000000000000000000000000300001000000000500300000000000300001100000000000000000000000000100000000100000500000010000010001000000030300006000000000000000601300
000000000000000000000000000001000000300000000000000000000000000000000003003000000300000000000030000100000000000100000000000000000300000000000000000000000300000000001000
000000000000000000000000000000000000000000000000000040000300000000000000000000000010000050300000001000000000000000001000000000000000000300010010000000000000000000000000
000000000000000000000000000000000000000000000010000000030000000000001060000000000000000000000000000000500000000000100000000000000000000000500000000300000000000200000000
550000000000000000000000000000000000000000000000000500000000000000000000000013500000000100000000005500000000000000000000002000050200000000000000003000000300000000000003
000000000000000000000000000000020202000021000000000300000000000000000000000000000003000000001000000100300030000000000000000000000000000020200006000000000000020232000000
000000000000000000000000000033630333033333333033510000000000000330303336303330000000033331333303030000000001000000000003000000010000033000030000000000000033303310033130
000000000000000000000000000000000000100000000030000000000000000030003000000000000000000000000000000000000000000000000000000000000000000000300103000001000000000020050000
000000000000000000000000000000000000000000000000000000000010000000000000010001000030000000020001000000000000000000000000000000000000000000000000000000000000000000000000
000000000000000000000000000030000003000000000000001001000000000000000000000100000000130000000000000000000000101000000001000000100000000000000000000100000000006001000100
000000000000000000000000000000100050000000000000000000000000000010000011000000000000000005000000000000000030000000000000302000000000004000030000000000003000320000000000
000000000000000000000000000000020500500000010006000001000030001000000100350000003000000000000000000000000000000000000000500000000000000000000501000000000000000000000050
000000020000200000000000202030000000000000060000300000000002033000000020000200000000203601000000003000010010032020000000030000000000300000000000100000000000000000000000
333333333333333330333333333310000000000000000003000333333333333011000000333030000000333033300000000150000303333033333330000000333030333330310000010000300031333303630333
