000000000000000000000000000000000000000300003000000000000000000000000000000000000000000000000000000000000000000000000000000003000100000000000001000000003000000000000000
000000000000000000000000000000000000000200000000000000000000000000000000000000000000030000000000060000030001000000000000000000000000000000000000000001000000000023000000
000000000000000000000000000000000100000600000000000001000000000001000000000000000000000000000000000000300000000000060000000000000001000000000000000000000000000000000000
000000002000000000000000000002000000000110000003000000204000000000003000000000000030000000014000000000000000000000000000000000020000000000100000000000300000000000000000
000000003333000000000000000063303000000000000001000003000300002400003000100000003000020000000000010000000000000000000000000000113330010000000000000001000000000000000000
000000000000000000000000000000000000000000000103000020000000000000003000022000030000000000000000000000000000220210000000002102000000000000000001000000000030020020100000
000000000000000000000000000000000000000000133033333333030000000033033333033330030030000000300000003333003330333300003003330003000000000000000000000000000033333003003333
000000000000000000000000000000000003000000000000000000000000000005000000000005030001600000000100000010000000000000000000000500000001000000000000000000000000000000000030
000000000000000000000000000000000000000000000000000000000100000000000000000000300000000030000100000000000000000130000003000000000000000000000000000000005000006000000000
000000000000000000000000000000000000000000100000005000005000000000000000000030000000000000000000000003000300000000000000000000010000000060000010000000060000001000000300
000000000000000000030000000000030000020000300600000000000000000320000000000300000000000000000000000000000000003000010031000000000000000001300200000100500050000303300000
000000000000000000030000003000000300000000000000000000000000000003300000000300000000000001003333003000000010303600000300000000000000000000320333300000002000000300000000
000000000022020000030000003000000003060000003000000000000301000014000000000300000000001000000000000000000010000000004300000000001003000010300000000000033000000300000000
333333333333333333333333333303333030010000333301300300000050000000000033330333333333330333000000000100000333333330033033303303000005033333330000000333333133003330000000
