000000000000000000000000000000000000000000003000000000000500000000000000000005000000010000050010005000000000000000000000000100000000000010010000000000000004000000001000
000000000000000000000000000000003000000000003200000000000000000001000100300000000100000000000000000000000000000000030000000000000000000000000000001100000000001000000000
000000000000000000000000000000000000006600000000000000000006600000000000000000000000003000005000000000050000600000000000000000000100000000000000000000000000000000030000
000000000000000000000000000000000000000600000200000000040005600000000000000004000001000030000000000000000000000000004000000000000000000010000000330000000001020100000000
000000000000000000000000000000000000003600006000000000000000620003000000000000000000006000000000000000000006600300060000030000030000000360000000000001000001000000000600
000000000010000000000000000000010002000300206000002000000006600000000000005000001003000000000000300000000000600000202230000000000000000060000000000003100021660000000000
000000000000000000000200000000000003033333303333325030003333333200000000030000000000000100000000003300533333330433330030000000000000033333332000000000500030330300000000
000000000000000000000500000001000300000303500000000000005000000000000000000000000001000000000000000005000000000000000005000000000000000000000000000000030050010000000000
000000000000000000000000000000000000000000000000000000610000000020000000000300000003000050000000000000000000000000000010000000301000000000000000003000000010000000000000
000660000000000000000000000000000000000000300000000000100000000000000000000000000000000000000006000000600000000000000000000330340060000000000000000000000000001000006600
000660000000000002000000000000001003100000000000103300000000000001000000000000010000000000000000000006600000000000000000010000000060000050000000000000000010000030006000
000660000000000066000000000000100000003000000000000000000000000000000000000001006003000000000000000000600000000000000000000000000606000000030000000000000003000000006600
200660000202202066000000000000000000000000000000000202200001030000030600200202006000032022103000002000600000010303000000010000200660000000410300050002022100000002006000
333333333333333333333333333300000000000000330633333300333363333030000033033330030333003030000000003331033200000010000033033303333033320000000000005353330053333030333303
