300000000000000000000000000003000000000000003000000000005000300000000000000003000000300000000000000000000000000000000000000001000000000000000000000033000000000003000000
000000000000000300000000000000000500010050200000000000010000000060000003000003000100060000000000010000050000005003300030100000000005300001500300003000005000011000010000
000000000000000000000000000010041411060011300100006000000010000300000000000000000000000000001000000004140100001100000000000000300601100040410000000000004430000000000000
000000000000000000000000000003000000000000000003000000300000000003000030000000030030010000000000000000000060130000000000000000000000000000000000100020000000000300000000
020000000000000000000000000000010010000001000000000000000000003000000000000000200000020000000000033000000000000050000000000000000000000000000000000300000000000000200000
000000000000000000111100000000000000000030100000000001110010030000033000006110000000000003004000000000000000000000011110000000060003000000300000011000000000003000003000
000000000000000000000000000000330330303033000400000000003000000333333003100000000020010000010000000030133103303000000000000610333033311030300000000003330333330330001000
000000000000000000000000000000000003000000060000000000000000000000000000030000000000000000000000500000000000000000000000000010000000000000003000000000000003000000000001
000010000000000000050000005500001400000000000000000100003000000000000100000000000055000000000011000000000030060301000000000000000013000000004000001000000300000000010000
300000000000000004141100001130000000000000000030300050000004141000000000003003000011000000030000000200000000000000000000000000300000010000000000000100001100000000000000
000000000000000000000000000000000000000000000000000000000000000000000100030000000000003000000000000030003000060010000000000000000000000000000000000300000010000000000000
000000000000033000000000000000000020200000000012000010033000000003000100000000000000000000000000010100000000000000000000000000000000000000000000200005000000000000000300
000033000000000000000000000000003300000000000000010000000000300100000006000000300000000300000033300000000000011300000000000000000003000000000000000030000300000001000006
333333330000000033333333333333333300000030000000033000000033333000000000000003330233000000035333330000000000000130000000000000330333300000000000000333300130000000000000
