000000000000000000000000000000000000000401000005000000000000000000000000020000000000000000300030330000000000000000000001000000003010000000001030031000100000010000000000
000000000000300000000000000000000301000000000000000000100000000000033300000000000000500000000003330000330000000300000003000000000000030001000000330001003000000300000100
000000000000000000000000000000100003000000000000110000000000000030003100001000000000030300001003030000030002010300001000000000003000000000004000003300100000000003000000
000000000000000000000000000000000300000000000100000000010000000000033300300000000000000000000030330010400000010000000030020000000000000000100003032000000000000030000000
000000000000000000000000000000000000000000000003000000000030000003303000000000000000000000000133030000000003000000000000000000000000010001000033033000000000000003000000
000000000000000000000000000000036000000001000000000003000000030033333000000000000001000000000330030000303000000302003060000000000000000000000003303000000100000000000000
000000000000000000000000000300000000000003000000033033300033333330333300000000000000003300330350030010000000000333303300033333006000300030003031033000000000000003300333
000000000000000000000000003300000000000001000000000000030500000000030000000003000000000020000000000000000000003000000005000000000003300000031010000000000000000000000030
000000000000005000000000033300000100060000000000000003330000030010000000100000000000000001000000000000000000000001000100000000100133000000000020000000000300000000000000
300000000000000000000000033330000000000000000000000303130000000003000030000000000000300000000000000000001000000000000303003000000003300003330000100000000003000100000030
000000000000000020000000333300004000020000000000000130030000005000000000000000000000000000010100000000000000000000000000000000000333000000000000000000000000000000330000
000000000000000000000003333300000000000000000010000033060000000000000000000000300000000000010060005000000000000000000000000000003300300000000000000000300000000100000100
000000002003000000000033333300010000203000000000000300330006100024030000000000000000000000000100000200300000000000000000000000000333330000001300000120030000030000000000
333333333333300033333333333333333300433333000000003330030000000330333033303330000000033333300000000333330000000000000003333300003331300000000000000333333000000030033033
