300000000000000000000000000000000000003000000010000000000000000000001200001000000000000001050000000300000000000000303000000000000000030030003530000100000000000003000300
300000000000000000000000000000000000000000000000500000003000000000000000000000000000000000000000000010000000000000000000000005000000000000003000000000000000100000000030
000000000000000000000000000000100000000400000000000000000000200300000000000100000003301000000000000000030000010300010000000001000300300000500001000300003000000000000003
000000000000000000000000000020000000000030000003000000000000000000000000000000000303000000000000000000000001000000000000000000000000000000000000000000000000000100301000
000000000055555500000000055500000005000000000003000050000000000000000000000000000001050000000001000005155000000050000000006555100000000000000000000600000000000000330000
000000000033333000000000333300000103000001000000000000000000000000000010000000000030300000000000001003333300000030020000000333020000000000000000000002000100000000100000
000000000000000000000000000000300000000000100000031303330000000000000303033300000033000000000000000000003000003300000000000000000003300000000000200000000310310100013033
000000000000000000000000000030020000000000000000000000000010000061000000000000000000060030000000000000000000000000000010000000000000000000000000000000000000000000000000
000000000000000000000000000030000001000000000000000000000000000000000000000003000000003000000000000000000003000100000000000000000000000300000000000300000030100030000000
000000030000000000000000000300030002000000000003300000000000000000000003000000000001000000030000004000000010000000000000000000000000030000000000000000000000000000000400
000003000000000000000000000000000000100300000000000000000000000010003000000001000000000001000000000000010000040000000000003000000000000000000000000000000010000100000000
000000000000000000000000000000400001001555100000000050551500000000005000355550000555000010000000000004000000055500000000003555000000000000105500000000015500000000005555
000000000000000000000000000000040000003333000030000013333000001000000000033300003133000000000000000000000000304300000000003303000000000010100000000001003300000000003331
100000000000033333333000003300000000310100000003000100000410000100000000000000000000100000030000033333333000000010000000000000330333300050000005000000000033333330000000
