000000003000000000000000000005400000003000000000000000000000000000000000000000300000003000000030000000000010000000000000000000000000030000000000000000300003000000000000
000000000300000000000000000300000000600000100000000300000000000100000000000000000000000000300000000000000003040000000000000000000040300010000000000000000000300000000014
000000000000000000000000000000000000600000005000000000000006300000000000000300100000000000000000000036000000040000100000000000000000100000000000030000000000000000000000
000000000000000000000000000003001000000500000005001000000000033000005000010100000010000000000000000000000000000000000000000000000000000003000000000030000000001000000060
000000000000000000000000000300000000033300000000000000400010500100000000000000110000000000300000000300000030000005000000000000000000300010000000000000300000000000100010
000000050000000000000000000000000010301000000000356010000000000000000300020005000030000000000000000000030500500000000000000500050000003330000001000000000000000000100000
000000000000000000000000000000030000033303003301300000000010300003333300000000000003000000000330030000000100000000000000000000000000003003330000000000000000010003333334
000000000000000000000000000000000031000000010000000060000000000000000200000000000000001000000000000030030100000000000030000000000000103000000000350000000100000003300000
000011110000000000000000000000000000000000000051000001110000001000011100000030000000000000000000000000111100200000000001000113000000000000001000000000010031000010000000
000000000000000003333000000000000000000000100333300005000000000000000000030000000333000330300030000000000000000000000000000300010333300000000000000000050000000000003030
000000000000000033000000030000200200000001300300003000000000300000000000001000030000003300000600000400000000030000000000000002003000000000000003000000530000000060033000
000000000000000333000003330060000000000003033300000000000030300000000000000000333000030000100010000000000003330100000000000000133300003000010000000003330000000031350000
000000000000000303000033330003000000000030030000000000000330300000000000000010300000630300000000000100050033000000001000000030030000150000000000000003300000000000303000
333333300333330333333033333300020600000000033033031303030033303000033300000000330333003333300000003330303033033011303333333333033333300000000033000003333300000000331333
