000000000000000000000000000000000000000000000000001001000000030100000000001000000300000300300060000000000000000000003060000000000000000000001000000000000000000000000000
100000000034000000000000000000000000000000000000010031001000100000340103003000030000100000000000000000130000340000000000000000000010301001000000100000000000000000100000
000000000000000000000000000030000000002000333002000000000004000600000000000000000600001003000000003300000000000030000000000000000000001000330500005060000300000016003000
000000000000000000000000000030000030030000000000000000000000000003010000000000020000000000560000611000000000000000000100003000000000000002036000000000020300000330000000
000050000000000000000000000030000000000000002100000000000000000000300000003330000000600053000033030000000000000030000300001001001050000033330000000000336300033330002000
100010000000000000000000000000010000000000000000300000000000100000000033033000100030100010033333300000000000000000300000006000000030000333301000000003303303303300000000
000000000000000000000000000000033301100001331300300000000001000000300003000500000000000030333133303033033003000001031330000000000000130333330000000303103330033300000000
000000000000000000000000000000000000000000000001000500000030000000000000000001000030000000000100000000001000000000000000000300030000000000000000000001000000000000000000
000000000000000000000000000010000010000000000000000100400000000000000010000003000000000000000000000000000000000000000006001000000001000004003000300000000000000001000110
333000000000003000000000003300000010303011000000000000333000000000533300000003330050000003300000100000000000000000000000000000330000000000000040000300000033300000000000
000000000000033000000000023300000000000100000000300002030100006000003300000000030000000020330000000000000000000000100010000000003000000000000000600300000000000302000000
000000000033333000030000333300000000400030000030300033030300030000300300000000000000000333330000000000000010000000033330000010000030003000000000000300035300010000010000
000000033333303000000003333310001001000000333303000033133000002003333100000030000000006353130000000000000010000030300001000000000000000010000000000360000000000001000100
333303333333300003333333333300000000000000003333030330330003333033333000000003331003030033000034030000000500100030330300000000330303000600030000000000033330330330000000
