000000000000000000000000000000000000000000000000000000000000000000000000100300000000000000000000000300001000100000000000000000000000000003000000000001000000000000000000
000000000000000000000000000000000000030000000030000100000003000000000000000000400001000000000000000000000000000100000000000033000060000000000000000000000000000000000000
000000000000000000000000000006000004004130000000000000000000000000000000000000000000000003000000010000000000630000040100000020000000004000000000000000000000000000000000
000000000000000000000000000001000000000000000000000030000000000000000000000000000000100000010000000000300000600000000030004000000010010000000000000000000060000000000000
000000000000000000000000000000000000001000200000001000000000000001000000000000000000000000000000000000000006610000600000000000000000000000000105000000000100000030003000
000111111111111100000000000011011010202000001003000000000003001110030000023000000000110040000000000000010006000002000000032000001000101000000001111000030000003001011011
000000000000000000000000000000000003010301033300001000000000000000000000033333333330000003000000000333330300030333333330000033000000000000030000000100313000000000000000
000000000000000000000000000000003000000000000000000000000000000000000600000000000000000000300000000000000000000000100000000000000000000300000000000000000000000000000100
000000000000000000000000000000300000010000000000000030000000000000030000030000000000000000002000000050010000000000000000031000000000000000000000000300000001100000000000
000411000000000000000006600003000000066000000000000000000061000100411000000000600001000411000000000000000000000000630000006000000000000000000006000000000000000000000110
000000000000000000000006600000000000066000000010000030000066030000000000000000000000000000000000100000030000000000060000020000000000000000000066000300000000000000000000
000000000000000000000006600000000000066000000030010000000060100000000000100000000000003000005000000000000000000000660000000000003000000000000060000000000003000000000000
020200200000000002000006600031000000060000030201000000110066000000200211110110001101000200211151110001111006000000660100001111000000001000000066000110000000320000200002
333333333333330333333333333300010003333501103103300000000313613533333100000000000000033313300050000000000333330033033030000000333303300000003330033000000003303333303333
