000000000000000000000000000000000300101001000000000000002010000000000000000000000000000000000000000000000000000100000001000000000000000005000003000000000001000003000300
000000000000000000000000000000000000000000010033000000100000000000100000000000000002000010000000000100300000000001000003000000006000000000000000000000000000000500000000
000000000000000000000000000002000006000000000000000030100100000000000000000000000030000000000000000000000010000000000000000000300000000000300000000000000200660000000000
000000000000000000000000000000000000030303010000000000000003000000000000300000600000000000000000000000000000000000000000000000000000000031000000000000000000000000000000
000000000000000002000000000000000000000000000000000010000000000004000030000000000000000000000000300000000300000000000000000100000000000000000000000000000000000000000000
505550000003000002000000000000000000003000000001000100000000001000030030000000000000000030000000001000004500550300000000000000000060000000000000000505550000300000003300
000000000330000000033300000000000003000000000000000000000000050003000000000000000000003300000001040000000000300000000000000000000000010013010000000300000000000300033000
000000000000000000000000000000001030000000000000000003000000000000000010000000000000000000000000030000000000000000000000000000000000100000000016000000030000010100000005
000333000000000000000000000001000000000000000000001000010000000000000000000003000000000100000100000003330004000000003000000300000300000000000000100000000000000300013000
000000000000000000000000000000000000500000000000000000000000000000000000003000000000000200000000000100000300000000000000000000000000000000000000000004000000010001000000
000000000000000000000000300000000011000000000000000030000000000110000000000001000003000000000000010010000000300000030000000000000010000000000003000000003000000000000110
000000000000000000000000000000000000000000000200000000000000000000000043000100002000000002000020000000000030300000000000000000030000000000000000000000000000020000000000
300000000000000000000000000000003005055500000230000000000000000000540000100000002200000000030030000000010000000030000000000010000050000120000000001000000100000003000000
000000000000000000000000000000330000000000000003000000003000130000000000000000000000000000000000333000000000000002300050000000000000000300331200000303000000000330002000
