000000000000000000000000000000000000300000000031001300000000000000000300010000000000000000000000003000001000000000500000000010000300000000000000000003000000001000010000
000000000000000000000000000000010000000000000000000005000000000000000000300000000000100000000030000000300000000000000000000000000000001000000300000000100000000001000000
000000000000000000000000000000000000000000100000000020000000000000002100020000000000000000000000000000000010200000041000002000000000000010000000000000400000000000002000
000000000000000000000000000000000003000000000000000163300000000000000001660331003000000003000000000000001000630000000000006030000000400000000000000000030020000100000000
000000000000000000000000000006000000000160000000000660000063000100000000640000000000000000100000000000000056600000000600036000000000000000000000000100000000000000060000
000110000011111100000000000000003020000110000003000660000001111110010020600000000000000110004000003000000001000002022000036000000000006000000001100020220000000000066000
000000000000000000000000000000333330000000000001003333000003000060000033033000000000600000000050030020010333330033333333333010060000000000000000000333333000330330303300
000000000000000000000000000000000000000010000000000005001000040000003000000000000000010000000006300001000000000300600000010000001003000000000000050000001000000000000000
000000000000000000000000000000000000001000300000000000000000000000101000000000000000100000000100000000000000000003000000000000000000000000000000030000300000000030000000
000410000020000000000000200000040000002000000000300300000000000000000000020000004100000000000021000000030000000000000000000000000000000001000000000000203300000000000030
000000000660000000000006600000000000060000000000000000000000000000000000600000000000000400000660000000000000000100660000000000000000000000000000000506000000000000000100
000000000660000000000006600000000000066000000030000000000000000020003000660030300000000000000660000000000000600000060000000000000000300000000100000006600000000000010600
020220000660000000002006600002022000066000310000000001110000002000100000600000202000000000000300000002000000111000660100050002110000000011113001011000600000000001000000
333333333333000033333333333333333300303330000000000020300003303300000033330333330033003303333300330363333000000003301330033300000000000000000000000003333300060000001013
