000000000000000000000000000000003300000030000400000000000500000000000000000300000030000010000000500000020000000000000000010000000001000000000000000000000000000000000000
000000000000000000000000000003103300000000000000000000100100000000000000000000000000030000000000600110000000000000000030000000000000000020300000100000060000000300001000
000000000000000000000000000000333030000000000000000000000000000000000000000000000000000000003000000000000000000000000100000000000000000313300000000100000000333330000000
000000000000000000000000000003333300030100000000200300000000002103100000000020000000030000100000020000100000000000000120330003000000003334300000000000000260333340000000
000000000000000000000000000003333330000000000006600030030000010000000000000000000000000000010000660000000000100000003660000003000001033333130000000000000631303030000030
000000000000000000000000000033000300000000000006601100030001066000000300000260000000000002000000030030000000000000000060001003000100033033330000000000006033163030000000
000000000000000000000000000033330000300030003313510321333033313033003030353330020000333303303330330000000000000033500333333330000000003330000000000303033033300000030000
000000000000000000000000003000000000000000000000000000000030030000000000000000000000003003030000000000000000030000000000000000010000030000000030000000000000001010603000
000000000000000000000000033050000000000000000000060000000000000000000000000030000000000033000000000000100003000000000000000000000000000001000000300000000000503005000000
000000000000000000000003333000000050000005000000000000000033330000000000000000000000003323000000000000000000300000000000000000000000000000000000000000000000000000000000
000000200000020030000033333000000000000000000000200030003330055000000000000000000000033033000005000030000000000600040000000000000000000000000000002000000010363000000000
000006600000000000003333333300000100600000000300000000003333333000033000000000000000333330300000000000013110000000001000001000000000010001000000000000000000000010060000
000006600000220000003333333360000010000000000002200000000133303000000000100000000000303333000000000000303000000000000000000000000000000000220000022300000000000030000000
333333333333333333333333300000000000330012303333330000000303000000300000000002000010333000000000003330333000600000000000000000000030033003330333333010000030033300000000
