000000000000000000000000000000020000000000030000003333500000000000000000000331000001000000000500000000000000000033134000000100000000300000003000050000001500100330000000
000000000000000000000000000100000010000000000000000000000000000500000000000000000000000200110103000000000000000000000000000000000000000100000000000000000000000000000000
000000000000000000000000000000000000000000300000001020000000000000000000000000500000000010000000000000006030000000000006000000000000000031000002000000010003000000000000
000000000000000000000000000000000000016000000000000100000000000000000005001030000000000000000000000000000000000000000000000000000000000000000000000000000000000000001300
000000000000000000000000000000000000000000000000350000001100000000060050000000030000000000000000000300000030000000000000000000000000030000100010030000026030000000000000
330030000000000000000000000000100000000000300030300000003310300000000033000000000000000000000000003302300000000000000003010300000000033000000000000000000003030100000000
000000000000000000000000000000003030000000300000000003330000000333303000000000000000000000000000500001000000000000033330000000030000000000300030333000032000000000000003
330000000000333333350000000000400000000013000003000000000000000330000030303500000000330000000000000000003303330101000000003000000000030000000000000000000000050003010000
000000000000000000000000500003000002000000000000000100000000000000000000000000000000000000000050010000000000020000050000000001000000000000000000000000000000000313000000
300000000000000002000000000000000000000000000300000000001010010300003000020000000010000000000100003100005000000000000000000000000000030000000000000000000001300003000300
000000000000000000000000000000000000000000000000000000000000000000000000050001000000000003000003005000001000000003001000000000000010100000003000000000000000000000000003
000000330000000000000000000000000000000000300010000000000000003000010300000000000000000000100000000000000000000000010000000000000000001000030000000003000000000000000003
300030333000000000000000000000000003300300330100030000000000000300030300000000000000300030300000000300100000000000000000000000000000030003033310300000000000000100000303
000000000000000033333333333301000600000000000000033033030000000001300010333030300100000000103331330000000103033333333331000000000000000000000000000333333300000000000010
