300000000000000000000000303305000000000000001000000000000000010000000000000001000000000000000000000000000100000300100000000001000000000000000000000000000000030300000000
300000000000000000000000003300000000000000030000000000130005000030000030000000000000000030000003000000033310000000030000060033000000010000000000333000000000000300000000
000000000000000000000000000000000003300000000050300000000003333000050000000000000100000002100000000020000000000033000000100000000000000030330000000030000050000003000030
000000000000000000000000000000000001200130000000000000010000003030000000100000000000000000000000000000030000000000000000000000000000000000000000000000000001000000000000
000000000500000000000055550000300000000030030003000000000000000000000050036001000000205000000530000000000000000000000000000000000000000000000000000105000006115000000000
333003033330000000000033300033330003000000000000000100300000000001000033300300000000000000033330000000000333003030300004000010000000123000000000000303000003360303000000
000000000000000000000000000000030003133333000003000301050000000000000300000003000000000030300000000006000000000030330303003000000000000000000000000000300000000000003303
000000000000000000000000000000000000003000000300000000000003033200000300000000300000000000500300000330000000003300001000100000330000003030300000000000000030000000000030
000000000000000000033030000000000001000033300000600000000000033000003300000600000500000020000000000002000000003300000030300000300000000000330300000000000030000000000000
333000000033330000000000000000033330000300000000000003000001000001000033300001000000000000000300000003333000000000000000000000000000000000000000000000043300000000000000
000000000000000000000000000000000000100001000000000000000000060000000000000004000003000000000300000000000000000000000010000000000000000000001000000000000000000100000000
000000000000000000000000000000000000055500000000000010000555500000000000000000050000000010000000000000030050500000500000000000000000005555000000000000000000300000000000
300000000000000000000000000000000000333000333003000000000033000000000030000600333000000000000000000000000030300033000000030000233100003330000000000000000003304000053000
333333300000000000000000033300000000300000004000000000000000000000000033333000000000000000033333330000000000000000000000000333000300000000300000333000030000000000000000
