000000000000000000000000000020000000000000000000003000300040000000000000000000000000000000300000006000000000000000000000000001000000000000000004000000000000000000000030
000000000000000000000000000000010000000000000000000000000000001000005001000000003000000003000000000000100000000000006000000000000000000000000000000100000000001000000000
000000000000000000000000000000300000000000000000000000000000100000000000000010000000000000000000500000001000000000000000000000000000000000000000000000000000000000000000
000000000000000000000000000000000000000000000000000000000000000003300000000013030000000000000000000000100000000000000400303000060000000000100000000000013000000000000000
000000000000000000000000000000000000000030001000000001000000000000200000003100000000000000000000000000000000000010000000000000030000000000000000000000000000000000010000
000000000000000000000000000000100022002003000000000000010000010030000000000300000020200230000000000000000000000000100000000000000000010000030030022000100000600002022003
000000000000000000000000000003303333353333333333300000000000000000001030603330313303303133300333030000000000006000000033000000310333333330313333333000020000006013332333
000000000000000000000000000000030000000006000000000030000000000000000200030000000000100100010000000000610001030000000000000000000000000000300033000000000000400000000000
000000000000000000000000000000010300000000000000200000000000000000000100000060000000100000000000100000000000000000000000000000000000000000000030000000000001000000000000
000000000000000000000000000010000000300001000000000000000000000000000000000000000000000000000000000000000010000000000000000000000000000000000100000000000003000100000000
000000000000000000000000000000000000030000000000000000000000300000000000000100310000000000000000030000000000000000000000000000000000000010000000000010100100000000000000
000000000000000000000000000003000001003000000003000000000000000000010000000100000000000010000030000000000030100000000000100010000100000000000000000000000000000000300000
000000020220000000000000002203003000000000000000010006000001000202200000000000000001000000006300030010000000000200000000000000632200000000000003100000000000000000000000
333333333333330033333333333300000600032333000000000000000033533333303300000000050000333333103000000000000333003300000040003016030330100303033330333001000000100000003333
