000000000000000000000000000000100000100000000000000100000000000000000010000000030000000000005000100000000000050000030000000000003603000000000000000000000100000000000000
000000000000000000000000000000400103000000000000000000010000003000000000001100000001000000000000000300000000000000000000100000030000000100000001000000060600000000100003
000000000000000000001100111000000000000000000110111010000131110000000110001110000000100000010011100001000000010000000001001100000500000000001111000100011000000011100000
000000000000000000001000000000110000000000300000000000000000020000000100000003000000000000000000000000300000010000000000000000000000000000100111100000000000000000001000
000000000000000100000010000000000000000000000000006001000006000010000001001000000000030000010000000000000000000000000000100001000000000000000013010010000001000000003000
000000000000111111000111144001000030000010000000200000000000000103120001034400000000000000011611400000000000000000010000111440000001000000005510110101044011110000000055
000000000000000000000000000030000000000000330333300000003313020000050010000000000000000100000000303000333330000100003000000000000000030006003333033000000000000003033333
000000000000000000000000000000000000000000000000000000000000000030001000000300000000030300000010000000000000000010000101000000030000000000000000000100000300000000000010
000000000000000000000000200000000000000010310210000000001000001300000000300000000000000300000020000000000000000000000001000000000000000020000000001000000000000000000100
000111000000001100000111110000000310100030010310000010100000000111010011000000000030110000001101000000000000000100001100100000000000110311000005006000111000000000003001
000000000000000001000011111000000600000000005111000001000000000011111000010000000001000100001101100000000000100101000000001000000000101101101000000000001000000000001000
000000000000000000000001111001000000000000001010021400000000000001100000000000000000000000000111100000000010003000000000000000010003000111101001003000000000000000010000
000000200000000000055551111011111000300000551011010114400060000051010000000550000011000005503111160000001011000000000020000055010100055011000010000000000000300100003000
333333333000003333333333333300000003303333330333300000003300000303000103331030000000033300333333330001000300000000333333333303000000033333330030000503533000000000000000
