000000000000000000000000000006000000000000000040100005060000000000000000000000003000000000000000400200100010000000300050000000000000000000000000000000000000000000003000
000000000000000000000000000003000300000000000030000000000030000000000000000000000000000000000300000000000000000000000000000000000000000000000000300000000000000000000000
000000000000000000000000000000001000000100000003330000000030000500120000000000300000000103303000001000010000000000000000000000000000303000000000100000000000600033330000
000000000000000000000000000000000000000000000033033000000000000000000100000000030000000033303000000000000000000000000000000001000001033000000000000330000000000000010000
000000000000000000000000000000030000000000030303333000000000000000330000000100000300033331033000000000000000000000000000000400300000033000000000100330000000510000000310
000000000000000011000011110100000060015000003333330000000041000003333000000000000000000333333000600100000000300000000000111101501100003000000000000301000000113000033330
000000000000000000000000000000000000000000333003300030330000000033033000300000000000033033630033013000000000000000000000010000000000000133030000000300303300000003330330
000000000000000000000000000000000000100000000000000001000000030300000003000000030000000000000000000000000000300011030100000000000000000000000606000000000000000100000003
000000000000000000000000000000000000001000000003000000005000000000000000000030000000000000001000000000000000000000000010000000000006000000000000000000000010000000000000
033300000000333300000100000000000001000000000000000330003010000000013300000000000000000000010000003000000030303000000001000000000013303300000050000030003310000000000000
000000000003333300000000000200001060001032000000000300001000000000030300000001000002000000000000000000000600000000000013000002000033303000000000010050033000000020000000
000333003333333300000000006600000000000060000000000033303300000003333300001000360066000060000000060000000000103000000000000066033333300033300000010000333360000660006000
003333000333333300000000006600000000000036000100130033300000010006333301010010010066116110000100600011010003333000000030000060003333300333300110100003300300000660310000
333333033333333003333333333300000000330333000000033333103003303330033300000000033333003030033333300600000313333000000000503303033333033330303000010033360330333330000000
