000000000000000000000000000000000000000000000000000000003000060000003000000001000000000300000000003000003000000000000000000000000000101000000000000000000000000000020000
000000000000000000000000000002000063000000104000000000000000000000300000000000300030000000002000000000101000000000000110000000000000002100000030000050000000300000000000
000000000000000000000000000066000000000003001001000000006600000000000100000000000034001000060000000600000000000010000000000000000000006600000000000000000000000000000000
000000000000000000000000000006000000000000000000000000006630000000000300000000000000001000000000000000000600000000000000000000010000006000000000300000600000000300000000
000000000000000000000000000000000000000001030300000000006600000300000000000000606600000050066000000001000003300000000000000000011030036000000000001000000000000000006000
000000000002000000000000000066000000000200000100302006000600000010023000100000200000000000066000060000000003000000000000000200000000066030000000000000020000000000200600
000000000003333000000000000033030300000333300310030333300333300000000133033333303133330333033000003330333000000000000003001030303333033303300303306300003330500003330303
000000000000000000000000000000000000000000000000000100000000001000000000000000000000000500000000000000000000430000000000311000000000000000000000000000000000010000000130
000000000000000000000020000000000000000000100002000000000000000000000000100100000000000000000000000000000000000000000000000000000300200000000000035000001002000000100000
000000000000000000000660000000000000000000000300000000000003000000000000005100000000000000000000000000000000000030000000300001000100000000000300000000000066000020030000
000000000000000000000660000010000000000000000000000000000100000000000000000000000003000006000000000000000000000000000000000000000000000000000000000300010006000000000051
000000000000000006600660000000000000000000000000000000000000000010000000000005000000060660000000000000000000000003006000030000000001000000000000300000000060000000000000
000000000000000206600660000000000000003000000000000000000000000000000100003000000000000660100000000000001000120002066000000000000000000000000000000000000066000000300000
333333033333333333333333333030000003303313000000000000000000303000000030330300000010303300310000600004000000000333130333030333300000000000000000300000300331333305006300
