003000000000000000000000000000000000300000003050000000000300000000000000100000000000000000000000000000000003000000000000000000003000000000000034000100000000000000000000
000000000000000000000000000000000000000001000030000000000000010000000010000000000000000000000030000000000000100000000000000006300000000001000000000000000000000000500000
000000000000000000000000000001000000010000001001300000000000300051000000003000000000301000003003000011100000000000003010300001000000020000000000000000000003100000030000
000000000000000000000000000000000000000000000000000000000000000000000000030000000000000000033000000000003300000000000003000000000000000000000000000000000033000000000300
000000000000000000000000000000000000000000000000000000006000300005000000000000000000000000000000030300000000000000000000031000000000006000000000000002000000000010000300
000001010111100000000011110100111000000010000301000030000000300200100010100100010100200610300002100000000001110100003000000020000000000000000000000011110000002200000300
000000000000000000000000000000000003313333000000000000003330033003303000000000000000330333330333330030020000000033303335030300000000000000000000000000000030300333333033
000000000000000000000000000000000003000000001000000000000010030003000000000000030000000000000000000010000003000000000010300003000004000000000030000000100000005000000000
000000000000000000000000000000000000000000000010000000000000000000000000000000000000000000050000000000300000000103000000000000000100000000000000000030000000000000001000
000030000111000300000001000000001000100030000030020001000011000000000003000000000000000000020000000000300000000000000000011131000000000000000000000000000000000000001100
000030000000003300000000000000000040300000040030000000000000000000300033000000300005040030100030000000360000000000000000000000100000000030000050000000000010000000000000
000030000000000000000000000000000000000003000010000000000003000000404030000000000000000000000000000030300031000000000000600000000000000050000000000000000300000000000002
000030000000000000220200000000000000000200000030010100100000000011110100002000000315101100010000000000300000000010010100000100210000001101012000000001101100000000000030
333333300000303333333333333300000303303333401003300000000000030000000033361330000000000033000000003303033000001000000000000030333333000000000333330000000000000000000030
