003300000000000000000000000000000000033000000000000000000033000000000000000000300000000003000000000040000000000003000000000000500000000000000033000000000000100000000003
000000000000000000000000000000000000000000301000000100000050000000001000000000000000000000002010000003000000030003000031000000030000000000004000000000000000000000000000
000000000000000000000000000000010000001023011010000000030001000000000000000000011050000000002000000000000051100001001001010000020000011110000000000000000003000000000000
000000000000000000000000000000000000000600000000000000300010000000000000030300000000000050066000000003000400000000000000000000060000000000010000300060000000000006040000
000000000000000000000000000000000000000000100000006000000000000000000000000000000300000000016000005000000000300001000000000000663000000000000000000060000000000000000000
011400000000000000000414100000100010164000000000060000020114000000000040000000000000000000066000004131000000000000000000000000600000000000000001000600000341433000000000
000000000000000000000000000030000030000000330033333300330000000000000001010003003333000300031330333000000033333333630300000003333333303333330000100333333303000000000000
000000000000000000000000000000000000150000000000000000000000100000000000000000000000000060000300010000000000300000000000043000000000000000030000050000000000000000000000
000000000000000200000000000000000000000000000000000000000000000020000000006000000000000000000000001000000010000000000000000000330000000000000000000050000000500000000000
111100000000000200000011010000000003111000202000000060000010100020013000000000000000100000130110300000000000000000000012000010030000300000000110100000000001013000000000
000000000000006600000000000000000000000000000000000000001000401660000000000000000003000000000000000000000040000600000003010000100000000000000000000000000000000000000000
000000000000006600000000000000000000000000000000000000000000010600000000000100000000000000000000000000000010000000000000001000004000000000000000000000000000000000000000
200000000000006600000000000000000002000000000000040410000030000660000000000030000000000010120000000000000011400000000000004010030000041410000000000010003100030000300000
333333330000033333333333333300010003333300000010000000003303333303333340000030000000300000333333330000000000000000000000000000040000000000013333330000000003330333000103
