000000000000000000000000000000000000000000000000000000000000000000000000000000000000000000001000000000003030300000000000500000000000000000004000000000000000000000000030
000000000000000000000000000000100000000000000001000000000000000200000000000000000000000000000003010000000000000000000300000000000000000000000001000000000000000000000000
000000000000000000000000000000000000000000000000000000330000000000060010030330000300000030000033300000000000000000033330001000000430000000000010000000010030033330000300
000000000000000000000000000000000000000000000000000403000000000000000000003000000003000030000003100000001000010000003000000000000000000000000030000000000000003000000330
000000000005000000000000000000000100000001001000003003000000503003050053000000000000000000000033000300000000010000013000300000000010000000030000510000005000303000000000
000000000033300000000111111100003300101111000000330003000003330000000000603000000000000000000003000030000000060000003000000000000000000000000000330000100000003000000030
000000000000000555000000000000306000003000010000033330300000000005500013333003030303000000033303003330333000000033030304303333000000015500000000000000000031333600000000
000000000000000000000000000000000000003300005003000000000000000500005000000000000000010000000000000100000000001003000000030000000010201000000000300010000010100000100000
000000000000000000000000000000000000000000000000000000000000000000300030000000100000100000000000000000000000000000010001100000000000000000000000000000000000000000000000
000333300003000004400000000000044030000300030000000000000000000000000000003000000400000000000000000000000000000000000100000000000000000000000000000000000000000000004400
000030000003000000000000000000000000000300000003000000000000000000000000003003000300100000010000000000000000000000000000000000010000000000005000000050000000000005000000
000030000000000000000000000000000000000000100000600000000000000000003000100000000000000003000000010000000000000000000000000530030000000130000003000000000000000000000000
000030000000000000000000000000030000000000000000000000000000000011101000000100003000000000000000000000000010001000000000003330310011160000011101111100000000000000000000
333333000000000333333333333333333630000000333033305500000000000000000000100000333333301333015500000000000000000000003000000000500000033033300000000055505033330330333133
