000000000000000000000000000000000000000100000000000000000000000000000000000005000000000000050000000000000003000100000000000000000000000000000000000000000000000000030003
000000000000000000000000000000000000000000000000031000000000000300000000006001000000000000030000000003004200000000000003000005000000033000000000000000000000000000000000
000000000000000000000000000000300000000000000000000010000000200000000100000000000000000000000010010000010000020000030000001000000000000000000000000100005000000000000003
000000000000000000000000000000000000000200000000000030000001600000000000002000000000000000000000000000000001610000000030000000000000000103100001600000000000002000000000
000000000000000000000000000000050300006600100000000030000000600000000000064210000000000600000000000001000000660000000000002000000000000066000006600000010000066000000000
000000000000000000000000000000000000006600000000000000000000000000000000066000000000000660000000000000000100060000000000000000000000000000000000600000000000166000000000
000000000000055000000000000000000053030030500050000150001003433000000003033333330333333333033330035000000000330303301555000000003333133333300003333333333303003000000000
000000000000000000000500000010000000000006000000050000000100110000010000000000000000100200003000000001000000000000000030000000000010050000000000000000000050000030003000
000000000000000000000000000000000000000000000000100000000000600000000500000000000001003000000030000000310000000000003000000000000000100011000000000030001000100006000000
000020000000000000000000000000002000010000000010600000000000000000000000300000000000000000000000003000000000000100000000100000000000004003000000000000000000000000030000
000660000002000000000000000000066000000000303000000000000000000000030300000000000000000000001000000000000000001006003000006600000000000000000400100000000000000000000000
000660000066000000000000000000063000001000000000000000010000001000000000001000000000000000000000000000000000000000000000003600000000000000000100000000000000000000001000
000660000066000000000000000000060300000000000000000000000003000000000001000000000000000000000000000000001000000000000000000603000000000300000000000000000000000000000000
000333333333333333333333333300303030000100033333333330030000005333300040000000000000000000030000000000005303033000000000003333000000033330335300000000016033033100000001
