000000000000000000000000000000500000300100301003000000000000000000000000010000011010000000000000300600000000000000000000005000000000000000000000000000000000000000001000
000000000000000000000000000000300000130000000100000000000000000000000000003000001000000000000000000100010000000000000000000000003000000000005000000000240010000000000000
000000011100053300111111111131011010030030001300033001110111030000060533101110003030111000000000000100033300101113000001011000300111010100031101300300111130001110003000
000000000000001110111111110000001010000033000000011301011110100000200011101110100300011011000000000000030000000311001111001010000010100000001101100000010311001110000000
000000000000011111111111111110000000000033000000000011111310101000000111111310000001111110000000000000033300030001014011111250300010030000011161100300016011111100000100
000000000000011111111111111113001500000030350000001111110101001030000111111010003000111110000000030000033030313511001011100110330010000003011110510300015501101000000000
001100001000000000000000000033333303100001001033300000000000000010005000000000630333330301500010000301030301333000000003103030333330301000003333000333303300000000363335
001100001000000000000000000000003000000010000000100000000000000000000130000000100000000000000000000000000033100000000000300000001100001300000100000000000000310000000000
000100001000000000000000000000000000300000000000000003000300000000000000000000303003000000000000000000000000050000000000000000000100001000000100000000000000000000000000
000300001000333001111111100001111101111000111000500000001113000000111100001000100033110011011000053303110000300030000001110111000300011000000100033111003500000000111111
000000000000330000101111111011111001111110000000000000001111110000010100000003000033110110001000001100110000000000000011111000000000000000330000033100300000000100011160
000000000000333000100111110011000000110500000000100010001111100300000000000011000033111011100000011110110000000000000003011110000000000000030000033000000000000041101101
000000000000333300155111111001101011011100011000100000021011110330015030000000030000120111003004211101111000000000000001111100000000003000330000000000000000000001101011
033333333000333333333333333003000000333300030000000000003330330301333306110003000003000000001010000000000033330300110000000000033333033000333000033100000000100000000000
