000000000000000000000000000000000000000000000030000000000000000000000000000000010000000010000000300000000000010000010000000006000000010000000000000000000000000000000000
300000000000000000000000310000000000000000021000000050001000000000000000300600000000300000030000000000000000000000001000200000000310000000510000000300000000300000030000
000000000000000000000000000003000000000000610000000001000000000000000060000000000000000001000000000000000000010000000000600000300000000001000000000001030000301000000000
000000000000000000000000000000000000000000600002020000100003000000010006000200000000003410000000000000000000004000001006000303000000010000000000000000000030100103000000
000000000000000000000000000000000000000020063000000000100000030000000060000000000000000000000000000100000000000000000000000000000000000000000000000000000000000000000000
050000000000000000000000000000000000010000061000000000000300000000300006000000000000000000000004030000000000000000300006600000000000005000000000000050001000000000000000
000000000000000000000000000000400003303133033000005000000000003033333333300000000002000000000001100000003000000000000003010000000000000000301000000102000033333033303000
000000000000000000000000000000000000003000000000053000000000060000000500000000100000000030000000000300000000000000000000000003000000000000000100000004000000000000000000
000000000000000000000020000030000111500131000000000001000000000000300000000000003000300300000000000000600020000000000000000000000000000002000003100050000000000000000000
000000000000000000000660000000000000000000000000060000000000000000000000000000000000000010000000000000000060000000000100000000001000001400000000000160000003000303000000
000000000000000000000660032300000000000000000000000300000600000000000000010000100000006000000010610000300660032000300000000003000000000000000000000660002000000100000000
000000000000000000000660000000000000300000000000000000000000030000000000000000000000000010020000000000000060000000000000000000000000003000000000000060000010000000000000
000000000000000000000660000005000100010000000000000002000000000050000000000000000000000000000000100000000660000000000000000000000000000000000000000000000000000000000003
333300000000033333333333000000100003333000100000300000003330000000000000000000100000010000033350003303330033000033330000000000000000133333331000300333000000006030000000
