000000000000000000000000000000002000000000000106000000010100000000000000305030000000000000000000004000000000000000000000000000000000003300000000000000000000000000330000
000000000000000000000000000000000000000000001000010000000000000000002000000000000000000000000000004060040000500000000030200000000000030003000000000000000000000000001000
000000000000000000000000000030000000300000000303300020000110000300000000103000000000050033300060000100000020000000000010000002003333310000000000000003033300000000000000
000000000000000000000000000000000000000000000000000000000000000000000000000000000030100000000000000000000600000000000100100000010000130000000000000100000305000000000001
000000000000000000000000000000000030000000630000500100020000010000020000000000000000000030000000000000000600000010000050000003100000000000000000000000000060000000000000
555500000000000000000000003000000000300000000000055000600000000000003000000005005000000000000000000000031600000000000005005000000000000010000000000000003000000000200000
000000003333300000000000000000000000000000000500000000005333303000000006000000000000130023003330300000000333333013333300000000000000001333300000000000003000000000333033
000000000000000330000000000020040000000000033000003010000000000000000000000000000000000000000000006000000003000000000000000000000000201000000000100005000000000000000000
000000000000000000000000550000005000030000000000000000000000000001000000005000000000000000000000000000000000000000003000000000000550000003000005500000000000110000004000
003333300000000000000020000002000000000000000000000000000000100300333000000000000001000000010000000000000000000003000000100000020000000003000200000000010001000000010000
000000000000000000000660000066000000013000000000000000000000000000003166000000000000050000003000000600000000000000000000100000634000000000003610000000000000010000000000
000000000000000000000660000006000000000300000000000000001100010000000066030000000000000000000000000001000000040000000000000100660000000000006600000000000000001000000001
000000000000000000000660000000000000000000000000000000000000500000000066000000000000000000000100000000036000000000010004000000003060000000306600000000000050550010000030
000000000000000333333333333033303300000000033033303333350303330000000033363000030000000000000000000000000033333300000000030000336333000000000333330331310000000600030000
