300000000000000000000000000000000000000000000000000000000003000000000000000000030300000000000000030000000000000000000000000000000000000000000000000000000000000000000000
000000000000303300000000000011000000000000000003033000000000010001013000000000110000000000000000003300000100000033000000053055000500003000300000030330000010000330110301
000000000000000000000000000000000000010031100000000000003000000001000300000000000006060000000000000000000000000000000031000111000001100000001000000000000000000040000000
000000000000000000000000000000000000000000500020000300000000010000000000000000000000000000000600000000002000000000000000000050000000000000000000000000100000000000000010
000000000000000000000000000000000000000000000000000000000000003000000000000000000111000001000001100000000000000003060000010000000000000000000000000000000000000000000000
000000000000000000001100000000000003000000000000100000010000000000000010000000000000000000010000000010001000000000200000000000000000000000000000000000000100000000000000
000000000000000000000000000033330330005533100001000000000300000000304000000003333333330000000000000000000303333300300000333033000333300000005001000000000000000003303303
000000000000000000000000000000000000000030100505300001000000000003300000003000000000300000000000000000000006000000000003000000000000005600140000000310000000300000000000
111000000000000000000000005500000000000300000006000060100000000000000000000550300000000000000000300000000000005511050000000000000003000000000000000000300300000550000000
000000000000000000011100011100000000001303000000000301116000000000000110001110000030000000000003000000011100031000000030050000000060000300000000330000000000601110000010
000000000000000000000000000000000000000050000000000000001000000000000000000050000000000000000000000000300050000000001000000000006000000000000000000000000000000000100000
000000000000030000000000000000001000002000000000300000001000000000000000000003001006010100000000000000605000000000300000040000000000400000000000000003000000000000003030
000000000000000000000000000000300000000000000000001000000000000000000000000003000001000000000000000000000000000000000000000000000000010000001000003000000000000000300000
333333333000000003333333333300000000000000300000033333000000500000303033300330000300400000000000003003303003330003333330000000330000000000000000100000000033333330003303
