000000000000000000000000000000000000000000000011000000000000000000000000005000000000000001000061010000000000000000001100160000001050000000000000001000300000000303000000
000000000000000000000000000000000000000000040303000003000000000000000001000000000000000000000001000000000555000000041000000000000000050530300000000000000005500000000000
500011131111100000000000000010001110000000000010100000303111100000003311403100000000000000000031110000000110000000001100001000000000011000100000000000000011400100000003
000000000000000000000000000000003000200100300003000000100000000000003300000010000010000033300000000000000100000000000001000000000000000000000300000030030000000000000003
000000000000000000000000000000300000000000100000001000000000000000003330000010000000000000300001003330060000000000000000000000010420000000000000010333000300000010000033
000000000000000000000000000000000000000000000100000000000000300023003000000000000000030003020500003330060000000030000000003403000000000000000000000331006000100000000003
000000000000000000110000000000000001000000331033300001100000000333033333333330000110313333303303303333330331303303303333000010000000030303330000000303130333333133310333
000000000000000000110000000000100000000000000001000000000300000000001000003000000110000000000000040000000000000110000000203000000000000000000000000001000000033100030000
000000000000000000100555000000000000000300555000000000000000100000001010000000000100000000000000006003000000030000000000000010000000001000000000000003000100001000000010
000000000000030000111114001000000003110110114001000030035000111000000000001000000113311000050001110000000001000000000035000011310310000000005000100010100030001113011100
030000200000330000000000000004000300000000030000000000330000300030100200000000003000100000000000000000000000030003000335000003000000103000500000000050000000000010000002
333006600000330000000000000000300160000600000300000000310000000330006600300000000450600000001000010000000000000000000330000000000000003300660000000000000000010000000000
333006602000333000000000000033000660000000000000002000030000000333006600000000000000000300000001000000000000001002300130000000000000033300600006000000000630000000000100
333333333333333330333333333333333300300000333333333330000000000300403300000003330333000010000030000000300000011033300030301005000005033333300001000000000133003030000500
