000000000000000000000000000000000000000000000000001000000000000000000000000000100000100000000000000000000000000003200400000000000000000000000000030003000000000000000500
000000000000300000000000000000000000000100000003000000000000000000033000000300000000000033000000000000000000000003000000000000000000000003300000000030033000060000000000
000000000000000000000000000033010030000000000000010300000000000000030000500000000031000000000000000000000000000330000032000000300000000000003000003300000030000530000000
000000000000000000000000000000000100000000050001000000000000000000050001000000000000000000006001000003000100000300001000060000001005000000000000303000000000003000000000
000000000000000002000000000003000001302000003000000000000000000000000000001000000000000000000000300000000000000000000000000000000000000000031000063000000000000000000000
000000000033000000000000000000000000000000333000110000000300100303300000000000050000333300000033001000010000000000001000000000000000033030000000000030030000600030000000
000000000000000000003000000000000000010003600000000000001000003000000000000200000000000000000000000000000000000003030000000003000000000000000000030000002000006000000003
000000000000000000000000000000000100000000003300000000000000030001000000000000000001000000000000000005000000000000000000000000000300000000000000100000000000000000000000
000033000000000000000000000000000030000030000000000000300000000000000060110000000000000303000010000000000000000000000000000010000000000000000000130000000000000000030000
000000030000333300003000000000000000000000300003000000000300063000000000000000000000000000030000330000000330013300000000001004300030000000000010000001000000000000000000
000000000000000000000000000000000000601000000000000000000000000000000000000000000000000000000000000300000000001000000001000000000000500001030000000030000000000300000000
000000000000000000000000000001100000000000500000000000000000000000000000000000000000001500003000003100100000000600000000000600000000001000000000004000010000000100000000
333300000000000000000000000000000000000300000000000003000000000000000000013000010005000000000000000000000300000000003000000000000010030000010013300100000000000000000000
000000000000000000000000000000000000000000000000000000000001000000000001000000030000000030300000000000034000000000000000000000000000000000000000100000000000000000000000
