000000000000000000000000000000006000000000000000000000000000003000000000000000000100000000000500100000000000000000000003000000000000000000000005000000010300000000000000
000000000000000000000000000000003000000000000000000030000000000000050000000000000000000000100000000000000000000000000000000000000000000000003000001000000000000000000000
000000000000000000000000000000000000001150000000000000000000000000004000001000000000000000000010000006600020000001060000000000000000000100000200000000000000000315000000
000000000000000000000000000000000010000000000000001030000000000000010000000001000000000000001003000006600660000300000000000000000000000000050000000000000003000001100000
000000000000000000000000000000000000000000000000000000010000000000000000000000000000300000000000000006000660000000066005000000000000000000306600000030000001100000000000
000000000000000000000000000000000000223200040000000100000000000030000000000000000000000050000232300006620600300000066300000000000000000000006001000100000000000000000020
000000000000000000000000000000000003333300000006005000000000000403333300000100000000300000000333000033333030030000333330000000300000000200000300303000000000000103033333
000000000000000000000000000000000000000010000000000000000000000000000000000003006000000000000000000000000000003000000005000000000000000600000000000000000000000000000000
000000000000000000000000000000000000000000000003101000000000000000003100300000000000000000000010000000000001000000000000000000000001000000000000000000000000000000000000
000000000066000200000000100000060000000000000000000000200001000000003000060300000003000000100000300300030000000000000000300100000000000000000000000003100000000000000000
000000000066006600000000000000060003000000000000661000000000000600000000006000000000000000000000030000001000000000000000000000660100000001000026610010000003000000000000
000000000066006600000000000000066000030000030300066000000000060660000000066000000000000000000000000000000000000036000000000000660110000000000066600000000003000000001000
000002000066206600000022020000066200000003100003060000000220200660050000066000000000000002000000000000000010500000000200000000660000002202130006620032020000000000000000
333333333333333333333333330033310333333333000000033303303300300330033333333000000000333033300000000600000000003003003330000000333333333333003033033330330000000000000000
