000000000000000000000000000030000006000000000000010103001000000000000000000030100300300030000003000000000000000000000000110000300000000000000000000000300300000000000000
000000000000000000000000000001000000000100030000000001000300000000000000000000000000000000000000000000000000000000000000000000100000000000000000000000000000000100000000
000000000000000000000000000000000300000000000000000000000050000000000000000000000300000000000000000000000000000000000000000000000000000010030000000000000000030000000100
000000000000000000000000000000000000000100002000000000000003000300000000000004000000000000000000000000010400100000000010000000000003000003000020000000000000000400000000
000000000003330000000000000002000000005000011030000000000000000000000000000000000000000000000000300000000016300000000000030000000001001003300100000000000000010000000000
000000000000000000000000000000200000000000011000000100000000000010000000002000006000002000000000000000000111000000000000320200000000000000030110000000000030000020020200
000000000000000000000000000003033300000000333033300000010000000005000033303030000000032303300000000000000333333303000000333003014030000000000333333000000033033333013333
000000000000000000000000000000000000000000000000000000001000003000000000000000000000000000000000000000003300000000000000000000000000000000003000000200000003000000000000
000000000000000000000000000005000000000000000000000000000000000000000100000300000000000000000000010000000000100006030000000000000000000000010000000000000000600500010000
000000000000000000000000000000000000000000000000000000000000000000100000000000000000000000000000000010000030000000000000000000010000000000000000000002100030032000000000
002000000000000000000000000003000000000500000010000040000000000002010003000000000000500000001000000020001130000000021000000000000000000060000100000000000300000000000005
011000000000000000000000000000000000000333000030300000000000000011000000005000000332000000000000000000106000000000300000000000000000001100000000000000033600000000000000
011000020000220020200000202000003000000000200002200000202000022011000050020200000000000000021000000000000000212000400002000020000202001000000000020000000000000010000000
333333333333333333333333303300000000001000336333303330033033331030030030330330001100000000003333430000000033003000010003033333030303330343331331033000000000010010004100
