000000000000000000000000000000030000000000000010000000000000000000000035000000000000000000000000000000000000000001000000000000000000000010000000000300000000000000000000
000000000000000000000000000000000050000000000000201000000000003000000030000010000000000000200000100000000000000030000003000000000003003000020000003300001030000020000000
000000000000000000000000000000000030000000000006600000000000033030030031033000000000000306600003330000000000000000000000003300000000000130660000003330000002000660000000
000000000000000000000000000001003330010000200006000000010000334000000030000000000000000606600003330006000000000000100000303000000000020000060000333303100020000660100000
000000000000000000000000000000030330000001000006600000000003303000001000003000000000000106000033330000000000000000000000333000000000000000660003003300000000000600000000
000000000000000111100000000003003330000000000006600003000003330000000033000000610100300010003033030000303001200001110000033000000000000000660333330330200010000060000000
000000000000000000000000000030353330000000333333000000301030303000000033330330000000030133033330330000000000000000000003333133100000033333333333333013333333031300201000
000000000000003000000000000030000000000000001000000300000000100000000060000000000000000000000000003010000000000000000003000003001003000600000000200003000000000000000000
000000000000033000000000000230000000006000130000000000000001000000300000000000000002000060000000203000000000000000000000010000100000000000310000000000000000000000000000
003300000000333000000000006635000000000000003300003000000034000000000000000000000060003300000000003100000000000000000000500000000000000000333300000013300000000000000000
033300000003333000000200006600000000100000033300000000000033000000000000000200000066003300000200003000000000000304000311000000500000000003130000000033003000000000000000
033300000033333000000000006600000000000000033000000000000333000010000030000000000460030300000000003000000000000000000003000500000000010033000001030000330000000000000000
033300003333333300000000006633000000001000033300001310001333000000003000000000000006603300000111003300000000000000003003300000000000000033030100140003300000000000000000
333333333333333333333333333333030630000000330333000000003333030000000000000003333033033303000000003303333000000000000033330333000000003333300000010130303000000000000000
