000000000000000000000000000000000000000000000000000000000040000000011110000000000001006000051000000010000000000000000000000000000000000000000001000000000000600000000000
000000000000000000000000000030000000000030030000000000300000000300000300000000000000000000000000000000001001200000000000002000000000000000000330000000000000300000000000
000000000000000000000000000000000000000005000000000030000000000110000000044000000100100000000000010000000006600000000000060000000000001000000000130113000000060000000000
000000000000000000000000000000000200000000300003000000000000030000000000000000000000000060310000000500000000600000000000066000000000300000050000000020000040660000000000
000000000000000000000000000000000200000000000000000000000000000100000000000000000100000000000000000000000006000000005000066000000001000000000000000000000100660000000000
000000411010111000000000000001010130000000000000410000000000100000003000000000000004000003000000001000300006600010010100066000000040410001000000001030500000660000000300
000000000000000000000000000030010000000000200000000000000333333330000333303031030003300000305500000001000310030300000033033033000000000000001333305300000333033330000000
000000000000000000000000000000300000000000000001000000000000000000000000000000000003000000100000010000000050000000001000000003000000006000000000000003000000000000600000
000000000000000000000000200030000300000000004200000000000000300003200000030000000000060030000000000000000000000000000000000000000100000000500000000100000000000000001000
000441011000000010100006600000000000010100001600000014100000000000600000100000000000000050000101000000000000240000310000034010030000000000000055100000000000044100000400
000000000000000000000006600000000010000000006000000000001000000016600000000000000000001000000000000300000000000000000000400000006010000000000000000000000000003000000000
000000000000000000000006600060000000000000006600000000002003000000600000000000000000003000000000000020100000000000000300000300000000000000000000000060100000000500000000
000000000000300000000006600000000400000000006000050003001001011000000010300011000000110001100000000000000000000000000000000000000003000000001000001000000000000001000011
333333333000030333333333333333000030330333333003330333000000000333333300000000002000000000003333330100040003033003033033331333300000300000000000300060300033323300000000
