000000000000000000000000000000000000000000000010061003100000000003301000000000000000000000000000000000000000010340000000000000000001000000000000000000010000000000000000
000000000000000000000000000000003000000000001000000001040100060004005400000000300000000000000000005150000003015400036000500000000010400000000000000000000000510000000010
550000111340300000001111111100000010334030000010100001100010001003000311340300000001113016011340301111111000011000000310000030000011030000000000000500003011011010134036
100000000000000000001111100000000010000000000000000000000000001100000000000000000000010603003600000000000000000000000000000000000000010000002000000140000000000000000000
000000000000000000101111110100001113100001000100000000000000111001001000000000000000111110000300000010000000006010000013300000000000000000003300000000000000100000010000
000000055500000000011111110100000110550000000000000010040000011000000005300000000000113010155500030000000000000000000000000010000000030300003000000000000000000005550000
000000000000000000010000000000000100000000333003633353330000010333300001005003333033000000000000000333330323333300000100033310330333300000001003033000000000333330000030
000000000000000000110000000000000000000000000000030001000100000060000000000000000000000010003000000000000000000000000300001000000000000000001000000000011000300000000000
000000000100000000154555000000001005550001000000000000000000000500030001000000006000000000000000000000000001010000003040110001000000055010000000000000015400000000013000
000000000000010000111111111000000001011110104111141000015300000011111000000001011131000000000000010505001000005110011100000001113403000101100000001300001110111010000000
200000000000000000000000000020000000000100110110020000001000000000000020000001110000300000000000011000000030300016100000000000000000100000030000030000000011110000000000
330000000000000000000000000033000000000000310110100000300004000000000033060001111100130000000000310000000000000011110010000000000000000000000000000000000011011010000000
000000000000000000000000000000000500000000111110100000000000010600000000000001000600000000000004010000030000000001210010000000555000300000000000011010000011011011100030
003333333333333333333333333300331330033333000100000060000000000333301000003334000010003303300000030000000033013300000000003303000000033333300000010333033300000000033330
