000000000000000000000000000000000000000010300000000000000000003000000000000000000000000000000006000000000000000100000000000000000001000000300105000003000000000000000000
000000000000000000000000000000000000000000001000000003000000000001000000000000000010000000000000000000000010000000000310001000000000000000000000000000000000000000010000
000000000000000000000000000000600100000010000000064000000000000000000000003000050000100000000030000011400000000000000300300000003000002001300010300000000000000000200110
000000000000000000000000000000110000000040010000100001000000000000010000000000000000000000000000000000000001000002000010000030000006066000000000000400000000000000600001
000000000000000000000000000000000060000000060300000000000000000000100104000000000100000000000000000000000000000066000000000000000000061030000000000000000000000006600000
011000000000000000000000000001100000000000006000000600000100000000000000000000000000000000011100012010000000000006020000000000200100006202002000000300000000000000620200
000000000000000000000000000000000000000000000030033330330000000000000033313310000000100000000000003333330000000333333330000000033003133331103333303000300000003003033300
000000000000000000000000000000000000000000000000003300000013000000000000000006000000000000010000000106000000000013000001000004030000000003000000001000000000000000000000
000000000000000000000000000000000000000000000000000000010000000000000020000000000000300000000000003001000000002300000000000000000000010010000000000000000000000000000000
440000000004000000000020010002001000000000000040000000004400000300000002001000000000003000002001000000000440006000000004000000023000100000000600300000000044000000004000
000000000000000200000660000010000000000000000000002000000000000101100006000000240000023000066000000000000000000060005000000000000000000300000600000000000000200100300000
000000000000006600000660000060010000000000000030000100000001600100000066000006000001060000006000000020310000000000000000000000000000000000000000000030000000000000605000
000222020000006602000662020066200000000000000000060320103002000011000060206006000000660030060203000000000000320000003000002220001000000100000000010001000000020206602000
333333333333333333333333330035333000000000333003333330303300330000000003333000333333310130330330302000000313000000000003331333000004000001000100000000000003313333303303
