000000000000000000000000000003000100000000000000000000000000030000000001000001000000000000000000000000000000000000000000000000000000010100000330000000300000000000000010
000000000000000000000000000000000100100000000000000000300000000000000000000030000000000000600000050000100000000000000000100000000030031000000000000000000006000000000000
000000000000000000000000000003300000060000030003300000000000003000000000010330000000000005000030006000033000000000000330000000000000000000000000000000000603000000000000
000000000000000000000000000000000000630000000033300000000000000000000000003300000000000100000000030000333000000000003330010000005000000000000000000010000000000000000000
000000000000000000000000000030300000660000000303300300000000000006000000033330000000000000000300000103333000000000013330000000001000000000000000000000100000030000400000
000000000000000000000000000000040003000000002333303022100000100100000000233330000000000000000003000000303000000000233330002220000000000000000502020000000000000000001000
000000000000000000000000000000000000333033333333303333300000020000000033333303035333333301300000030330333500000003311333333333000000300000003303333000000003100000000000
000000000000000000000000000001003000000100500100001000000000000300000300000000000000000000000000010000000000000020000001000003000005601000000000005000000000010030000000
000000000000000000000000000000001000300000001000001300000000000000000000000000000000000000300000000000000000000000000000000000000000000001000000003000000000000000000060
066000000000000000033000000000000000000030000000000000010000000000000000000000660000000000006600000000000000000006600000000000000000000000000000030060000000000200000000
066000000000000000333000000000001000000000100000000000000000000000000000000000610000000000006600000000000100300106610000300000000000000030000000333066000000000000000100
366000000000000003333000000000000000300600010000000000000000000000000000010003660000000000006600100000000000200036600000000000000030000030000616330366000000000000000000
366000000022220023333000000000000000400000000000010000000000000000001000022023060000003000006600000010000000000006600000000000000600000003000103033306000000000000000010
333333333333333333333333333332333300000000000000000000000000000003000033303333033033333330333130330000000000130033330300000500000000033303313300333333333333403030000030
