300000000003030000000030033003000000000000000005030000000000000034030003003033000000004000001003001300330003000000000000000303000000033000001000000000000000100000000400
000000000000000000000000003300000000000010000000000000000000030000003300000100000000000000000000000000033000000000000000350000003000000000000000000001000000000001000000
000000000000000000000000000000000000003300000440000003000100000000000000000000000000000000000000003000510000030000000000001000000600000100000000000001000000044000000030
000000000000000000000000000000000000000011000004000000000000000000000000000001000000000000000000010000001000000000000030000000006000000000000000000000000000000030000000
000000000055000000000055550000000000003000000000000000000000000055050000003000000000000000000655000155500000000000010000005500300000100000100300000000000030000000100000
030000333333300000000033333300000000000003001000013005030000001003333333033050300003000000003333305313305000000002001000333030000030003000030300003000030000000000100000
000000000000000000000000000000033000000103330300600000000000003000000000000000000000300000000000000000000000000300033030000000000000000100000000000300000033000300000003
000000000000000000000000000003003000010000000000000003000003000000100130000000000040000000000030000000000000000500000000000000030033000000000000353000000000000000300330
000000000000000000000000000000000330000000000000010000000000000000000000000010000510000000000013006000000300000000006000000000000003300000000000000000000000003000000033
000000000003300004400000000010000000000000000000000000000000000000440000000300000000000000330044000000030302000003000000004400000000000001300000000000000100000000000000
000000000000000000000000000000000000000100000000000000000001000000000000000000000100000000000000300000040000000100300000100001000000000000000000006000060000000000000000
000000000000000000000000000005555100000003000000030350000000030000000000000000000000003000000000000000000000000030000000000100050500000000000005000000000000000000550500
000030000000000000000020000006303330300000000030033333300000000000066000000000000300020000000000000300003000600000000000000000033333300100003030310000003030000000333333
300000000000033333330000330300050001000000300000010000000000000333330000000030010000000330333333100000000100000000100003333330000000001000030000003000030300000000000000
