000000000000000000000000000000006000000313000010000100000000000000000100210000000010000010000003000000000110100000010501150000000000100000110000000100000000003113000110
000000000000000000000000000000000000000000000010000000000000000000000000000000000110000000000000000000000010100000001000111000000003000000000000000003000000000000000100
111111111111111100100111001141400400300100100001011101001010011100000031400400200011101111111110011110010010100000000110110003111001110000011000011110101110000000000111
000000000000000000000000000000003001000000000000000000000000000000001001000000000000000500300600010000030000000030000000400000000000110010000010000003000000000000000000
000000000000000000000000000000000000000100000000000000000000000000003000050000000000000000000000030000000000000000000000000000010000010000000000100000200010003000001000
000005055550000000000000000000000003000000003000000000500030050300000000006000030000000005005350000000000000000000300000000000000030030000000000000000005030000000000000
000000000000000000010000000033330333333333330303300000000001000000330013333003033300000000000000600000000333333310000330333033000000003033330002000000010033333303303003
000001111110000000110000000000000001111003000000006000000000000000000001000001101000000000000000100000110000000000000000000000000503000000030000000000030000030501011000
000000001110000000100000000000000000101000001000001000000003000000000000030000110000000000000030000000000000030000000000000000000000000050000000000001000000000000111050
100000001110000000111414004010001030110300101111101100010111110110003011000110011000110010010000000005111414000011101111111111110010001000401000100404004010111110303000
100000000000000000000000000000000000300003000000000000006000000000000000000000010000000000010000000000000000300000000000000000000000000000000300005000003000000000000000
100000000000000000000000000000000000000100000400030000000000000000510000000030000010000000033003002000000000000000000000050000000000000000000000000000300000000000000050
300000000000000030000000000000000000000300505000000000005550010003000000000000000000300030030040030030000000000030020500055000000000000000000000000000001050550000000030
333333333333333333333333333300000103313330000000000000000010000000001000000003330103000003030033033300303333333300000000000000300001030033300000010330333000000003033033
