000000000000000000000000000000100000000000000000000000000000004000000002001000000000000000000000000000000001000002000030031000030000100000010600000010000000010000100000
000000000000000000000000000000001000020000010000000000000300000000000000500000005000000000000000000000000303000000300000000000000000000000000000300000000000000000000000
000000000000000000000000000003000000000000000000000000004040050000000001000001000000003000000030000000010004000000000000001000000000004000000400300404000000000000000000
000000000000000000000000000000000000000000100003000000000000000000000000003000000003000000000000000000000000002300000000000000000001000000000000000001000000000006000000
000000000000000000000000000000000004000000000000000010000000000000020000000000000000000333000000000000000000000000000000000100000000010000010300000000000000000000600020
240000000000000000000000000000000000000000000000000000000000200240000002022000600000000000001000000000000000200000000000000010000000022021030200005000220000000000600000
000000000000000000000000000000000003033033000000000000013333003000000033333003603333000000030100003003333333303333003000000000000000033333333303333330033303333330033313
000000000000000000000000000000000000000000000000000000000005000000000000000100000000000000000000000000000000000000000000000000000000000000000000000000000020000300000000
000000000000000000000000000000000000000000101000030000000000000000000000000000001000000000000000300000000000000000000000000000300000000000000000000000000000000000000010
404000000000000400000020000040400000201000040000000000000006000020040000000000030000000000006000000200040000000000000000000000000000040500000000000000300000000000000000
000000000000000000000660000000000006600000000000000000000000000660030000100000000000000000000000006600000000000030000000000000660000000000000600000000000000000000020000
000000000000000000000660000000000006006000000000000000000000000660000000000000000000000000010000000630000000000000000006000000660000000000000030000055000101000000000000
000220000000002202200660000000620000600001230220000000000000010600000000000000000000000000022032006610000140000004000000000030660000000022002400000000000000000300000000
333333333333333333333333333333330333333333303333300000000001300303031300000000000000003000033333333333533000000000000000000000300330030333304000000000000000000004000000
