000000000000000000000000000000000000000300001000000600000100000010600000000000000000000000000000000000000000300100060000001050000000000000000030000001000000000030100000
000000000000000000000000000000000000400000000000000000000000000010600000000003000000000001000001100023000040000500660000000000000400000000000000000001000001000000000000
000000000000000000000000000010000000011000000005003000000100000006600000100501000002000000030000500000030000000000600001000002000050000000000000000101000200001100000000
000000000000000000000000000040000662000000000000030000001000000006600000056300000000000000000000040000000000000000660000000560000000000000000000000000046600000000000000
000000000000000000000000000000000660000000000000000000000000000000600000006000000066000000000000000000013000000000660000000066000000000000010000000000506600000000000001
000000410000001000000000000030000000000000010060410000001004000006600000000000000006000000010010000000000000000400600000000060100000000000000000004000000602000000000000
000000000000000000000000200033300333000033000000000000000600000003333330000333131033000230000000000333003000000000333133000003010303000003000000300303003303333330002030
000000000000000000000006600000000000006000000000000000000000000000000001000000000000000000000660030000000000000000030000000000000000010000000000030000000000000030046000
000000000000000000000006600000100000066010000500000000000000000001000000400001000000000000000260100000000000000000000000000000000000000000000000000000600000000000063600
000411010000020011000006600000000000306035000111200000000000000000411000000000000002000000000060100004510100060200110000000020100000000031100000000000000010010000066000
000000000000660000000006600000003050006010000000000006000000000000000000000000000000000000000660010000010000006600006005000000000000000000000000000000000010000000066000
000000000000660000000006600000000000066000000000000010000000000000000000000000000000003000000660000000000000000600000000003000000000101000000000000000010000000300066020
020000000000660000000006600010000000066000020000010000030000010000006000000040000000111000300060000000000000006600000001000004000000003000011030000000001010001000060500
333333333300333333333003333300000000030033330333303120000012000333333060030001000000050010000333333303333333003333333330000000000200033303330000000333303000000100030333
