000000000000000000000000000000000000000000000000000010000000000000003000000000303000000300000000000000000000000100000000000000000030001000000050000000000100000000010000
000000000000000000000000000000000000000000000000000000300500000000000000000000000010000000000000000010010000000000000000000000000000000000300000035000000003000000000000
000000000000000000000000000000000100000000040000000600000000000000000000030000000000000000003050000000000000000000000000000000000000000000003060000000003000000100000000
000000000000000000000000000000000000000000003030000000030000000000000030000000000000003000000000000000000000000000000000010000000000000006330000333060000000000000000000
000000000000000000000000000000000000030000303003000033000000000001000000000000000000000000000000000000000030000000000100100000000000000033000003300000000000000030030001
000000000000000000000000034000000000003000000000000331300300000200300000000000000010000000000000000000000000034000000000000100000000000330303333330200000000010000000000
000000000000000000000000000000004003333033003003032034330001000333313300000133033333000000033313030500000001001000000300000000330333333033033333333333303300330330000000
000000000000000000000000000000000020000300000000000000000000000000000000000001000000050000003000004000000600003000000000004300000000000000000000000040000000000000000000
000000000000000000030000000000001000000003000000030000000001000000000000006300000000000003100000000000000000043000000000000000000000030000000010300030000000000000030000
000000000000000000000000000000000000000000000306000000000100000000000000000000000001000000000000000000000000001000000000000000000000000000010000000000000000000003000000
000000000000000000333000000000000000000000000000000000000000000000300000003300000100000033300600000000000000000000050030000000000000000000100000000001004000010000000000
000000000000000003330000000000000000000000100000000000400000000000013000033300000000000333600000300000000000000101300000000030000000000000002000100000000000000300030000
200000000000000033330000000000004403000000000000006001000060000000004000003000011000000333000000003000000000000000000000100000200033000000400000000300001130000000000340
333333333333333333333000003000000000000000010000031333330000000201000033333000100000300300300000303333030003000000300000000000330003300000000000000000003000001000000000
