303000000000000000000000000300300000000003000001000003400000000000000000000001000000100000300000000001000000000030000010000000000000000031000000000000000000000000000000
400000000000000000000000000000000000003003000000000000000000000000003000000020000000000000000000000010000000000000000000000000000000530000100000000000300001000000000000
000000000000000000000000000000000600000000000000000000100000300000000300010030000000000000000000000000000030000000030000000000000000000000000003000300000000000006000301
000000002000200000000000000000000030200020030000000000000000050000000000033000000000000000000000000203320000013130600000000030020000000000000000333000000000000000000000
000000003330003000000000000000000000333000000000000000000000010000000000000000000000000000000000000333100000003000000003005000030300000000000000000000000000000000000000
000000000000000000000000000000000000000000006000000000000000000000000000000003000000000003000000000000000040000000000000030000000011000000000010000003010600000202000000
000000000000200000000000000033333330000023100333303400000003130033363033303000006010000000033303000000020333000300000005000000000002000033333300000100000033033033303030
000000000001100000000000000000030000000001000000030000000060110300000030001000000000000011030300000000000000001000000030030000050000000000000000110400000000300003000000
000000000000100000000000000000000000000030000000040000000000000400000000110000000000000001061000010000000030000000000110101000000000000000005010000500100000000004000000
000033300000000000000000000000000130001000000333000000400000000000000000400000000000500000300001000000000000030300000000000133000000001000000000040000000000000000006000
000000000000000000000000333300030330000000003000030000000000000000000000000000000130000000000000000003000000000000000000000334000333300000000030010020302000000000300010
000000000000000000000000000003000000000000060000000000000200000000000030000001003000000000000000003000000030000000000000000000000000000000000000000033000005100060000035
000000000000000000000000000000100000000000500000000000000000000000000000000000000000000000100003000000030001000000000001000000030000000000000000000000001000000000000000
333333000333333333333333000030300000000000331033000000000003000010000000000030005020003033301000000000000533333000000000033333330000013330300033303300002030030000000000
