000030000000000000000030000000000000000000000000000030000001000330000000000300000000040000000000100000000010030000000001000000000000000000000005000000006000030000000000
000300000000000000000000000001000010000000000030000000000000000001000000000010000010000000000300000000000000330030000010000000300000000300030003000004013000000000003000
000000000000000000000000000000000030000000000000000000000001030000000000000000030000000000030000000003040000005000300301030000000000000000000000000000000013200000010000
000000000000000000000000000000300000001000010300000000000000000030000000030000030000000001000000000000000000001000000000303000006000000000000400000001000000000000001050
000000000003000000000000000000000000000000600000003000000000000000000000400000000000000030000000300000000010000000000500000001001000100000000000300300000003000100000000
000000000000000000000000000000000000300000001000000000000030001000000000000000000030050000000000001030000000000000060000000000030000000060000010000000000000000000000010
000555000000000005505000000033333333033333000010530300033303333000000000010050363330000000053033333033300101055000000001333330033300300000010000000010550533300033103303
000300000000000000000000000000003000000000000001003000000000000000130000000000003000000003000000000000100030010000000030003000000000050000110000300030000100300000300001
000000000000000000000000000000030000000000000000003000000000000000300000000000000000000000000000000000000000000300030100000103300000300000000003000000000000000000000000
002000000000000030000000000000000000000030000000000000000000000000000000000000020000003001000203000010000000000000000000020300000000000010000000300610000000000000030000
000002000000000030000000000000000000000000000000060000000000000000000020000000000020000000000000200000000000000000000000000020000000000000010000000000000000060000030000
030000000000000000000000000000000000000300001000000000000000000000000000003000301000000000003000000000000000100000000000002000000030000000000000300000000000000000010000
000000000000000000000000000010003000000000000000020000000000000300000000000000040000100000000000000000000000000000000100030000000000000000000000030000000000000000000000
333000333333333333333333333300005000000001333030300000003333033000555650000003330003303333330300000005535000300000135503330003000000033030310005550000000033033303303303
