000000000000000000000000000000300000003000000000000000000000000000000000000000000000010000001000000000000000000001300000000000300300000000000000000000000000300000000000
000000000000000000000000003301000000000030000000300000000000000013330000000000000000000000000000330000000000000000000000000005000003300333000001000600000000000000000030
000000000000000000000000000000000000000000000006000000000000000000000000000000000003000000000000000000000000000000000000002000000000000000000300000000000000030000010000
000000000000000000000000000000033000000000000000000030000000000000000000010000000000000000000020040000033000000003333100003010010600000000000100000000000000003000000000
000000500005550500000003330030000000031301000000000000050000000000000000000000000000000000000330000000000300000530110600500300003030000003000000005000500030000000003300
000003330000330000000000003010300000000030000000600000330000033000000000000000000000030000000000300000000000003300001000000000000003000000000000033000000002000000000000
000000000000000000000000000000000000030000006000000000000000000000313000330133303313001000000000000030303000000000000000000000000000000333030000000033030300000000000000
003000000000000000000000000000003000000030000003000000001030000000000000000000000000353000001000000000000103000030000000000060000000000010000000000000000003000000000000
000000000000000033300000000000000000003300000000000000000005600000000300000000000000000000000003000001010000060000000000000000000000000000000031300000006000000000000300
000000000000000000000000000010000000100000000000000000000000000000100030001003000030000001000100013000000000000000000000000000000000000000000000000000000000000000000000
033330000000000000000000000002000000000000000001000000000333300000000010000000100000133330000000000000003000000500000000010300000000000000010000000000000000000000000000
300000000000000000000000000000000000000030010101030000055000000003310000000550000000300010000000000000555000000000000000100000000015500100000000100000000000005500500000
000000000000000000000000000000000000050000000000030000000060000000003000000336000000000000000030003000013000000003010330000000300003000000100010000000000030000330000000
000000033333030033333333333363333000033333333333000000100300000000100000000000000000000000000300330000000333000000000063303031300400032330030030343033333103000100001000
