000000000000000000000000000000000000000030000300000000000030000000000000100000000000000000000000000000000000000000005000000100000000000000000000103000040030000000000000
000000000000000000000000000002000000000000000000000000000000000000000002020030000030300000000000000000000001000000000000200000000000000000000210000000000100000000000000
000000000000000000000000000006000000010000000000011111000000000000000066000000110100011110011000000000030000000000000006601000000000000000006600000000000001011000011100
000000000000000000000000000066000030010000000000010000003000000000000066000000000000400000000000000000000000000000000113600000000000000000006603000000000000000000000000
000000000000000000000000000060000000000000003000000000010000300000000005000001000000000000000003000000010000000000000016100000300005000100006001000000000600000000001000
000000000000001000000014100060000020000000614000020200000010001000000066000001000000000200020030330140000100010003000006030002000000001410006600002000000000000000000000
000000000000000000000000000000331300053003000030031331303033103000000033031333300033033333303330303000000400000060000003330033003300010000003333333303100303333333333330
000000000000000000000000000000000000300000000000300000000000000000000000000000000000000000000000101000000000000000000000001000000040000000000000000000000000000000000000
000000000000000200000000000000000000000302000110001000000000000000000000000000000303031000002000000000000000000000000000050000100000000000000000000500035000110003000000
011110000000006600000111110031111000000000000000600000000000003111010000000130100010000000066000300000000000000013110000005000011110100003000003000000016000000000000000
000000000000006600000000000000000010000000000005100010000000000000030000000000000000000300066000000000000010000000000001000000000000000000000000000000010000000000000000
000000000000006600000000000000000001000000000010000000000000000000000000200000003000030000066000000100000010000000000000001000000006003000000600000000000003000000000000
000000000000006600002202000000000000000300100000000000000041000202000000000000000000000010066003020600000000000020000000005000000300010000000060000010100010000001000002
333333330330033333333333333030330130000000000000300000010000100033003000000300000060000000033313013030000000000033000300003000333333310005000000000000000110000000000000
