000000000000000000000000303000040000003031000002000000003000000000000000000030100000000300006000200000000000303000000300000000000303000000000100000000000400000330600000
000000000000000000000000000000013000000600000000001003000000000000000000003000000000000030300000000030000300100000000000000000000000003100000000000000030000010000000000
000000000000000000000000000000030000000000001000500000300100000030000100000300000000000303300000030000000000010000001003000000001000033000030000000000003300000000000100
000000000000000000000000000000000000000000000000000000000000000000000003100000600000130000000000000000060000000000000000000501000000000000000000000000300000004000000000
000000000000000002000000000000000000003050000200340000000000130000000300003000030000000060000020000001000000300000000003000103000000500000000000013010100000000000000000
000050003333000002002000033300030000000303000200233330030000030000000030334000331300333300010024220000000000033060020020000500000003000000000000401330300000004330330300
000000000000000000033333300000000000035000000003000000000000000000100006000000000050500000000000330000000113300000000300000003033301000000000000000000000433330101000006
000000000000000000000000000000000000000000000001000010000000000000300050000000000000000000000000000000000000300600000000000030001000000000000000001000000000000300003010
000030000000000000000000000000000010000000000000000000000000000000000000000000000030100000000000000010000000000000003000030000000000000000000000000100000000000000000000
000003333000333300000000000000000030000000030001301400000000030000000000000003330000000000031000330030000330000100040330000000000000033000003300000330003600000000000000
000000000000000000000000000003000000001000000000100000000000003000000001000003000000003000000003000000000000003030000003000001000001000001000000000000500000000000000100
000000000000000000000000000000000000010000000000050000300000000000000000020000000000000010100000000001000000000100000600003000001000003000010100000110300000010000000030
333300000000000000000000000000000000000503000000000000000040500005033300026020000000333330000000000300000000010033300120000031003300000000030020001000000000020000000000
000000000000000000000000000000000000000000000000050000035000000130000000000330000100000010000000000000000001000000000000000000000000000300000000000000000050000350000000
