003000000000000000000000000000000001030000000000001000000000000000000000000000000000000010000000030010000000000001000000000000003000000010010000000000001000300000000010
000000000000000000000000000030100000000100000000000000000000300000010000000000000050000020000600500000000000000000000000000010000000000000000000050005000000000000000000
000000000000000000000000000011011000000000000000000000000000000000000000000000001101000000010001110000000000000000003000000030002000000000100300111000000000000000000005
000000000000000000000000000000000000000000000030000000030000000200000010000003000000000000036000000000000000000000000000000000000000000000003000000050000000000305000000
000000000000000000000000000000000000003030000000001000001000300300000000000300000000000000000000000000000000000030000000000000011000000030300000001000000000000000053030
000000000011100000000414111130030000003100014111100011100000000414111030010000000202000000003062020000000404111041410130300001000000000103300300000000000000000000003330
000000000000000000000000000010330103333334000300000000000000001000000000000003330010000005030306330003000000000000000000000030000000000333333333000000000000300000330303
000000000000000000000000000000000000000000030000000300000500000000000000000000300000000000040000050000000000000000000000000000000000000010001100000000600000000000000000
000000000000000000050000000000012000000001000005100000000000000002000001000000010000000030000000000000000000000000000000000000000001000000000030000000000000000000000000
000000000000000301111111110000000000000000010001000000000000000011110000010000000000111110000000000000000000600000010001100103030110400000000000000300000001110000000300
000000000000003000000000000000000000000000400100003000000001003004000000000600000000000000000000001001010050000000000000600000000000000300000000000000000000000000003000
000303000000000000000000000000000000000000000000000100000011000000000000003000000000600000000000030000005003303000000010000001000006000000100000000000100000000000000000
000333000000000300202000000000003000000000030000200300010003040030000000000000010010000000000010300000000100333000100000030003030400000011104101101006011000000000000000
333333330000003333333333330030000000000000313333300000003303330033100030000000000000030330030000003000010303313030000003133300330333300000000010000000030133033003000000
