000000000000000000000000000000000000000000000000000030000000101000000000000000000100000001000000100000000000000000000000000000000000006000001000000000100000000000100000
000000000000000000000000000000000000000000000000100100000000000000000000230000100100000100000000000000000000000000300000000000000000000000000000001000003000060050000000
000000000000000000000000000000000000003100000000000000000000001000001000000000000000000000100000000000000000000000003000000300000000500002000000000000000000000000004000
000000000000000000000000000060100100000330000060000000000000000000000000000000200000001000000000000200000000000000000000200000000000004130000001000021000000000000000000
000000000000000000000000000000000000033030000000100000004000000000000000000006600000000000003000006600500300000000000016600000000030000000000000000660000000030000000000
000000000000000000000000000000000000023330300000000600000000000000600200000100600000000000000021026300100000000000020026601600000030103000000000100610000000000000000000
000000000000000000003000000030000003030333000000000000000000000330353000000003333033000300030313333330303300003003333003333333000000330000030000000633033300000030000000
000000000000000000030000000000300000000000001000000000300000000000000000000300000000000003000000000000003000000000000300000001000600000000000000000000000000300000000030
000000000000000000000000000000000000000000000000000000000000000000000000000000000000000000000000000000003000000000000000000000000000000000000000000000100000000000000000
000000000000000003000000000000030000120000000000000000000004001010010000330010000000030300000000000000000000000000010000000000000001000000000000000000000000000003003000
020000000000000003330000000000600000000001000000002000030000000000000000033000000000000303000000000000006000000000030330100000000050310000010000000060000000000001160330
660000000000000003330000000000000000000610000000036600000000000000000011033300100000001303000000300000100000036000030300030000000000000000000000001000000000000000013030
660000000022020023330000003000000000002002060000460000600000100000003300233003000000002333006000300000000000000000230300300000000000000000300002200003100000000306020040
333333333333333333333333333300000003333303333363333133030000006303303030333030003300030333333303330004003000000033033000000000000000030336330330330000000033030333333333
