000000000000000000000000000000003000000000005000010000000000300000000000000000000000000000000000000000000000010000000000000000000000000000000000000300000000000000000001
000000000000000000000000000000000000000000000050000000000000000000000000000030000000000000000000000000000040000100000000000000000000002003000001000100030000500000030001
000000000000000000000000000000000000000000000000000000000000000000000100000005006000000002010000003000600000000000000000000000005000000000000000000000000000000000000001
000000000000000000000000000000000000030100130000100010000000000020000100000000000000000000000000000000000010001000000000000000000000050001000000030000040000000000000000
000000000000000000000000000000000000000050000000000000000000000000100000000000000000000000003000000050000000100100000100000000030000000000000000000000000000003000100100
000000000000000000000000000006000000630000000000000000300000000000010100000000000260000003001000000000000000000000000000001000000000000000000000000000010100100000006600
000000000000000000000000000000000003303330300303300060000000000000000005303301333333000000033333333030330000000033303310003000000000030033335003000333030333333333330333
000000000000000000000000000000000000000000000000300000000000000003000003000000000010000000000000000000001000050000000000160010000303000000000000000400000000003000000000
000000000000000055000000000000003000415000000000000000000053000000030000000000000000300000000000010000000000000400050000000000000000000000000000000000000000000000000000
000000000000000000000000000030000100000000000000003000300000000000000300000000000000010010300000000000000000000000000000060000000000000000000000000000000000000000000000
000000000000000000000000000000000000010000001000000000000000000000000100500000010000000300003000000000006000000000000000001000500000001300000000000000000000000000060000
000000000000000000000000000000003000000000000000300000000000000000000000000000000000000000000000100000000010000000000000000010003000030003000000000003020000000000300000
000000000000000000000000022000000006000000000000001000000000000000000000000000000000000000000000000000220000000000000000000200000000000032103000003000000000000000100000
333333333333333333333333333333333300330333000000000000003010330000000033333300000000000000000000003303133333330033330300000000000100033333010000000000000003000003330333
