000000000000000000000000000000000000000000000051000000000000000000000000000000000010000000000000000300000060000000000300000000000060000000000000005001000001030600000000
000000000000000000000000000000000000032000000000000055550305005000000000000000000000030000000065550000100000060000000000000000000055500000000003000600000000000000000000
000000000000000000000000001000000000001010000000030010100301010000003000000004000000000101000011000000030000001004440000000000000110000000000000000000003010000000001010
000000000000000000000000000000000000010000000000100000003000000000000000060000000000040100000006000000110000000001000100000000000030000000000000000000000000000000010000
000000000000000000000000000000000000011010000000000000005000000003100000000001000050001131000000000000000000300001000010000000000000300000000000000000000003000330011110
000000000000011000000011400000300000011000000000000000000000000011000001100010000030000100010100000000100010400050000201000000000000000000001000000006000001140000510000
000000000000000000000000000000000003333033303333333333033030333000000000100000333033333303333333310000000000000033336330000000303033100000010300000333303300100003033033
000000000000000000000000000000000000000300003100000000030000001000001000000000000000000000000100000000000100000000000000000000000100000010000000300050000000000000003000
000555500000000002000000000001000010000000000000000000000000050000000000000000002000000000000000100005000000000000000000000000000200010000000000000000000000000000005050
000111000000000011010444400000000000000000440300040000000330010000050000000000000010001000044440000000000000010010600000000010001101000000000000000000500044440540000110
000000000000000011000000000000000000040000030000010000000000000000300000001000011006005000000016000000000300000000000000003000001000100000100000000050000000000000000000
000000000000000011110000000000050000000000000000000000000000000000000000003000011110000000300000000016000000000000000010000000001111100000000000000000000000000000000000
000000000000000011000500002000000010110000500002010000000000000000000010000000000000000300055003201000020000000100000010100000000100000000000000001000000050000000000000
333333333333333333033333333300000000000000333303300000010030000000000030303333030033333330303333030030010000000000300300005000310303330033330000000000000003031033333333
