000000000000000000000000000000000000000000003036003000330000001000003300333300000002000003000000000010000000000000330300010033000000000000000000000003013000000330000000
000000000001000000000000000000001000333330000300000000500000000000000000000000000000000000300000050063100100000000000000000000000010000000001333030004000000010000000000
000000000000000000000000000000000000003001000033300000400000000000000000003300000000000000000000000000000000000000010030001000000000000000000000000103133300000000000000
000000000000000000000000000010000000000000000000010000100000000000030000000000000000000000000003000000000300010000000100001000000300000000000000500000000000000000000000
000000000000000000000000000000000000000000300000000001306010000000003333000100000000000003300010000000000100002000000030000003000010000000000000000000001000000330000000
111000000030000000003333000000030000000000000010001000000003003000000000000003030000000000011100000003000000000100000000000000000000033300000000000000000000000000003000
000000000000000000200000000003000000330000030030530000001000000300100000000100010010300000000000000000010000000000000003000000001000000000000330000000000130000000000000
000000000000330033330000000000000000000000000000000000000000110000000000000010000300000030000030000000000000330000001000000000000060050000300000003000000000010000000000
133333000000000000000000000000030000000000000000000000000000050000000000000001013330000000013333300300000000000000001001303030000010000003000000000000000000000000000100
000000000000000000333000000000000000000000000000000000010030001000000000000000000000000000000000000000010100033300000000010000000000300100000300403000000000000000000000
000000000000000000000000000000000000000000000000000000000006100000000000000000300001000300000000000000000000010000005000000000001000000000050003000000000000006000000000
000000000000333000000000000031000500000000000200000000000000000000000000000000000000000000000000006000000310000000000000000000000000000000000000000001004000000000003000
000000000000000000000000000033100000000005051000000003000010000000000300030000000000000000000300400000000000000015100000000000000060003000033000003303000011100000000300
033000030000000000000000333300000000003303003000000000000000300000020000000330330300400330000300000000000000000000000000135000000330100002000000200000000000000000003030
