000000000000000000000000000000000000001000000000000000010300000000000000000000013000000000000000000000000050000000003000000000020000000000000000000500000003000000000000
000000000000000000000000000000000100000000000101000000000000000000000000000000000000000000000100000001000000300000000000000000000100000000000000000000000000000000000001
111110110000000000000000000000000010011000000015310000000003000003000030000000030000111010100000020000000000000000000001111101000000000001401000000003000000000002000003
000000000000000000000000000000003003000000300030000030000000000043330000000000000000000000000000030001000000000000000000061000000030000000000000000033330000000610010000
000000000000000000000000000000000000000000303330000000000000000333310000000000000000000600060000004006000000000000000000100000000300004060001000000333300000030000000010
000000000000000000000000000001000000000000000310000000000110003333300000000000000000300000003000000302003403000000000000000000010330600000000000000303300000033000500013
000000000000000000000000000000000100000000333330000000000033333333033300000010000000300000033333300033303000000000000000000000333333000000000000000333033353333330003333
000000000000000000000000000000503000000000000000000000000000000000000000000000000000001000001000300000000000000030300000000000003000000001000000000010000000000000000000
000000000000000000000000000000005000006030000000000000000000000001000000010000000000030000000000000000000000000100030000000030000000000000110000000000030000000000030000
000000020000000030000000000000000000030000200005011011000000030011110010000000000000000000000000000030000100000001000000000000010000020000001011101000000000000000000000
000000300000000333300000030000000030333300000000000000000000300000000001000000000003000030001000000003300000000000000030333300030300000000000000000000100000000000000000
600000000000003333000003330002000013333001000000000000001003300000000000000006000000003330000000010333000000003065000003333000000000000030000010000000000060004000000000
600000000000033333000000330060000003333030000000100000000003000000000000000006010000000300000000003033000000000300000000303000000000000000000000000000000060000000000000
333333300333333333333333333333333333363303000333300030003033303000000011310002333030333333300000003033333000000033003333301330000000000333030000100000003003333130000000
