303000000000000000000000000000000000030000050000000000001000000100000000000000000000000000000000000000000300000015000004000010000100000000000000000030003000000003300000
000000000000000000000000000010000000010000000000000003000000000110000000000000001000000000000000060000010000013000000000000030000000300000000000000000300000000200000000
000000000000000000000000000000200000000000001000000110040000060000000000000000000000000000601010003311000000003000000000000000000000000000001000000020000030110040000000
000000000000000000000000000060000000000000030000000000000005000000000000300300000000100000006003000000400000000000000000000010100000000000000000000100000000000000010000
000000000000000000000000000066000001032000000050000003000000300000000000000000000000300000066000000030001000000010000000000000000000000000000000030063000000000000000000
114400000000000000000111110060000001210110000000000000301101100000000000000001104000000000066000000000000114401001111000000000100000000003000000000600000300000001003000
000000000000000000000000000013333030000000333333333300300000000333030030000000000000000000033330033330000000003000000003133033000030100000000000000003633333333300000000
000000000000000000000000000000000500000000010000030300013000000000000000000000000000000000000000000000000000300000003000000001352000000000000300000000000000500000010300
000002000000000000000000000000030000000000005100300000006000010000000000000000000010000000000000060000010000000050010200000000000000001000030000003000000100010000000000
331100400000000200000000000000000060100000000000600000003331004000000003000000200000000000000000000000000000000033111040000000000000002000300000010000000000000000000000
000000000000006600000000000000000000000000000000000000000000000000000010000006600000003000010000000000100010000010600000030000000300066010000100000000000000000000000000
000000000000006600000000000000000030000000000000000000010000000006000000000006600000000000000000000000000000000000010000000000000000060000000000000000000001000000300000
300000000000006600000000000000000000030000000000011401003000000000000000000006600000300000000000001010000003000030000000000100014000066010000000000000000001111000000000
333333300003333333333333333300000000000303000000006000000333333000000000003303033303000000300000300000000333303330330031000330000000030336330000000030003300000003000330
