000000000000000000000000000300000000000000003000000000003000000000000000000000000016000000000000030000010000000000001000000000000000000100030000033000000030000000000020
000000000000000000000000000300000000000000020020000000000500000000000000000000000003000020000050000000000010000000400000000203000000010000000000003000000000000000000000
000000000000000000000000000000301030000000000100000013026000000000110000000100000000000130001001000000000010000100000000001100000000000003000000000000000000020000001000
000000000000000000000000000000000000000300000000000000000000000001000000000000101100000300000000002000000000000000030000000003000003000000000000000000000000663000000000
000000000000000000000000000000000000000000000000200000000000000000000000000000000000000000000000000000000000000000000000000000000000001000000000000000000100660000000100
000110000000010000000000000000001000000000000200000000000000000000000000001000001000000200000010000000000000000100000000002000000300000605000000000000000100660000030000
000000000000000000000000000000000003333333031330300000000203333003033300000023000000333333000010000500000000001030003300333333000000000000000000000000000030003330000000
000000000000000000000000000000000000000000000000000030030000000040300000000000000001000000002000000000003000000000000000000100000000000000003000000000000000050000000000
000020000000000000000000000000010000000000010010000000030000000003000000300001000000300000000000010000033000040000000000001010000000000000000030001006000000000000060200
000110000000000000000000200010000003030360000200000000000020000040000000020100300000000200000000000000000000010000020050000000000000000060000000000006000003000000001100
000000000000000000000006600000000000000060006600000000000000100100000000600000000000006600000000000000000000003000660000000000000000000000000000001000100000000000000000
000000000000000000000006600000000000006000006000000000000000000060000000660000000000006600000000000000000300000000060300000000000000000030300000103000010000000000000000
000200000000000000000006600000000000000001006600000033000000000030000100660000000000000000000000000010000000100000660000000031000110010000000000000000110103000000002000
333333333333333333333333333333033330000002333333000300000333033300000033333630000000030033333333030000020033033333303330000300000000030003333333033030000031033033333033
