000000000000000000000000000000000000000000000000500000000000000000000000000105000000000000030000000000000000030000100000000000050100000000000014000000010000000000001000
000000000000000000000000000001000000000000000000000000000000000000000000000000000000000000000000000000000010000000000000000000000000000000000000000000000000000000000000
000000000000000000000000000000000000000000000001000000000000000010000000000000000000000010000100000500000000000000100000000000000000000000000000000300000000000000050000
000000000000000000000000000000000000000000003100000000000000000030000000000001310000000000020000030300000000000000000000030000000005000000000010000000000000000000000000
000000000000000000000000000000330000000000030000600000000300100001330000000000300000000000000000000330000000000300000003330100000000000033000000000000005000000000000300
000000000000000000000000000000001000000000030000030002003000000000330000000000300000000020000000000030000000000000000320330005000000000003000000000000040003000000000000
000000000000000000000000000005000300000000330333330333330300000333003300010003333033330033000000003130332100000000000000333633000000030000330333330300000000100000000000
000000000000000000000000000004000000000000000000001000000001000000000010000000000000000000000000000000000000000000000000000300000500000000000000000000000000000000000000
000000000000000000000000000000000000001000101000000000000000000000000000000000000000000000000000000000000000000000000000001000000000000000000000000000050000001000000000
000000000000000000000000000000000000005000100000000000000000030303000000000000033000000000000000000000300000000030001000000030001000000000000000300000000000300000000000
000000200000000330000000000000000000000000600000200000000000000000000000000000000002003000200000000030000000000000000020000000000000000000030000100000100000000000000003
600006600000000330000003330000000000000600600006600000020000000100000000000006000066600000600000000030000006330060000660000000000000000000000100000100500030330006000006
600006600002000330000000030000000000010000600006600000000031250000000000300006000066600000610030010500000000000060000660000200000000000000000000501000000000003006300066
333333333333333333333333003300000000000300003330300100103333330000030000000003133303333033000000033311033000000003333353033333000000000400011333303000000000300033330333
