000000000000000000000000000000000000003000000000000000000010000003000000100000000000000000013000001000000000130000033300100000000003000004000000000000050000000000000000
000000000000000000000000000000000000000006000000100010100000000000000000000500000300030000300000000000000000000000330130000000010005000000000000030000000060200000000000
000000000000000000000000000000000000002000005000600000000010000000000103021000000000010000000000001300000000000003303330000000000000030000000000000500200010000000000000
000000000000000000000000000000000000063000000000000000003000000030000000160000000000000000001003001010000000000000333330000000000600000000000300000000000000001000000000
000000000000000000000000000000000000066010000000000000000000000000000001660200000000000020600000030000002000000033333000010000000000000000000100030006600000030000001000
000000000000000000000000003300000000066000300100010000000000000000000000660000100030300000000000000000003000000033331330160000000000000003030000031006600100000000300000
000000000000000000000000033333333033033033031000000000000000000001003003333330000330003330301010003013030010000033333300000300003333000003030000333330035300000000000000
000000000000000000000000333300000000003330000000000000000000000000000010030330000000000333000000300000000000130000000000030050000000300000000003303000000400000000000010
000000000000000000000003333300002000003313000000100000000000000000000100333000000000003333300000000000000000000000000000000003000000000000000033033050000010000000000000
000000000020000000000033333300000000000300000000000000310000010006300000333030030001030333300000000000000000010000000000000000000000000000000133333001000000000000030000
000000000660000000000333333300001003303033000000000000004300000130000000003330000000333030300000000000030001600000000000066000000000000000003333333000000000000001000000
000000000660000000003333333300000000300033060000300002000000006000000033063330000100330033000000003000000000600000050001066001000000300000003013333000000000000000000000
000000000660000000033333333300000323333030100000300000000000320000003330330030000400333303300000330000000006650000003000006000000003300000000033333003000001000000000030
333333333333333333333333333300003033333303003333300000300000000033303333033133330100333333333333330060001303330300000003333303333333300000001333303003333300000003333336
