000000000000000000000000000035000000000010001003500000000000000000000000000000000330000000000000000000000000000003300000000000000000000000000000001000300000000000000300
000000000000000000000000000000000000000000050010000020000000400000000000000005303000000000000000000000000000000000000050600000000300000000010000000000000000000000300400
000000000000000000000000000000020000000000000000000000056001440000000000000000000000000100000005000300000000044005000050000200100110100000005000010000066000020000001440
000000000000000000000000000000660000000000000000005000000000000000000000000006010000000000010000000000000000000010000000000000060000000005000000000003030000660000000000
000000000000000000000000000000160000000000000001000000000001000000000000061001030000000000000036010000000000000000000000000000000030000000003000000300000000650000000000
000000000110000000000000000000160200010000000000000100600000210000000000220020000000002202210001000000000100020000000000000000003000000110000300000100000000060232102200
000000000000000000000000000533333000300000000000100003330333033000033033633300000000333333300000000003010300033000003000000000000000003000000000000000000033333363033303
000000000000000000000000000000000000000000000000500000000000000000100000000000000600000000000000000000000001000100000000000000000000003000000000000000000000000310000000
000040000000000000000000000000004000000100000000020000000000002000000000030000000010000000000000000000000000000000000000000000006003000011300000000000000000500000000000
000144000010000002000000000510010000000005000100000000000002100004000010000060000100000000000000000100000000000000110000000000000100000120002000000000000500010000000000
000000000000000066000000000000001000000100000000000000000006000000000030000030000000000000000000000006010000000000006000000000300000000660000000000000000000000000000000
000000000000000066000000000000000000003000000010000000000066003000003000000000000000000000000000000000000000000000030000000020000000000660000000000002000010000010000005
200220000220220066020000000020020000000000002202200000000066020000000000110000000000000000000110000061000000000023000000000000102002300660230000000000000000200220000000
333333333333333333330000033333333330000000000323300000053303336500000500030000000000000000500000003350330000030330333330000300333333333130300000040000030333303300000025
