000000000000000000000000000000003030000000000000000000000001000000050000001000000000000000000000000001003000000000300000003000000000000000000000000000000300000010000010
000000000000000000000000000000033330000000000000000010000000000000000010000000000010000000000000000000000000000001004000000010000001000000000001000000303000000000000010
000000000000000000000000000000350330000000000000000000020000010020000003040000000000000000200000000000305000000000500000000000000000030000000000000003303300000000000060
000000000000000000000000000003333330000000400000001000660010000000006600000000000000000006000000000000000000000000000030000000000000000000000300000033330300000000003020
000000000000000000000000000033300300000000000000000000660030000000006003020000000000000000603000000000000000000000000000030000003000000000100000000303330300000000000000
000000000000000000000000000033330330000000000000002000660300003021003600000000000000020000600000005000000000000000000000003000000000100000000000000333330303000000003040
000000000000000000000000003336303330000033030333303330003303333333033303600003033333300333610000000103000303030110003330000000000000033333300000000330303333330330000001
000000000000000000000000033303000000000000000000000030003100331000000000000000000100000300000000000000333000000001000000000333000004000000000003601000000000000000000000
000000000000000000000000333300300000000000000000000000000000333000000600000000000001000000000000000003003000000000000000003030000000000000013000000200100000005000000000
000000000000020000000003333300500000030003000000000002000033033000000000000000000103000000000000000003133311000000000021033333000000300000003000000000000000000000000000
000000000000660000000033333300000000000000006000000000000331330000000000000003100000000000030300000333333005000000000660033033050000000003000000000010000000000363000000
000000000000660000000333333300000000000000000000005000103333330100500010300000000300000000010000003030303000000000000000333333030000000000100000000000100000300660000000
000000002000660000003333333300000030000000000001001000003333303600000000000500004300300000000000003030333000000002000603333333000100000000000000020000000600400060000030
333333333333333333333333333333333330000003000000000000000033333001000000000000000000003000030333030333053000003533333303303030000000033333330300000001003330533333302333
