000000000000000000000000000000000000000000010000000000000000000000300000000000000004000000000000000000000000300000000030004000500000010000060000300000200000000001000000
000000000000000000000000000000000000000333000020000000000000023000003300000000000000000033010005000004000100000030003000000050000060300000000000000000000003000000000333
000000000000000000000000000061000000003330000000000000003000000000333000000000000000300033000000000100000660000000000000003000000000000050006600000000000403000000003330
000000000000000000000000000066000000003000000000001000010000000033333000000000000000033303000000001000000600010400000000000000000000000000006600000000000000000030333030
000000000000000000000000000066000003333300000030010000000000000103331000003000000000300303000100000000000660000000000001000000000000000000006600300000100000600000333000
000000000000000000000000000066013010333330000000300000000060000033103000000300000060033033000000000000003621000010000000000000000010000000000650000031000000300003330300
000000000000000000000000000003503000303330003332003003330000000331333003010330003500303333000000000000333310030000000010000000000100003003350300300001333300010003033330
000000000000000000000000000000000500000101000000101000000000000000000000000000100010000000030001000000000000000000000000000000030100000000001000000000000000000000000000
000000000000000000333000000000000000000010000000000000000030003003000000000000000000000000000010000000030030002300000000000000001030300000000000000000000000000000000000
660000000000000003330000000000000000000000000300000100006600006000003000000000000000000000000000000000000000000100000003000000000333000000300000000000000000000000000000
660000000000000333330000000000000000000000000000000001006000100000000000000000000010310000010000000000000000000000000000000000033133000000000000000000000000000000050000
660000000000003333330000000000000010000000000000000000006600000000000000000000006000000010000000000000000000000066100000030000333303000000000000000000321000000000000000
660000000000033333330000000010000000000300000000000000006601000000000000001000003003000300000003000000000000000060000000000000000301030000000000000000001000003000000000
330030000333333333330030333330030000000013000000010000033300400000000000000000033333030002000000000000000030010033001002030333333303000300004000000000000010333330000400
