000000000000300000000000000300030000000000001300000001000000000010000000000300000000000000000000000000100000000300000000000000000000100000000000000000000000000000000003
000000000000000000000000000000060003003303030006500003000000000030033000010000000053000000005003000003300000000002001000000000010000000005530000000000000000003000001000
000000000000000000000000000000001001000000030000000000300000001000000300000000000000003000000000000000000000000300000000000030000030000000000000300000033000000000000000
000000000000000000000000000000000000100000000000330130400000000000000000020000000000033334000000010000000000000000000003310140000000000001000300003331334001000001000000
000000000000000002000000000000000000000000000000000003000000000000000000000000030000000003000000000000001035000000000004000000000200000300000000000000000000000000000000
505550000003440000000000034300505000000003000000000000001000340000000000010000000001000000000000603000000000000300003000000000000000000000000000000100000000000000000340
000000000300000000033000000000600000000001300000000000000020000000000000001000000010000001000000000000000000000000000000100000000003300000100300000100003000000000000000
000000000000000000000000000000000000000000001000000000030000000000003000000000000000000000001000000000003020003010000000000000000000300000300000036000000000000000000000
000330000005530300000000000000005530000050400000000000000300000003000001000000000000600010000100000000553000010000000003000000000000004000000000000000055300000000000000
000000000000000000000000033000000000300000000000000000000000000000000300000000000330000000003000000003100000000000300100600030000000000000300000000001600030000000100000
000000000000000000003333334000000000000000000000001000000000000000000000000000303340001000000000000000000000000000000110100000000000000003000000000000300000000000033000
000000000000000000000000000000000030000000030200000000000360000030003000020000000000000000110020000000000000000000000000000000000000000000000000003000000000020000000000
000000000000000000000000000000000000000344000000000000335055000000034400002000000000001500000000000000000000063400000005050500000034003000460000304030000100000335005500
000000000000000000000000000000000200030000000001300000010000000000000000000300000000000000000100030000000000000000000000000000010000001300000000000000000000000030000010
