000000000000000000000000000000000000000000000000000000000000010040000000000010000300000010000030000100010000000000000000000000000000000000000000000000000000004010000100
300000000000000000001000000000000000100004330000000006000000000530001000000000000000001000000000000005303000030033000100000505001000000100000000003130000001000010030010
000000000000000000000000000000000000000000000000002600003333310000000000000000000000333333010000000030000000000002003000333000000000000000000000000000000000000001200400
000000000000000000000000000050000000000000000000300000033000000000003300400000000000300000000000000100000000000000003001030000000000600000000000100001000010000000000000
000000000000000000000000000000000000000000000000000000000300000300000100000000000010000000000000000003000030000000000000000000000000000000000300000000300000000000000003
300055500003555000000000033360000000000355000000050300000000033000000000003553000050000003300005330000000000000000000000000000000000000003550100000000003050000050000333
300000000000000000000000000000000000000000000100000000000000003000000000000003000003000000300000050600000300300005000000000000000000000000000000000000000000000000000000
000000000000000000000000000000000000000000000000000000000003000000000000000100000000000000000000000000000000000000030000000000000030030000000001000100000000000000100000
000030000055533300000000000000000000000000000000000050030000001000000000003000000553301000003101003000300000000000000010000000110000000001003000000000000000000000005553
000000003330000000000333333060000000000000100333003330000000500000000000000000333000000000000000300200000000000001600003033040000000000000000060030333333000000000033000
000000000000000000003300000000000000000000300000000000000000303000000000005000100000000000100000000000000000000000000003010100003000000600010000000330000100000000000000
000000000000000000000000000003000000000010100000300030010030000000000000000000000000000000000100000000000030000000000000001010000000030000000000000000000000000000000000
000000000000000000000000003300005551000035000003000100035000000063030000000000000000330056500003005000000410035550501000000130301055500003333000555000000600013050000000
000000000000000000000000000330000000000000000000000061000000000000000000000000030000300000000000000000000000000000300000300103300000000100003050000000000200010000010000
