000000000000000000000000000010000000300000000000000000000100000000003000000000000000000000001000050001000060000010001000000550000001000000010000000000001001005500000000
000000000000000000000000000000000000100000100000000000000000300100000000000000000000000000000000000100006000000000000000200000000000000011100100400100101100001000000000
000000000000000000000000000000000000000000300000000003300000300100000000000300500000000000000010000000000000000000003000001100000030103030000000300000000000001060000000
000000000000000000000000000060000000000000000000033000003303300000000000000000000100000000000000000000000000000033003000000000000000003000003300300300000000000003000000
000000000000000000000000000000000000000000000000033003003310300030000000000000000000000000000000000000000000000030003000003000000000000010000300000000000000000000000000
000004414000000000000000000000000402000002000000000003003000360200300030600043050000000000000001002000002140000000603000000030040000000000000000310000300046300000101000
000000000000000000000000000000000063333033010000033311332333300300333000000100000000000000000000000333303004000033330333003333000000010303333303333333333303333330000000
000000000005500000000000000000000000000550000006000000000000550000500000000000000006030055000000030300000000000001000100000000000000000000000000000000240000000000030000
000000002000000001111110000040011110200000030000000000000300000000131100000000000000000050000000000600111000000000000000000000110000000000000000000110300000000000000000
000030000111000000000000000000000000001100000000000000105011100000000000000000030000001110000000000000000000330000100030000000000000004005000000000003000000300000000060
330030000000003300000000000033001000000000000300000000600000300030000000000000000000000000000000503000000310030100010005000000000001000200000630000000000200000000000000
330030000000000000000000000000000043000000000000000000000000003000050013000001000000100000000000000000000030000000000300000000000000300000000000010000000000000000000000
000030000000000000000200000200000010000003000011014010000100000020000000000001400000000000300000040000000000030000000030000000200000200000000000044200000200000000000000
333333333333333333333333333313333353033333001000000060003330330030330504000000000000313333300361003330333303303300004000000300133333000000000000000333332000000000000000
