000000000000000000000000000006000000000610000000000000000000100000000000600000000000000000000000000000300000000000000000000300000000000000031000000000000300000000000010
000000000000000000000000000010000030003000000011100000000120000000000000000021160000200000000000011110000000000000030000000000003000100000060001001000300030000000000000
000000000000000000000000000000000000000000060000000000040111013000000000000000000000000000002000000060000000300310000000000001023000000000300213000000000000000000030003
000000000000000000000000000050000000000000160010060000000000000000000600000000000000000000006000000000000000000000000000001000063003001000006600600000060000030000000000
000000000000000000000000000000000010000030600000000001000000000000000000000000100000100000066000000600000000000000000002000000660006000000016600000000000600000000020000
011444410000000000000000000000000020000000160000001000000000000000000000000000000002611445060000000030002000000000000300000000060000001000006600100001444400000001000000
000000000000000000000000000033333010000000003303000000003330033000000000000003335103000000133333103333303313333330033330000000333033000000003033330000000000000000000000
000000000000000000000000000000300001000000000000000000000030000000000003000000005000000030000000002200000000000000000000000000000000000040000000000000000001000000000000
002000000000000000001110000000000000000000000000001200000000000000000101000000000006000000000000000000003002000011020001020000410000000000000040000100000000000000000000
011111410000000200000000000000000001000000001000031101000000000020000000003003000000000000003010000300000011111400000000011004000100000000050111110000600010000003300300
000000000000006600000000000000000000000000000000000000000000000063000000100000000000000000000000000000000000000000000000000000010000000000000000000000000000000000006000
000000000000006600000000000000000000000330000003000000000000000000000003000000000000000000330000000000000000001000000000000000000010000000000000001033000030000000000000
200000000000006600000000000200144400000000001000020000000114444500003003000000000000100000000000000000000200000000000022000000011044410000002000000000000200000010001100
333333330333333333330333333300000003033333000000033333330000000333330000000003033033000000000000000000000030330133333333333333001000000000003330330033330330333330000000
