000030000000000000000000000003100000000000000000000000000000000000001000030000004000000000000000000000000000000000600000000000001001000130000000000100030400030100000000
000000000000300000000000000000003300101020000000000000000500000000000000000000000000010013030100000010001003000000000000000000000003000000000000000010000601000000000000
000000000000000000000000000000000003000103103000000000113000000000000000000000000000000000010000003033065000000030330000000100000300000000100000001000000000000003003000
000000000000000000000000000000000000000000003000000000003000000000000300000000030000000000000000000060000000000030300000000000000000000000000000001300001000010010030030
000000000003333000000000000000003330000000000000000000003030000000000000003030000003000030530000000000000003000000000100000003000033300003033010000000000000003030000000
000000000000000000000000000000000003000000000000060000000000000000100300006000000000000030000003000000000500000000003000000003000000000000010000000000000000000000013000
000550000000000005555550000000066003300000303333355000000005555303300330000035501000000001000005553333333000000006300330333333000010030000000001355400000033000033333330
000300000000000000000000000000001000003300001030000000010000300000001000000000000000000000010030003000000000030000000000330300100000000000000100130300000200000000000000
000000000000000000000000002000005000000000400000000000100000000030030000000300000000030002300000000000000000000000000000000000000000000000000300001010002000300003000000
000000000000003033000000000000000000000000000000000000000000000003350030005331000000000000000000050000000000000100000001000000000050000000000000000000000000000500000000
000000000000000030000000000010000000000000000000000000000000000003000000000000000100000000003000003000000000000000000000030000000100000000000030030000000000000000000010
000030300000000000000000000000503000000300000000030000000000004010000000000000000330000000000003033000000000000000000000000000000000000000000000333000000000000000003000
000000000000030000000000000001000030010000000000000000000000000004010000000000030000000000000000000000000000000000000000000100000000050030030000000000000100000000003003
330000333333333333333333333303331333100033000650000050550005000333333303330010000000033333033000133303330000550030005550003500554000033303310000201333003310000003033331
