300000000000000000000000000000000011000000000000000500003000001300000000000000000500000000000000000000600000000000000000000000000000100300000000000002000030000000000000
000000000000000000000000000003003020000100000000000000300050000000010000000000001001000000000040000000000000005000130000020100000000001000500300000000003000000000100000
000000000000000000000000000000000000000000130101500000000000000000000000001110000000000000000000010000000000001100000001001101000000000001010000000001000001000000000111
000000000000000000001000000000000000000000000000000000000000010000000300030000000000000000000000000000000000000000000000000000300000000000003000000000000000000000000000
000000000000000000002000000100000000000002000000000001000000001000000003000000000000000000100000100000000000000000000000000000000000100000001000001100000000000050000000
000000000000000000111110011101000000030111000000000005001100301000000000001000000000110011100000000000000000000000000000003000110011100001001000110000000000000010000000
000000000000000000000000000030000030003000333303300100000100000000000033300333000003000000033330303000003300303300000003033330000030063303300000001300000300000003300336
000000000000000000000000000000000000000000000000000000004000000000000000000000000000300050000000000000000000000000000000000000000000000000010000000010000000000000000000
000000000000000000050000000000000000003030000000000000510030000600000000000000000000000000000000000000000000000000000000000000003000000600000000000000010000000000000000
000000000000000000111100111100000000100000000000000051110000000500000010001110000001100001100030000000000000000000000000060000000000000000000000000000000110001010000000
000000000000000000000000000000000000000000000000000000105000000100000110000000000000000000000000001000000010006100000000000000000000000006000000000000000000000000003001
000000000000000000000000000000000000000001000001300000000000003000000100000000000000000000000000000000500000300003000000000002000000000001000000000010000000010000000002
000000000000000000000000000000000005000111000000000300000010000000011100000000000000000000000000050000000000010100000000000111000030000000000000000000000001000000000111
333333330000033333333333333300000000000060533333100333330000000000000033303333303030330333500000000000000300000001000000000000033333030000030100000330330333333330000000
