000000000000000000000000000000100000001020000000000000000000000000000001600011060300000000500000000000000000000001000100000000000000003000000000000000000001000000000000
000000000000000000000000000000000000000000000000000000000000000000003000000000000000000000000300000000000000000000005000000000000000000100000000010000000040000006000000
000000000000000000000000000000000000000000000000000000000000000000600000000001000000000000000000010000100000000003000030000000000002000000000000000001000100040000000000
000000000000000000000000000000000000000000000000000010000000030000003000000000100000000000000000000030000010000030000000000000000030000000000000000000000000000000000003
000000000000000000000000000300000000000000300600300000000000010000003330000030000100301100000002003000000000000000000000000103000000000000000000133000000000000000000600
000000000000000000000000000000000000001020000000000000100030100000033300000000000001101100000000200000000000000060000200000000000000000000100000130000002002000000000100
000000000000000000000000000000000003333333000000033030300000000033033300060000000000333333003200300000000000030033330330000000000050000000003330030301333030003533030330
000000000000000000000000000000000030000000330000000000000000000000000000000000000000000000000000000030000000000000005000000000000300600010000000000000000000000000100000
000000000000000000000000000000000000000000000000000000001000000000003010000000001010000000000000000001000600000003000000000000000000000000000000000000000030300000000300
000000100040000000000000000000010010000000000000000000000000001004000000000010004000000000010000000000000000400000040010000100000000000100000500001000000000000000000000
000000000000000000000000000000002000000000000000005000000000000010000000001000000000000000000100000000002000000000000000000001000000000001001000000300000000000100006000
000000000000000000000000003300000000000000000003000000000000000002000000000000000000300000300000000000000000000000020000100000000300000000330000001000000000000000000005
000002022000000000000000033322000000000040000033300000000000000000000000000202200000000030300001000000003200000022003000000000000000000003330000000000000000000000000000
333333333333333333330333333303330300000030030003300000003033333000000033333333330305303333000300000000000303133300005030004000333333013033330100000010000000003000000000
