000000000000000000000000000000000000000010020000000000000000000000000000000000000000003000000000000000000000000000010000503000000000000000000000000000000000000000000000
000000000000000000000000000003000006500000000000000000000005000003400000000020300000004300000000000300000000000000000000000000000000003000000000000000000100000000000000
000000000000000000000000000014000000000000000000000010504400000003000000000000000000000000002000003000000000300000000000000001440000000000010100300000000000000010000000
000000000000000000000000000000000010000000000100000030000100000000200000000000000100000000066000000000000000000000000000312000000000000000000000000000000000000050002003
000000000000000000000000000030000000300000000000000060301000000006600000000000000000000000066000000000000100000300000000066000000003000006000000000000100000000000366000
010000000000000000000000000050022200000003300100000660000022220000600000000000000000110000063050000000000000000010000000006000000220003000040000000010000000000110063000
000000000000000000000000000033330033303333000000003030333033030333333000000000600010000000033303300000000333333033303300033333033033000000000000000000000000000003330333
000000000000000000000000000000000051200600000000000000000000003000001000000000000000000000000000000100000000000000000000000000000000300000000000000000000000000000000000
000000000000000000000000000010300000000000000000003000100000000000000000000000500000020000050000010000000000000000000000001000000000000000000001000000000000000000000000
440000000000000200000000000000000000000000000000001000000230000001000000000000000000000000040000600000500000005000000000100000000000000000300000000400000000000000203000
000000000000006600000000200000000000000000300000666100000100000000000000000000000000000200000000000000000000000000000000600000000000000000100000000000000000000000000000
000000000000006600000006600050000001000000600000006000006306000000000000000000100000005600003000000000000003300000000000630000000000000000000000000000000000000000600000
000222000000006602000006600000000300400000050010060020000302000010000000000000000000000000000022001000000000010000000006002000000000000000000000000000320000000006300000
333333333333333333333333333300000000060000000000033003330000300000010030333330000000333303033333330000000000000000000003330333000010000000000000510333333333333303331333
