000000000000000000000000000000000000000000000003000000010330000000000503000000000050000000000000000000000000000000000000003000000000000000000000000000000000003020040300
000400000000000000000000000000010000030000000000000000000004100010000000200000000000000000001000001000000000400000000000004000000000000000000000000000400000000000000000
000000000000000000000000000000000000020000000000030000000001000000000000000000060000000000010000000001010000000000000000000000000000000500000000000000000300000000000000
000000000000200000000000000000000001000000000000100006000000000000004000003000000000000000000001200000000000000000000000000000000000000100230000000030000000000000000000
000000000333333000000000000000010003000003000000000000000000000300000020000300030010000000000303300001010000000000000000030600000000000030030006000000000000000000000001
000000000000000000000000000000000000000000002020010000010030000000000000000000000000000000005000000000000000000060000000000000010020000000000000101000000000000000000003
000000000000000000000000000033330000000000033030330333330400000000000003331333000100433333300000003333003000000030033330000000013313300000000033100000000000000003333313
000000000000000000000000000000000000000000000000000040000010000100000000000000010000000000000000000000001000000001000000000000000004000000000000000050000000000000000000
000000000000000000000000000050140000000001000003100003000000000000000000000000000000000000000000000000010000001000000000000000000000000000000000000000000000000000000000
000000000000000000000000000000003000000030010000100000000000000000100000001000000000000000011000000000000000000000000010000000000000000000500000000000010000000000000100
000000000000000000000000000000000000000000000062000000000030520000000000000000010003000030000000000000005000000000000000000000100000000000000000000003300000000600300020
000000000000000000000000000000000000000000001333300030000033333000060030000000000000300000030000000000000000000000100000110000300000000000000001000000000000000000005303
000000000000020020200000000000000100000000000006000000530000000000000000202000000002000000000500300000000000020000000000110000003000000000000000000003010010000000000000
333300333333333333333333333300000000000001000000003333300000000300305033030003333330333003300000000000003003300333303336003000000010000330033310333333330300000003000000
