000030000000000000000000000000000000300000000030000000000000000000000000005000000000000000000040000000000100030003000000002000000000000003000300000110330100000000300000
000000000000000000000000000000020000000003000000000000000000100000000000000000000000000000000000000000000000000000000000010030030000000400000000000000000060000000000000
000000000000000000000000000000000000000000000330000000000000100000000000002000000005000000000002030000000000030000033000000000000010000000000000020000000000002000003000
000000000000000000000000000000000000000000003303000000000000000030000000003330000002000000000000330000000000003000300000000000000000000000000000060330000000003330033300
000000000000000000000000000000000360000000303333000000010000500001000130600000000306000000330000000000000000000030033300000000000006300000000000000000000030000003133030
000000000003300000000001111100000660000010003330000131000000330000000000000310100060003000000000000000300000000000033000001111000006300000000000000300000000000000033300
000000000000000055000000000003303330000000303330000000000000000003333303030003303333005500003330000000000000140030303000000000300333003002000033333000000003300003033300
030000000000000000000000000060000000300000000000000003000000300000000000000000000000030000300000000000000000000000000000000000000000010000000000000000000000000000000000
000000000000000000000000000011000000000030000000000000000000300000000006000000000030000000000000000000000000000000000300000000010000000100000100000340000000000030003000
000330000002030000000000000020000000000203000000000000000000000301000000033000000000000030000000000000000000000000000000000200000000000000000000000300000000000000000000
003330000003333300000000000201130001000303030003000000000000300050000000330010500000100330000300003301350000000200000000030333330300000100000000000000000200010000000000
333333030000000000000000006600000001000000000000000000000000000000010033333300000000333333000000010000000130016600000003100000000050005000000000000000000600030300000000
003330000000000000000000006600003300000003000000000000000000000000000000303000011111003330000110100010000030006600003000000000000600000000000000330003606600000000010100
303330003330000033333333333303000000333000003333300000000005000005000530003000003000003330000000000033303333333300000000333000000333300506000000000333330300550000000000
