000000000000000000030000000000000000000100000101000000000000030000000000000000000000000003030000003000000000040300000000500001006000030000001000001000000000010000000000
000000000000000000000000000000000000000000000000000000030000000000000000010000000000000000000000000000000000000000000000000000000004000030350030000000200000000000000000
000000000000000000000000000000000000000001100000000000000000000000001130030100000000300300000000000000000000000000000000001100000004110000003333000000000000000000000000
000000000000000000000000000003000001000010033000200000000000000000300000000000000003000000000100000000000005020000000000000000000003000000020000000000000311032300000000
000000000000000000000000000000000100003330100006603000100000000033000006000000600030000010000000003000000000303300001300001000333100000000060000000030000030033030500000
000001000000000000111111110011011000000000000006600006000000100000000060000000000000001000011011000000010000000011111000300000030000003300660000000000001000000300300000
000000000000000000000000000000000003300000301333500000000000000000000033031330001000333353000000000005000330600000000000000000300000033300003303333000400030000033000000
000000000000000000000000000000000000300036000000000000000000000000000000000030000000000000000201006000000000303000000300000000000000100000010000000000000000000003000000
000000000000000000040000000530003000000000000000000000400000061000060000000300000005000000500130000000040000000000060000000000000000000000000000000000004003000000003005
333300000000000000041100000000000000000000330000001001400030000000000010010001000000131000030030000000041000000000000003033050000000000000100000000000000100000000000000
000000000002000000000000000200000000000000000000000000000000200000000000000000000012000000200000000000000000003000000000000000000000000000000100003000005030000000000002
000000000033333330000000006600006000000000000000030000000003333000000000000003000066000006600300003300000000000100000100010000000000000033330000000300000000000000000066
000000000000300000000000006600000020000111000000000000060300130000000010100003300006000506600000000300000000011000003110005000000001000603300300131000010011011000010066
333333333000000000003333333305000000000000333003300000533001050000000000000003333333333303300030000000002000000000000003330030300000030100000000000000000300000003333030
