000000000000000000000000000000000000020000000030000000040000030010000000000000100000000000060000000000060000000000000000000100000000000000000100003000000000000060000100
000000000000000000000000000000000000103002000000000000030010010000000000000000000010000001100000000100000000000002000000000010000000310000000000000300000300000020000000
000000000000000000000000000000000001100060000300000000000000000050000050000010600000110001600000001000000000000000100000000000000300000000000000000100000011000660000000
000000000000000000000000000000000000000066000300000300000000500000030300000300000000000000600000000333000000000000003000030000033300000000002000000000000000100660333000
000000000000000000000000000000000000000006000300000000000060000000000000000003000000000006600000000303000000060000000000000000000300000000000066000000000000000600300002
000000000000000011100000000000040000020066033300000000000000000000010021000000000000002005640000000300000303000000000000000000003000010000000066000000050030300660333001
000000000000000000000000000000000353333333043333600000600000000010030033333330020000330303300000003030333000000000000000050000333330300000003043302000000033033033303333
000000000000000000000000000000000000000000004050000000006000000000000000000000000000000000050000000010000000000000000000000000000000000000100000000000006006000000000000
000000000000020000000000000000000000000000000000000000000000002000000430100000006000000003300100000050030000000000000000000600000000200300000003000000000000000000050000
000300011000660000000000000000000000000000000000000000001100000000300000000000000001000000000000000000000000000000000000001000100006600000030001000003000000000000000004
033300000000660000000200200000003000012000030000000000001000066033000000001000300000000000000001000000000234210000000002001000000000000000000000000010000000000040000000
030300000000660000000006600000000000060000000000000006000000066010300000000001466000000000000000000000050000600000000004060000000006600300000000000000003000000000000000
033300000200662000000006600000111000066000000000030000000020066003000000000000066000200000010000000011000006600000110300060000002006620000000000000000000001000000011100
333333333333333333333333330304000000333013000000033003331333333033033300000013333303303300300000001000030333030300000003313303300333033330300000000001000033333030000000
