300000000000000000030000000000000001003050000003030000403003300000001000000000300000000000330001000000030100000001000000000050000000000033100000000000300033033000000000
100000000003330003330000000000001050000300000000001000000000000000000500100000000000100063013000000003160000000000000000000005000000000000000300000000000000000000000333
000000000000000000000000000050000000000340030000000000001000040100000000000500000000000300000000000000000100000000000000000500001020000003000000000000000000003400000000
000000000000000000000000000000000020000000000000000003000000030000000200000030000000000000000000000000000000003000300000000102000000000000000000000000000000000100000001
000000000000002000000000000000003000000136000000000010000001031030006000000000000000000030000000000000000000010000000000100300000000000000000100000000000000000000000010
300000000030000000000110000000000000000000110030000000000000000000000000000001000000300001000000000000001150000000000000000000100010000000100000000000300000000005000000
000000000000000000000000000030003030003300000000033300000003300303333300000000000000000000032300000000000000000010300003003303010000000033003030030333000000033000000000
300000000000003003350000000030003000000030000400000000000000000300000000000000000000300030603000300003000000000000000000000030330000030003000000000000000000300000000000
030000000000000000000000000510100000000300000000000003036003001000000000000300000000001000030000000300005000033300003032000330110000001000000600005000000000033301000010
000000000000000000340000000000003000000000000000000100000000000000000000000000000000000034000000030010000030300000000000000000000040000000000000000010020001000000000000
000000000000000000000000000200000000000000000000000000000000000000000000000000010005000006050000000003000000000000000030000000300530000000010000002000000000000000000000
000000000000000000000000000000000002000100000000000000002005000000000000000000000001000000060000000000000000000000000002001000000030000000000100000000000430000000000000
000000000000000000000000000000000000000000000000000030000003030000006000000000030000100010000000000000000000500000030000030000300000000000000000000110000000000003000100
333000000300000003300300333300300000000030000000000000000000010313030000000000010001000300000000001003103500000000000000000000000000063100000101303000000000001050000000
