000000000000000000000000000000000000000000000000000003000000000300000000000000000000000000000000001000000000010000000000000000000000000000000000000000000010003000003000
000000000000000000000000000010000000000005000000000000000000010000000000000100300000000000000000000000300000000000000030000000000000000000000300000000000000000000000000
000000000000000000000000000000000000000000000000000300000006030010000430000001001000000040400000000300000000000000000110000000000000006000000001000000306003000000003000
000000000000000000000000000000000000000000000000000000000000002000000034000000000000000060000000000000000000000000010000000000000500110000000000300000000000000003000003
000000000000000000000000000000000000000000000000010000000000000203000030003300000000000000010001000000000003000010000000000000000000000000000000000000000030050033000330
000000000000000000000000000022202000000000000000000000000006000200000000003030000010200500000000000000000030000020202202000000000000100000000000000000000000300000000303
000000000000000000000000000030033330010000033333300000003303033303303130033330000000333330500000000000000000000000033303333330000010030300100005000333033300003003003333
000000000000000000000000000050000000000000000300000006000000000000000000000000000000000000000010000000000030000000000000000000030000000000000000000000000000010000000000
000000000000000000000000000000000000000000000010000000000000000301300000000030000000300001000000000000000000000000000000001000010000000000000000000000000100000000010000
000000000004040000000000300000000000003000000000000000040000000020000030000031000003000001000000000000000000310000000000003000003000000000000000000000000000003030000404
000000000000000000000300000301100000000003000001100000000000000000000000000000000000000000000000000100000300060000000003000003004030000000000000000000000000000000000000
000000000000000000000300033300000000000033000000000000000000000000100000000000500010000000000000000003000000033000000003000330000000000000000000010003100000000000000100
222022020000000000000000033300010000000033100000000000000620000000000000000002200110012002000000030000000000033000000000000301000000000000010000000232020000000002001000
333333333333333333333300333313000003003313000000033333300000100000000000000000310333333333300000003033303300033033303333000333000000000000000010002333303300000003331303
