000000000000000000000000000000000000000000040000000000020000000000000000000010100000000000000110000000000000000000001000001001000000000000010300000000100100000000000000
000000000000000000000000000000000000000000000000300000000000503000000000000500000000000000000000300200000000000100000010200000000000001000000000000000200003000000010001
000000000000000000000000000000033000300000000000001030000000000000000000000000000001030000000000000000100033000000000000000100000000000006000000000000000000001000100100
000000000000000000000000000000103000000000000000000006000000300330000001000000000000330000000000000000000000000000000000000300000000013000000000000000000000003000031300
000000000000000000000000000000033000000000030003010000000303330300000000000000000000000000040000000130000000000030500000000000000000000002000000000000000000000100003300
000004000001100000000011110003000300000110000004020000000000030000000000000400000100030000001111000000000000000001010000300100000000000003100030000000000000000000000000
000000000000000000000000000010333030000000000000000033303333330001303300000000000000000033001000003330000000000000000003033060330313000000001000003010000033300503333333
000000000000000000000000000000000000000000100000000000000000100000000000000000030000000000000000000000000000000000100500000000000000000000000000000300100000000002100000
000000002000000000000000000000100500000000000000000300000000000000030002000600100010000000000000000000000000000030000000000010000000013000000000000000000000000000000000
000330000001000300000000000003000000000003000010003000000003000000003000031000000000000030000000000000050000000003000110010301035000000000000000000000000100000000000000
000030000003003300000000000000000600000000000030003300100110000000000003003000000010000000000000000000000000000003000000000300030000000000000000000000000330006000000000
000333000000000000000000000000000000000000600000000000000003305003000000000001000000000303000030000000000000000000000300003300000000000001011000001000001000003003000000
000033000000000300000200000000005100111100000000013000030111100000000000000002000000000033620000000000100300000000000400000300030000000003000000100200000003000000110100
333333333330000333333333333305310000000002033350003303330010000000210233030000133333333333033033330000000060000300000003300003033033300000000000000333033301333030010000
