000000000000000000000000000000000000000000000000000000000000000000000000000010000000000000000100003030000010000000000000000001000000000000000000500000000000010000000003
000000000000000000000000000000000000000000000000000000000000000000000000000000000000030000000010000000010000000000000020000000000000000000000000001000000000100000000000
000000000000055000000000011003030000000000000111050006000333003000030000000010000000000000050000000000010033010000000000010110500000000000055000000033300000300000000000
000000000000000000000000000033300003010000000005000100003303000000050000000000000003500000330000000000040031300000000000000000000003000000000000000333000000000030000000
000000000000000000000000000033000000000010000001000001003303000000100000000000001100000000300000000000300303000000000000000000000000000030000000000333300000060030000003
000000000000000000000000000031300000000003005000000000003335000000000000005020000003300003300060000000003033330000003003000000000000000000000060000330330000000030000000
000000000000000000050000000033333330303303000000010000003333313003103300100003300000333000000000000303033333030333313030000000043005000000000000000330330333300000330330
000000000000000000000000000000100000000000000010000000000000000000000000000000000000000000003000000000000010000000000000000000000000000000000000010300000000000000000003
000000000000000000000000000000000000030000000500000000000000001000000000600600030000000000000000000000600500000000000000000000000000000003001000000000000000000001000006
000000000000000333000000000010000000020005000000000000300010000001011000000000000000000011030000005000030030000500000300000000033300010020005000030000011000030003000005
000000300000003333000000000000000000000000000000600000000000000000000000000000000000000000000000000000600000001003000030000005330360000100001000000003000000000000003000
000000300000003333000000000000000100000000000000300010000000000000300000300000000000000000000000000001000000000000000000300000003303000000000000000000000000000000000030
000000300000033333300000030030003000000000000000300010000000000000000000000000000000000000000003000000013100000000000030000003363330000000006000000000000000003001000000
333000003333333333333333333303030330000000133000000004000000050000000000000004033310000050033033350000050000000500300000303333003033300000000030050000000003303000000030
