000000000000000000000000000000300010000030000000030000003303003000000000000000000000000010000000500000000300000000000000003000000000030000000000000000000010000000010000
000000000000000000000000000000000000000010000000000000003033000000010000000000300003000000000000000000000000000040000000000000000000000000330100033010030000000030000000
000000000000000000000000000000000200000001005000000000040130330000000003000000000013000020000000000000000000000010000000000000000000101003031010033060000100000000000000
000000000000000000000000000000000000030000000000000000000330300000000000000010033303000000000000000001000300000000000000000000000000000333300033333003010010000000000000
000000000000000000000000000000000000630000300000000000003333300003000000000000333303000000300000000000100000000000000000000000100000003333030330330000003000000300000000
000000000000000000000000300003001000000000000200000000003333300000320000020003033333000000100000003000000000000100000000002000000000013333333333333000300000000000002003
000000000000000000000023330033333300000430003330000000000333303023300000333030003363103033300413000000000000000003303100030300000000003303333030336023330000000000030033
000000000000000000000333330033133030030000000000000000000000000000000000000004000000033330000000000000000100000000000000000000333030000000000000010000000033331010300000
000000000000000000033333330033033000011000001000010000331100000000000000040000000000333300010000330000000000000000000000000106333000000000000000000000000033033000000000
000000000000000000333333330033133000000000000000030003330000000000000100000000000000333300000003000000000000000000000000000041330330010001000000000000000033333010000000
000000000000000033333333330033333000000000000000000030030000000001000000000000000000330030000033330000000004000000030000060000333300000000000000000300100030333000300000
000000000000000333333333330030333000005000000000010300030060000003000000006000000000033310003303030010004000000000000030000000303030000030000000000005001033303030300000
000000000020003333333333330030333000001000000100030363310300000010000000000000000000300030033332330000010000001060000000300000333031000030000000000000030030330000000000
333333000333333333333333333333033330000000023330003333333333330000000000000000001000303333335333330000003333303000000000013000333130302333000000000000000003030303630330
