000000000000000000000000000000000000000100003000010000000000000000000000000000000000000000001004002000000000000110000000000000000000000000000000000000000000000000000000
000000000000000000000000000000000000000000000000000000300103000000000000000000001000000000000000030000000000001001000300000000000000001000000000000030000000005000000000
000000000000000000000000000020000000000000000000002000000000044000000000000000000001000000000000000000003001300000000004400000100000000000000000000000100000010043200000
000000000000000000000000000000000000000000000000000000300001000000010001020000000000003000000000000030000000000000000000100000000000000000010000000000000000000000040000
000000000000000000000000000000005000001000000000100003000000300300000000300000000300000000000030000003300010000000000030000000000000000010000000030000000000000000000000
000000044400000000000000000044400000000000000000002200200000000022005002620004440000002000000410000000000022200000000000000000014000002220000140000024000000000000220030
000000000000000000000000000010000000000000000000030033333033331333333333313330000000333300300000000000003333333300000003000333000000005333030000000033333033333303333013
000000000000000000000000000000100000040010000000000000000000000000000010000000300000001100600000000000000000000000000050000000000000000000000000000500000000000000000001
000000000000000000000000000000000010000000000000000000000000000000000000000000000000000000000300000004000000000000000000000010006000000000000010000500000000000000000000
000004444000000000000020000000000000000004410005000000000000000445000000000000000000004000000000440000000440000003000000000044003000000000000000000000000044000000300000
000000000000000000000000000000030000000000000000000100100100000000010000000000002000030000000000000000000000000000000000000000000000000000000000000000004000000000000001
000000000000000000000000000000040000000011000000000000000000000000000000000100010000000000000000000003000110000012000000000000000030100000000000000000000004000000060300
000000000000000222000022000000000000000000000000002220000003000010500000200000000000001000000000000000000000000000300000000000000000002230000000000000001000000000000000
333333030003333333333333333300000003303330001001135033330000000300033300000000000000000000033333300000000300653300000003333030000000033303300000000000000000003340000000
