000000000000000000000000000000000000000000000000000000030000300000000000000006030000000100000130000010000000000000000000000000000000000600000300000000000000000000000001
100000000000000000000000000300601110000000000006001000330000000000000300000101000000100003110010003000000000005000000000000005000003000000130000030001000350000000000600
000000000000000000000000000030000000000000000032000003330000000000000030015000000000000000000000000000330000000000000400000000000000000003303000333000010000000100000000
000000000000000000000000000000000000000000003000000033300000000000000000100000000000000000000000000036000000000000000000000005000000001033331001330003003000000000000000
000000000000002000000000000010000000000010003300000333330000011000000000000000000000000000100000000003060000000000001000000000010010005333030003333000300020000000000000
000001055500000000000000000000000030013000000000003330300500000000000000000000000010000001000006000000000035000000000101000000550110000303002303333000000001000010060060
000000000000000000000000000033033000000000000033330331030000000000000033303000000000000010003331500000303000000000000000003000000000033330333303303000003300000000030000
000000000100000000000000000000131000000000000000000000000000000000000001000000010000000000000000300000000000000000000050000001000000000000000010000000000000006000000000
000011111100000000000000003300100000000000100500000000000000043000300000000001010000000000300001110003033000000000000000000000000011101100001110000000000300001110000000
300000000000000000330000033310000000000000000040000000100000303000000000003301000000030000010000000000133000030000003300000000300004000000000000000003000000000000000000
000000000000000030000000333300000000000000000030000000000003003000000000300030000000000000000053000000003000000000300000000300000000000000000000100001000100000000000000
000000000000000033000003333300000000003000000000020000100003003200000000030000501000000300000000000033333203003000330002000010000000000000000100000001000000000500000000
000000000000000000000033333300000000550000000001001000000030303000000101000000000000000000000000000333303000000005000000000000000000000000000000000000003000000105500000
333330003333300000333333333303333300000000000000000000003033330000000000000330330300000000033333000333333000000000000330030030333330003033300330330000000033303000000030
