000000000000000000000000000000000000000000010000000000000000000000000000000000000000000000600000000100001000000000000000000000000000000000001005000030500000000000300000
000000000000000000000000000055500000000300000000000000010000100000000000000003000000505000000000600010000000000000000100000000000000000000000010000000000350500000000000
000000000000000000000000000000060000011100010000000000000000000000000000000000000000003006300000000300036000020010300000000000000000300050002000000000001000000000000000
000000000000000000000000000000000000121000000000000000000003010001030000000030000000000000000000000000000000040000000000000000000000300000000000030000000003000000000000
000000000000000000000000000000000000000000000310000100000000000000000000000000010300000006000000000010000000060000000000000000000000000000000000000000000000060000000000
000000011100000000000000000000000030005000000020000000630110001000000000000100000020000000003002000000020111010011000000000000003002000000000000000100002000000000001200
000000000000000000000000000003333003633333330333003003300002000000300000230000000333333336333030333000333000000000000003333303300033310333300000000300330333333033333333
000000000000000000000000000000000000304000000000000000000300000000000000000000000000000003100000000000000000001000000000000000000000000010050000100000000000000000010000
555000000000000000000000000000003000101000000000000000000000000000000000000005500000000000000000000000000006000055000000000000000000000000010000000000000000000000100000
000000004111000000000000000000000000000000000000000000000011100330000100000000000000000000000000010000000001100000000003100000000000000000000001100000000000000000000000
000000000000000000000000000000000000003000100000000000000000000003000000003000000300000000000000000000100600000000000000000000000000000001000100000000100000000000010000
000000000000000000000000000000000000000000000000000000030000030000000000000000000030003000000000000100000000010030000005000000000000000000000000000000010000000000000000
000000000000000000020000020000000101110000000000010000000000000000000100000000000030000000000000300030500030000000000000000000000000000000000000000001000000300010000000
333330333333333000333333333300000000000000000030006000000333363300003033330033033000000000000000000000000333100003333030000000000000000600001333331001000000000000000000
