000000000000000000000000000000000000030000003000000000000000060000000000300000001000000000600000000000000000000000000000000000000000000000000200000000000000002000000000
000000000000000003000000000000000000110000000300000000550000000000000000000010000000000000000000000030000003000000000000003000000000000000000003000000000000000000110000
000000000000000000000000000000000000000000000000000001010003000000000000030001000011000000000000000000000000000110060000000000000000000000000100030000000010000100000000
000000000000000000000000000000000000000000000000000010000000000003000000000000000000003000000000000000010130000000000000000000000000000000010000000000000000000000000000
000000000000000000002000000000000020000000000000200000000100000000000000000030000001000000000000030100000000500003030000000040000000000000000000000040000000500003000030
000000000000000000011110000031000040100000000001100000000000000000030000000000000000000300000000001100000000000000000053000011000000011000000000011030000100000060000000
000000000000000000000000000000050000333030000000033333336000000000000030000000003333000003030000010000000110030330000031000000000000000100000000000000000000000003033333
000000000000000000000000000000000000000000000000030000002000000100003000000000000000000000000000000000000000000300000010000000000000000300000000000000000300000003000000
011000000000000000000000005500000001000000030000000300000000000000300001100000000005011000001000550000000010300001000000000050004000000000000106000000005500000000000030
000000000000000000011000011100000001001000010000000000110000000000000006000010010011000000003001110000030300000000010000000110000001000000000000000000011100000000000000
000000000000000000000000000000000000000000000000000000000000000000000030010000003000000000000000000000000000000000000000000000100000000000000000001000000000000000000000
000000000000030000000000000000000000000001000000300000050000000513000600000000000000000000000000000000030000000200100010000001000000000000000000003000000030000000000000
000000000000000000000000000000000000000000000000000050300100000000001100000000000000003000000006060000000003001000000000000000000000000000000000000000000011000000300000
333333330000030033333333333300300000000000300000300333300000000000000030333333033333033303030300136000000000000030333303033333003033300000003000003333333305000020030330
