300000000000000000000000000000000000000000000000030000000000000000000000000000000050000000030400000000000000510000000000300100000050000001000000010000000003000000000000
000000000000000000000000000001030000000000000000000000000000000000000000000000000003000000000000000000000030300000000000000000000000000003500000010000000000000000000300
300000000000000000000000000010000000000000000100030000100000000000000000000003000000000000030000000000000404000144300010000000000000000000000100000000000044400010000000
000000000000000000000000000000000000000100000000000000000000030000000000003000010000000000000000000001000003000000000000000000000000000400300010010000000000000000000000
000000000000000000000000000000300300000000005000100000000000000003060010000000000006000000000000000000000000000000000000000000000000000000000100000003000000000000000000
000000000000004000000000000000000001000000000040000000000000000300000000000000000000000000000100000000000000005000000000000000000003000000000000000400000000000000000000
000000000000000000000000000033333100013000000000000000003333300000000001000000000500100000000000000000000333330303303333103313000400000000000040050000000033333130100300
000000000000000000000000000000000000000000005000000000000000000100000000000010000000000030000000000000000000000000001003000000000000000000000000000000000003000003000100
000000000000000000000000000000000000000003000000000100000000000000000100000000000000000000000000000000000000000000000000000000000001000300000000130000000600000000000000
000000044400011000000000000044000010000000000000000000600000000440000100000000003000000100000000001000000000000010000003000000000000000000000010000000000010000000000003
000000000000000000030000000000000001000000000000100000000000000000000000100000100600000300000000003000030000000000000000000000000000000000000000100000000000000300001005
000000000000000000030000000000000000000000000000000000000000000501003000050000000001500000000000000000000000010000000301000000300000010000000000000000000000001330000000
000000000000000000030000000003000000010000030000040000000000003006006003000000000000402000000000021000000001000000000300000000000000040000000030000000000000000330000000
333333333333333333330000000030330330000000033330300000003333303330300300000000002000000000000006000300330333153333303300003000000300001000000000000333303333033300000000
