000000000000000000000000000000004000006000000000000000000000000100300000000005003000000300000000001000000000000000010000000000000000000003000000000000000000000000000100
000000000030000000000000000000000300033000000000000000000020000000300000000020000000000000000010001000020000000000000001000300000031000001000000000000000000030000000002
000000000000000000000000000000000000000030100000000010000000000000300000000000000000000000000000000000000000000300000000000001000003010000000030000000000100000000000320
000000000000000000000000000000000000020000000000000000000000000000003000000000002000000000000000000000000030200000000001000000000200050010000000000300000000000000004000
000000000000000000000000000000660000000000003000000000030060000000000000000000000010000000003000000000000306000010000000000000006600040000000000000006600000000000000000
000000000000000000000000000020060200000000000300000000003066020000600000000000000220000000000000000000000000602000000000301200206600000000000000000400000000000000000000
000000000000000000000000000001333030000000600100600000000033333000000003333330530333000030000000003230035006330331300030000033033300000000003033333033330000031003333303
000000000000000000000000000000000001000000000000000000100001000001000000000000000000000000000000000000000000000000000000000000000000000000000000000000000000001000000000
000000000000020000000000000000100000000006001000000000000003010000005030000000000000000000000005020010000000000100030330000000003000000000020000000000030000000000003000
000000000000200000000000000000000000451000000000000000200000000100600000003000300000103000000000000000000000000000000300000000000000300000200060000000000000000000000000
000000000000000000000000200000000000000001000010000000030000010001000000000000000000203000000000000100100000000000000000000200001000000000000000000000000000000000000000
000000000000000000000006600000200000000000300000000000000000000000003000000000000060000000000003000000000000000000000300001000000000000030000000000101000000006000003000
000000000000000000220206602003000000000220000000000010000000300000000000001000010100000002000000000000010000000000000000000000000000000000000000000000020000400000000000
333333333333330000333033333300333030000303000000033333310333333300000003001000000000300303030303310300000000030000000000000300010000003330030000000001033300300010000000
