000000000000000000000000000000000000000000000033000000000000000000000000000000030000000000000000000000000000000000000000000000000300010003000000000600100000000006000030
000000000000000000000000000000000000000003000033000000000000000000000000000000000000001000000033050000060000000000000000000000000000004100600000000100000000000000000330
000000000000000000000000000000000003000000000033000000003333000000000004000004000000000000033330300001010040000000300000333030000000030000000000000000000000000000001330
000000000000000000000000000000000100000003000330000000003313030003000000000000101003001000033335015000000000000000000003333000000000000303300000000000000000000100033330
000000000000000000000000000000300000001020003030000000003312060000000000000004023000000000033330000000000000000001300000333000000000000033300000000000010001000000003300
000000000000000000000000000000000001000000303330000300000033303000000000600000000000030000133333030000000000000000000003333503000001000333300000000000000000000003033310
000000000000000000000000030000000000330000203323000003003333333000500000013001030000000000033330300000000000000010000103333333000030033330330000000000000031333333330000
000000000000000000000000033000000000000000000000000000000000000000300000000000000330000000000000020000300003000000000001000000000000000000100500000000003000000000000000
000000000000000000000000033000000000030000010000000000001100000000000000000000000330000000000000000001330000000000000000003000000010000000000000000000000004000010000006
400000000000003333000000333040000003333000000000010000000000000000000000000000003330000000000000000003030000000000000034000000000050000000004000100000000050000000300000
000000300000003333000003333000000003003010000000000101000000000000000000000000033334000000000000030030330000000000010000000004000031000000100000603000003000300003013003
000000000000003333000003333000000003033000000000000004000000000030000000000000330330000000000100000303330000300000000000600010000000010001000600000000000000000003303000
000000000000033333303303333000000033330303000000000000300000000000000300000402030300000000300000000133300000300000030030000000300000000000100000000000000000000003330003
333000033333333333333333333333303330303300000000300000001000000333333000000603303333333033300300103333333010030033003330330000000000003001000300000000030000001003033333
