000000000000000000000000000000000000000000000000000000000000003000000000000000000300000031000030110000000000000030000000000000000000000000000100000000030000000000000000
000000000000000000000000000000000000000000000000100000000000000000000000020000000020000000000020000000000000000101100000000000000100000000000000100000000000010000000003
000000000000000000000000000000003000000000000000000000300000010000000000660001100002000031010660000000110000000001000620010001000000000100000300000110000200040000000000
000000000000000000000000000000000000000000010000000000000000100000001000060000000006000000000660000000000010000030000060000000600000000300000000000000006600000000031000
000000000000000000000000000000001000000000010500002000000000000300000001660000000066000030000660000000000000100030000600000000000003001000000100000000000600010000003000
000000010000011111000000000003040001000001001000000000000000001000300000600010020060000000000665000301000000000000200601100000000000000006001000000002006600000001000003
000000000000000000000000000033333330000000000000000000000000000330333033333330035330133303333333333333333000100030300330000000033333300000000000500330333036363300000001
000000000000000000000000000000000000100030000000000003000305000000010010000000000000000100000400000000000000000000000000000000003000000000000000000000000000000000000001
000000000000000000000000200000020000006010000000000002000000100000001000000000000000003000500000000000000000000000010000000000000000050000001001000000000000000000000005
000410011000020000000006600000360000000000160000100030100000000000400000000000000000000000300000100000000010000200060000000100000000000041000066000000410000000000000000
000000000000660000000006600000660000000000000306100000000000002000030000003000000000000000000000000000000000306600660000000000000000000000000066000000000001000000000000
000000000000660000000006600000300000000000000006000000000000000000000000300000000001000000000030000000100300006630600000100000000100000060000066000000100000000000300000
030000000200660000000006600000660000000000002006001000000000000030000000002001113000101100000000001000001012006600660000000000000000100000000066000000000100004001113000
333333333333333333333333333330303303313000333001000000100000000333303300000000003000000000000000000006000330313333303330000060000000033303333600333353503000000000000000
