000000000000000000000000000000100000300000000100000000000000000000000000000000400000000000100000003000000030000000000000000000000060000100000000000000000000000000000000
000000000000000000000000000000000002000600000000000000000000010003000031001000600000000000000000000013000000000300000000000030000000000000000000000000020000000000003000
000000000000000000000000000000000005000000100000030000000000100000000000000000000300100050300000000000000000500000000100100000000000300000000000000000600000004000000000
000000000000000000000000000001000000000000000000000000000000300000000000000000000000000000000000000000003000000000000000000000000000300000030000000030360010003010000000
000000000000000000000000000000000000000000021000000060000000000000000000000000000000000003000000003030000000010000000000003000000000030000000030000000601000000000000000
000000000000000000000110000000500000000000000100000010000000100000000001000000000000000000003000000100000000000300100000000000000000012000000000000000600000000001000000
000000000000000000000000000000000003033033333330000000000000000130400000000030005000533330010033330000000000000600005000000000000010000000000000000033333301000000000000
000000000000000000000000000000000000000010000000003000000000000000000010000000000000000000000000130001000000000000000000000000200000000000000000000000000000003000000000
000000000002000000000000000000000000000000000111000000003000000300020000000530000000010000300000000030200002000000000000000000000000000000000000030001000000000000000000
000000000066000000001100000000066000000003000000130000001000000000060000030010000000000000010300010000600000000000000100006000000000110000001600000000000000050000000000
000000000066000200000000000000060010000000020000010000060000000010650002000000000001000000002060000000600000001000000000000600020000000100000000000000000000003000000000
000000000066006600000020000001060000000010060000000000000000300000660060030000200000000000061000000006650000000000000000016600565000002000030200000000000000000006600060
000000000066006600000000000000066101101000660000000000000000000000660006100000000000000000006000000006600010000000000005006600660000000100000000000000000000000006606004
333333333333333333300333330033131000000003333330000000000330333033333333333000003300000000030303003333303000000033303330333333303030033313003303300310333000000002333303
