000000000000000000000000000000000300013010000000000000000300000000000000000000000300000001010000000000000000000000000000000000005000010000000060000000000050000020000000
000000000000000000003000000300000000000000000000000300000000000000000000003030333000000000303330030030000010010000330000000000000001020000000000000000000300000001000003
000000000000000000000000000000030000000000000300301000000000000000000000100000001000500000000000000000000000000000010000000000000000000000300000000006000000000000000000
000000000000000000000000000000000000000000000005000000000000060000000000000000000000000000000000000000010000000000000300000000000000000000000000000000100000100000000000
000000000000000000000000000000000000000600000060000000000010000060000000000000000000000000000000000000000000000000000000000000000000000000000000000000000000000000050030
000000000000000000000000000000000000000000000000300000000000000000001000000000000000000000000000000000000000000000030001000000000002000000000000000000000300030000040000
000000000300000000000000003000300003000030300300000000100000000000003300000300000000000103002000000000030010000010000000000050000001000000000000030000040000000000000000
000000000000000000000000000000000000000000000000000000000000000000000000000000000000010000000000000000000060000000000110010000000300060000000000000000000000003000100000
033300000000000000000000000000100031000000000000000000000000000000000000000000000000000100000003000200010000000300000400000000000000600000030031000000000010010000003000
000000000000000003303000000000000000010000000000000032030001300000000500000000600000000030000000000000000000001000000000003001000000010000000000000010000000033030000030
000000000000000003000000000005003001000000000300000030000003000030030000000000200010000300000000000000000330000000000000003000000013001000000000000000600010000000003000
000000000000000003000000000000000301000000000000000030000000301000000000000000100000000600000000000000030000060000030000000100000000001000400000000000000000030000001000
000000000000000003000000000000000500100000003000600030000000600000000000000400600000000300000000100000030000000000000010003000000000000000000000000000100000030600000000
000000000000000000000000003300000000103000000000300000010000060003200000000000000000000001000300030030000000000000000100000000000010010000300000000003000301000100010000
