000000000000000000000000000000000000000000000000000000000000000000000000000003330300000000000000000000000000000000030000300000000100060000000000000000000033330000333030
000006000000000000000000000031010000050000000006000100000000000000000000000600000000000000000100000000010000000010000010000300000000000003000000001000000010000000000000
000066000000000000000000000000005000000000000116000000000100000000000000006600030050000000000000000300360001000000000000000000000003000000030000000000001000000000000300
000063000000000000000000000000000000000500000563000000000000000000000000060300000000000000000000000000600000600000000010000000000000000000000000000100000000000000000000
000066000000000000000000555000055500350000103066000003000005550000000000006000000000330000000030000000660003000006000000000050030000033300000000000100000000000000000000
333333333033330000000000000000000000000000003303331034300000000000000003013330000350000000300010010003033330333030000000300000000000030020000303433000000100000000000002
030000000000000000200050000000000000060001001000003000000100010060000003000003330333000000000003013000000001000000012000500000010000000100000000000000000000300330000303
000000000000000333333333330003333303333100000000000000000333301000000000000000000100000100003331300000001303330203033333000000003000003333000000000003000000003000000000
000000000000000000000000000000000000030000010000000400002000000000000000100000000000000050005000000000000000000000000050000010001500000000000000000000002001000000100060
000000000000000000000000000000000000000000000000001000001000005003000000000000005004000000500000000000200000000000000000000661000000000000000000000000000030000000000060
000000000000000000000000000000000000000000000000000000000500000000000000003300000100000500050000000000000000000000000000000634000000000000000003000000000000000000000630
000000033300000000000000000000000000000000000001000000000000000000000000000003330000000000000300100001550000000000000000000661060001000003005300000000550000000000000660
000000000000000000000000002000000000000020000000003000030000000300303000050000000010000000030000000000000040000000000003333331330333330010000000000000000001010003330200
000000000000000000003333333300000033300033000000000002000000003000000000002000000000000020000005030500020333103300000130301000000000333130330000030300003013012000560000
