303000000000000000000000000000300000300010303000000000000000000200000030305000000000000000000000000000000000000000000030000000000000030300000000000000000000000000300000
000000000000000000000000000000000000000003020000000000000000000000010043000000000000000300100010000000000030000000000000003000001000000000000000000006000200000000000000
000000000000000000000000000000303030000000000000033010000000000000000000030000001000001000004000003000000003033343000000000003100000000000000000000001030333030030011000
000000000000000000000000000000000000000000010010000000000000000000000003000005000000000003000000001000000040000010000000000030000100000000000300333000000000000000000060
000000003000000000000000000000000000000000000000000000000003000000000000000010000000000000003000000000000000000100000000000000000000000000000000000030030000000000000000
555000040000000000000000000000000000000000543000001000100000000000000055500000000000000000001000000030000030000000000000000000000000035000000003010000300000000000000000
000000000000200033300000000033333303330333000000000033330000000333333300000000003000303103001150010013333333333000003333033430005030300000003033330003303000053333033000
000000000000000000000000000000100003000000000000000000000000000000000000000000000000000000000000000006100303001000000050030000000000000000003030000010000001000000000000
000000000000000000000000000000000000000003000300000000000000000000010000000300000000000000000000000000000000000000000000000001000000000000000000000000010300000000001000
003033333000000000000000000000100000000000000000000000000000000000033131600000000000000000000000030000000000000600000000000300000000000303313000030000000000100000000000
000000000000000000000000003000000300000000006000005000000000030000000000000003000000000011001003000000000000200000000000000000000000000000000000000005000000000000000000
000000000000000000000000000000000000000000004000002000000000000000000006000000300001000000000000000000000000000000000000000000030000000000300000000030030000000010020000
000000000000000000000000000004500000000000000000140000000000000003000000000034000000000000001000000000000555003000000000000000400000000000605550000400300000000000000000
333333000033333333333333333003333100000000003333020000003033300533003010030300000020033333300000000003300000000600000003330333000002133300000032000000002030333000000000
