000000000000000000000000000000600000000000000000000000000000000000000000000000000000000100000001000000000000000000000000000000000000000000060000001001000000000000000000
000000000000000000000000000000030000300000000000000000020000000000003000400010000000000000001000000300000000000000300000000001000000000000000030000000000000000000006010
000000000000000000000000000000046000044000000000000000000000000000400000000000050000000000000100000000000000000000000000000010000000000041030100000000000000000010000000
000000000000000000000000000000000000300001000200000000600100000000000001000000002000000000000000000000000000000000000000100310030000000200000002030000000000000000000001
000000000000000000000000000030300000040000000006000000660100005300000300000000000000000000000003000000000100000050000000000000100000000000000000000000000000000000000000
000000000000000000000000000000001060000000000200000000660000000000000200000000022003000000000000000000000000000000000000000000000000000000020002000010000000000000000000
000000000000000000000000000033330330033010330333003333310000100330330300000003333330000000000030000033330400000003000000000000000002003033333333336300000000000000003000
000000000000000000000000000000000000000300000006010000000000001000006500000000000000000000000000000000000000003000000000000010000100000000300303000000000000000000000001
000000000000020000000000000000001006030000001000000000000000000000010000000020000000000000000000110001002000000000000000300006000000000010020000102100006000000006130011
000400000000020000000004400000000000306050001000000003000044000005000000000020000000000000000040001050000001000100000000004050000000000000020000002004430000000000100000
000000000000660002000000000000000000000000000000000000000000010000000004000661000000000000000000000000066000000000020000000000001000000333660030061515000000000000000000
300000000000660000000000000000010000000000000000000000100000000000000200000660000100000300030000000000066000000000000000000000000000000100660000066000000010000000000000
000000200000660022000000000001000000001000000000000000000100000000000000000660000000000001000000020000060032000300220000000000300000000000660000060000500000000020000050
333333333333333333330003333000010501000000003000300003003033330000000033503330000000000000003030333330330333333033030100133360000000033313003033330000303033303310000000
