300000000000000000000000000000000000000000000000000000000600010000000030000000000103000000000000000000000000000000000000000000000000000000000000000000000000010000003000
300000000000000000020000000000000005000000000000000005000000020000000000003000000000000302000000000010003000000000000000000000000002000100000000030000000060500000000050
110011111111111111111111111000000020000000000000011113101111111111100000001000010000111111100000000010110111011000000000000061030101300000001011110000000000054001010011
000000000000000000000000000000300000000200000030000000000000100000000000300000000000000000000100000000000000000000000000010000001000030300600000000300000000000000001000
000000000000000000000000000000000000006600000000000000000000100000000000300000001600000000010000000000000300000000000000100000000000000000000001400003010000010000000000
000000000000000000000000000003300000006101000100000000000000000000030003300000006650030300000000000005000000000020300000000000000000003300000000000200000000002000000000
000000000000000000000000000033033030033330130333000000000000000000000033333300035303000000013300330000000000000030300013033503100000033333300000000333363303303332060000
000000000000000000000000000030000000000000000000000000030100000300030000000000000010200000000000000000000300000600000000000000000000033001000000000000000050000000000000
000000000000000000000000000030000040000000000000000000000000000301000000003000000000210000000000000000000300000000001000030000000000000000000000000000000003000001001001
000000000000000000000000000001001111111100000000001101010000050110010100000001101111310000000000000001000000011133000001116111106031011001110000003000000011111100100101
000000000002000030000000000000000000001000000301000010000000101000000040000000100010000000000001000000200400000000002000000000000000000000050030000000023000000000000000
000000000066000030000000000000000000000000000001000000000300000000000000000500000000000000000310600006600400000000066000000000000000000000000030001000660000000000000003
200000000066000330000000000000000000000001200300060030000100000000000010000000000050200000000300000000310003000000011000000000000000000100000330010100660000000000000000
333333300333333333333333333300000000000000000333300003001333330000000030333330000000333330330330030033310000000000333330000000000000000000003033333000330304000000002000
