000000000000000000000000000000100000000000000000000030000030000010030000000000001000000000006001000000030000000000000000000000100000303000000000000000001000000000000000
000000000000000000000000000000000000000000000000000000500005000000000000000000000000000000000010000300000000000000300001000000300030000000000000100100013000000000000000
000000000000000000000000000000000000000000000000000000000000000000000000000000100000000300000000100000000000300000000000000000001000000001000003000000000000000000000003
000000000000000000000000000000030600000000000000000003000002000000000000000000000000000000400000000000000000200000000000002000000000000030160000000300000000000000300002
000000000000000000000000000000000000000000000000000000000036003000000000000500000000000000000000000000000006600300000000006003000000000001000000000000000000000000000000
000011110000000000000000000000000000000202002200010000001060006000000000200000000000000000000000110002000000650600000000066000300000000000000000400500003001021020000111
000000000000000000000000000000000003113333333333300000000333310000000030330333000000000000000060003303303333033205000000533333000050103333030000610000000033031330000000
000000000000000000000000000030000000000000000000000000000000000000000003100100000000000003003000040000000000000000000010300000100003000000000000000003013000000000013000
000000000000000500000000000000030001500000000020000005000500000100000000001000003000000000000100000500000000001000300000006000000000500000000000050000000005000000000500
000000000000000000100000000000000000001100000010000000000000100000000000000000000000000600000000030000110001000000000000000000000000000000000000000000000000601003000300
000000000000000000000000200006000000000000000200000000000000000000000000000300060010020000000030000000000010000000020000403000000000000000000003000000030100000000502000
000000000000000000000006600300000000010060006000100000030000000000000300000010000000000000000000000000000000000000000000300000000000000000000000000000000000000000066000
000220200220000000000006600606000001000000000101600001110000000000011300000000102002000000000022020000100100000000050021000000002000000001111000003002200000000000166000
333333333333330333333333333300000000303330333333300000030333333000000000000000303330000000003303303333333000000033333330000000330333304000060000000333030303330033330333
