000000000000000000000000000000000000000000000000000006003000000000000000000000510000000000000000000000000000100000000000000000000000000000010000000001030000000000000000
000000000000000000000000000000200000000000000000000010000000003200000000000601000000000000000000000000000000000000000000000000000305000000000003000000000000100000300000
000000000000111111111111111100000000001000111101130000101110300001110000000001101111111100000110003000000000001110000020001000011001100101101100002001110000000001010010
000000000000010111111000100000000000000000011101100000010111111031101100000000111010111131100111111000000010000000000310010000101111100001000000030001010100000000110111
000000000000011111111111101100000000000000116111130000011060110001011000000001011110111111000111100000100000000100000330000000110111100110050000033001013100000001111110
000000011000111111111111111100000000000000100111110000111111010001011600000101111111110140013100100000000110101150000040000600111031100100110000034000000000000011101330
000000011000000000000000000000001400301033000000011000003133300033500300000000000000333330030000030005000310000000000030333333000000033300033300050160000300000000000000
000000000000000000000000000000000000000000000000000301000000000300000000000000000000000000011001300000000000000000000000000200000000000000000000000000100000000000000000
000000000000000000000000000000000000000000000000000000031000000100300000000300000000000000000000000000000000000000005000030000000000003000000000003000000100000000000000
000110011000020011110111100010110011100000111100000311003000011000110011111110100000000100000131111113100010000000000111111000111001100000000000610011100301111140001003
000000000000310011111111111100010000500031031101100101500000000000000000010000000031000000000110110001030000003100000011110013000100000000000000000111110100030000000030
000000000000330011111111111000110110000033111011003111140000501000020011110010000330000000010101111010011000003000000011101110111101100000003000011111101011110010000000
000000000000340010011111111011111110003004111111000100103100010000000011111110000004000000010111111010111030003411100011111013101001100000001102010101110010011010000000
033333333000033330003333330000001003300003333330033300000300000060333300010003300000000033300010000000000330000011000000333000000000000000001000000313030001000000333330
