000000000000000000000000000000001000030010000020000000000005000030000000000000000000400000000000000000000000300000000000000000000001000030000000000000000000000000000000
000000000000003000000000000000000000000000000000000000000000000001000000000000000001000000031000000000030000030000000500000000101100000000000000000000000000000003000000
000000000000000000000000000000001000030000030100000000040000000003400000000000000000000000100300000000000005200200000000030000000200000004000000000000000000000000000000
000000000000000000000000000003020000060000000000000000000000001000000000000000060000000000000000000000003003000000000010000000000600000050000000000000000000020000000000
000000000000000000000000000000000660066000330000000000030000000000000020000663066001000000000000000001600006600000050660000100006600000000000000000000000000000060000000
000000000000000000000000000000000660006010030100000000000000000020002000020660066020000000000000000000000006601600230660000000003602000000000000000030030000220600000000
000000000000000000000000005533300333313330000000060000000000030303003330333333303303000000000000550000010335003303333300000000333330300000050000000015000033303300100000
000000000000000000000000000010000002000000000000010000000000000000000002000000000000000000000000000000000000000000000000000003000000003000000000000000010000000000000000
000000000000000000000000000300000000000000000000000000020000000000000030000000000003000000000000030000003040000000300001000001000001030000000000003000000003000001000010
000444000020000000000000000300044400000003000000000030000000000000000000000000000001000004000000000030001000000000000001000000000440000000000000003000100000000000004400
000000000660000002000003000300000000030003010000000000000000000000000000010000130000000000030000000030003000230000000050000003001000000000006000003000000000660000000000
000000000660000000066003000300000000130000000000000000100001000000000300000000040000000000000000000030003000006600000000030000000010000000000030003000000000160000200000
020000000660200022066003000302005000030003000000000000060005000003000000000100030000020000000000000030033002206600000000030002020000000000000030003000000000660200000001
333333333333333333333303333333303330030333030000000005600300000000000000000003033333330301000000003033333003333000000000033333333333300000033013333003005133333303333333
