000000000000000000000000000000000006000000000000000000000000000000300001000000000000040000000000060000010001000000000000000000000000000004000000000000001000000000000000
000000000000000000000000000000000000000001000000000000010000200302000301000030000000100020000000000001000000000000003006000000000000013000011030000000000000000000000000
000000000000000000000000000000000000000000000201000000000006600000200000000000000030000000000000030000000000000000000000000030010200000000000000403000200000000000100000
000000000000000000000000000000000000000000006600300000000006600006000000000000000000000300000300000000006000000000000000010000006600000000000010000006600000000000000003
000000000000000000000000000000000000000000006606600000000006600006006600000030000000002001003300000000000000000000000000000000006000300000001330000006400600000030000000
000000000010000000000000000000000002100000006100000013000006600001620100000000030000001003033300000001000000000000000000520000006606600010003330006036001000000000020200
000000000000000000000000000000000500000100333333300600000033300333343300060300000000000000030000000000000000110000003033333033330030000000000300005333333100000053333333
000000000000000000000000000000000000030000600000000000000000300000000000000000000000000000000000000000000000000000000000000000000000101000000000000000000000000000000000
000020000000000000000000000000000000000000003020000000000010000000100000001010000000010000000000000000200030000301002000000000000000000000000000300000000003002000000000
000660000000000002000000000302000000000000000060000030030000003000000000000000000300010000000100001001300000200000016000000003000010000000000000000000000100066000000000
000660000000000066000003000000000000000000000660003300000030030000020005000000060000000003100000000006600006603000060000030000000000000010005005001000000000006000001000
000660000000000066066033000000000000000000000660103003010030003000000000010000000000000000000000000006600006606300066110330000000000000000000002000000000005056000000030
000660000202000066066333000000100000020200000660000300603430000002040000000000000000002020000000000000606006100600066003300000000000505000000000010010000000001000001000
333333333333333333333330000000000000033030333030333000010000000033333000000000000000330333300000000134303330303333133333300000000000000000101030000300000030033000000000
