300000000000000000000000000010100003500000000000000000000000000100000006000100000000000200000030000500000000000000001000000000000000000000000000000000000000000000060000
300000000000000000000000000000030003000000000010300000000000030000100036600000003000000000300000100040000000002000000000000100000000000000003000000000000000000003160000
000000000000000000000000000000000001000000030000000000030000001000000000311100000000110101400000030030000000000001000000000000000000000000000000000000000300000000031110
000000000000000000000000000000000000000000000000300000000000000000000010000000000000100001100000000000000000030000000000000000000000000030000000500000000000103000006000
000000000000000000000000000000000000000000030000000300030000000000000000000000000000000011000000030000000000000100000003040000000000000000010300100030000300000030000000
002000000000000011111110000000030000320000001011100000000011111000030000100001100000000000000000030010111000000000011100020000000000001003000000000000000300000000103000
066000000000000000000000000033303300060000030100003303030100000003000030333000500000033006303033030000000033303300000000160310000000000000101600000030330333330313330333
066000000000000000000000000000002000000000066000010000000000000300000000500000000000060006000100003000000000000000000000060000000000000003000000000000000000060000300000
366000000000000000000000000000000000000000066500000000000000000300000003000050000000366000000000003000300000000000000003060001000000000000000000000000000000000000000000
003111000000001111000000000300000010000000001111011010001001000000000000000030000000000111010000000000000000000011110034031110000000300000000030000300000010100000000000
000000000000000000011000000006100001000000000000000000011000011010000000000000000000000000000000000000000000000010000310000000000030010000000000000031000003000010000030
000000000000000000010000000300000600004000000000000000000000010000010300000030000000000000303000000000000000000000040000001000000606300000001000000000000000000100600500
000000000000000000000000000311000000000600000003100030000000000002000000000035000000000030011000000000100000100000000000000000000000300000002010010100000000000000000000
333333333333333330003033330300000000030000303303330300000330003066000003330030031330363303300000000660000000000003000033303333005330333330030030000000000010000033000000
