000000000000000000000000000000000000000003000010000000000100000000000001000000000000000000000000000000000000000000000000000000000000000000000000000000000000100000000000
000000000033000000000000000000010000010000000030000000000000000000000100030000030000000330000000000000300000100000000000000000000310000000000000050300000000000000001000
000000000000000000000000000000000000000006000000000000000000000001000001000000000000003000000000000000000000000000000000000000000000000000100000000000005000000000000000
000000000000000000000000000000020310000000000000000000030000000000000000000200000000000301000020000000000010000100010000300010000000000000000000101000000000000000000000
000000000000000000000000000000660003000000000103030000000006000003000001000000030100000000000600000000000000100000000000000000011000021005000030000000000000030000000000
000000000011111100000000000000360000000030000111100000000066000000220000011110300000100111130100000000000000000000000000000100000111000000000001000000100001000000000000
000000000000000000000000000030010030003333300000000300003333003333333300000000001000000000030333300000000030333300003330600000000000033333030000000000000000000000103330
000000000000000000000000000003000000000004000000000000000000000000000000000000000000000000000003000000030040000000000000000000000000002000000000030000000000000000000000
000000000000000000000000000000001300000010000000000300000000100000000030300000000000005000006000000000000000000000000000000000000300001000000001200000033000000000000000
000000000000000000000000000000100000000000000000000000000000000000000000000000000000000000000030000300000000000300000000000400000000000000000000013000030000000100002000
000000000000000000000000200000600010000000030000000000000000030600000000001000000000000000000000000006004000000000000000000000000200000000000000000010000001020000000000
000000000000000000000006600000000030000000000000000000000100000000000000000000000100000000001030000000000004000030000000000000006600000000000000000000000030060000000000
000220200000000000000006600010003000000302130000303000060000000000000006000000000100000000000022020000000110000001000001030000000600000022020101202000011104660000000000
333333333333330003333333333350001000333333000000033333310003303000000000103003340330300333333333030000000000000000000010000000303333333300133303001000000033333303000303
