000000000000000000000000000000000000010030000000303000000000000000000300000000001500000000000000000000000030000000000010000000000000000100010000000000000000000000000000
000000000000000000000000000000000000000000000010000000000000000000020000050000000000000000000000000000000000000000000300000000000020000000000000200060000010030000000005
000000000000000000000000000000000000000000000000000000000002000000660000000000000000500000000000000000005000000000030000000000000660000000005006600000000500000030010000
000000000000000000000000000000000003000050000003000000001066000000660000010100000011000000000000000000000001003000000000000000000600000660000006600000000000000000030005
000000000000000000000000000000000000000000001600000000000063000100060000000000104000000300000000000030100300000000000000300000000063000060000006600003000000000001000000
000000000000000000000000000000000500000000306002000204102036000200610000001000000000000000000000005010000000000000000000000223200640023660202006600000000000000000000000
000000000000000000000000000000000000000000330013033303030333330003333000000000000000000000000001000000003000000000000033333330330300333003333333030000033300100000000000
000000000000000000000000000000000000000003000000300000500000000000000000000000000000000000000000000000000001000500300000000100000000000000000000000000000000000600000000
000020000000000000000000000000000000000000000000000000000000000000500000000000000000000000000000000000000300126000001000000000000050000000000000000000000000000000000000
000660000000000000000000000500000000002000000660000000001200005000010000000000000000000000000000000030000000060000000000000010300000500000010000000003000003000000000000
000660000000000066000000000000030000000003000600300000000000000013000060000000000000003030000000000066000000060000005000000100000000000100000006000000000000000000100050
000660000000000066000003000000300000000000000060000000000000000601000000003000001000000000000000001010000000660000000000000010000000000000000006000000000000000000000000
200660000202202066020003000000300050000060100660000000000000003000000000000000020222002032600000000006020200600000030300000000103000000000003000020000000000202200000000
333333333333333333330000033300023330000000330333000000000000333000010000000003333303333333000000000333360333033330003030000000000033300000003300330000000033330302000003
