000000000000300000000000000000000300300000000000004000000000000300030000000000000000000000000000000000000000000000000003000030000000000000330000000000000000000003000000
400000000000000000000000000000000000000100000000000000000000003000000140000001000000300100000000000300000000000000000000000000000000000000000000603003000000000000000000
000000000000000000000000000000000000000000000000000330330033303000103400000000000000010000000033330000000300000000100000000000000000530010000000003000000033000000033303
050000000000000000000000000000000000000000000000000000000010000003002001000001000000000000000000000003000000000000000600000000000000200000030500001000000000000000010200
000000000000000002000000000003010600000005000000000000000000000200000000000000000130000230000020000000000030000000003001000000000200000000000000000000200000000000000000
555000000000000002000000000030000000001100555010000000001000000100100011500000000010000000000000000000000000000000300000000000100200000000005500000053200000000005030000
300000000033300033330000000000033003303330300000000000000000000003013330030000100000050333000300003333033000003333333330003000003333000000330000000001333600000330030000
000000000000000000000000000000050000040000000310000600000000030000000000000000030000000000000000001000010300103200000000000010000000000000000000000000000000001100000010
000000000000000000000000000000000000000000100001000000000000000000000100000003000000000000010000004000000000000000000004000000005010000000100506000000000000000000000000
003333333000000000000000000000300003301000000000003000000000000000000000100000000000030000000000000000000001001100000050030000003303300000000000000000000000001000000000
000000000000000000000000002000000200000000000300003000000000010000000000000000000001000016000000033000000000000000000200000000000000000000000000000100032006000000000000
000000000000000000000200000020000000100030000000000000000200000000000000000000000000200000000010000000000000000010000000000000300000000000010000000200000000000000000040
000000000000000000000000000002060000100000000200000000000100000000000000020000000000000000000035005010000000000000000035550000000000000300000000000000010000000103000000
003000000000333333333333333303033000000033000333000000000013030333333300333300000033333133301000003000000000033003333303000020003000100000000000000033333003330300000330
