000000000000000000000000000000000000030000000000000000001031005000000000300000000000006000000000110000000000000000000000000000003000000000000000000000010200100000000000
000000000030000000000000000001000300000000100000000000600002000000000003000000000010060000000000120000000000350000000030003000100000000000100000003010030000030000030030
000000000000000000000000000000000040000003100000000000000066000000300000000160506000000000010000660000000000000000000000003000000000000010101000006000000000000000000000
000000000000000000000000000000000000000000300000000000000066300003300000000660000000100100000000660000000010000000030000000001000000000000000000060200001000000000000000
000000000000000000000000000001000000600000000000000000300000000030300000010000000300001000000000060000003000000001000000000000000300040000000000060000000000000000000000
000000000000000000000000001100000110000000050002006100003066000031000200200660001011000000000200660000011000000000330026000000000001100300200020065000000000000000000020
000000000000000000000000000000000000000031033333000000003333333333300333533330000000030000030333030000000000000033033030000000005000033303333301300000000000300003033303
000000000000000000000000000000000060004030000000000000000000100000000000000000000040003000000000000000000000000030000000000003000000000100000000000000000000300000000000
000000000000020000000000200000000001000530000200000000120000000060000430000000003300000000000000000000000000000600020060000300000000000000000000013000000000000000000300
000300000000660000000006600000000000003000006600010000060000000600000000000000000000006101000010000000000100000000660000000060003000000000000003001000000000660000000010
000300000000660000000006600000003000003100000000000000661010000000003005000000000000006600000030100010000000000001060200000006000000000000000013000000100000660000001000
030300000000660000000006600000000000600000000010000000601300000000000000000000100000001630003030000000000000000000600000000066000300000031000003000000000000060000100000
030300200200660000020006600000030000300002006000000200660000000000000000100200000000001000003000000000020000000000660000020060000000000030040303002010000000660100000001
333333333333333333333333333300000000333133330333333303030030000001000033030330000000033303333033033330013000000033333333330033000000006000100333303000000000333360000000
