000000000000000000000000000000003000000000000000000000000000000000000000000000000000300000000000000000000000000050000000000000030000000000053000300000000000000002050000
000000000000000000000000000030060000000000000000000000000001000000000000000000000000000000000000000000003000000001110110001000000000000000000000050000300001110103000000
000000000000000000000000000011110000000000000000000000000000000000000000000000000000000000000000000000010100000000000001000000030000000030000003000101300000000000000000
000000000000000000000000000000000000000000000000030000000000000000000020000000300001000030000000030401000000000003000003300000100030000003000000000300033000002000300501
000000000000000000000000000000000000000000000000000210000300003000100000000000300000000066006000000000000000000030000000300000000000000000000000000000000030103000300000
000001414000000000000000000001000100000014000100000002000400000000300000000101000200000066604000000300000000030030000000050200010000000000141400030000000000000002000003
000000000000000000000000000033333330000000000000033133300000000000000000000000233333333333300000000003010131000133003303313333000000000000000000000003333330333303036330
000000000000500000000000000000010000000000000000000300000002050000000000000000000000000005000000000000000000000000000000000050000000000000300000000000000000000000000000
000000000000000111111000000000060001000000000000001131110000303010111100000000000000000000000000000110311000000000000000000000000003000000000000000000000100000000000000
000000011111000000000000000000000000000000003000000000001100000000000000000600000000101100000000000000000000020000006033110100000002010000005000000000000000000000000003
330000000000000000000000000000000100000000000000030000300000000000000000000000000000000001533000000000030000000000002000000000000000000000000000500000001100300000000000
030000000000000000000000066000000005003600000000000000000403000000000000030000000600000000003000000000003000000000006600000000000000000000000000000200000010000000000000
000020000000000000000000066600000000010660100000000000010000000000000000006060000000000000000000000000000000003400006660004630140000000000000000000030066600000006000004
333333333333333333330333333300000030333300000000033303503333033333333033330330000003333300300333333003301000000003330330333303000004000000030000300033330300000000100000
