000000000000000000000000000000000000000000060000105000310003030000000000000000300000000000100000000000000000000000000000000200050000000000000000000000001000000000000000
000000000000000000000000000000050000000000000000000000000003030000000000030200000000000000000000000000000000003000000000010000000000000000000000000000000310000030000000
000000000000000000000000000000000300000000003000000000000000030003001000000000000000000100000000000000000000000000000000000030000000000000000000000001000000000000000000
000000000000000000000000000000230030010000000000000000000003330000001000100300000000000000001033000000000000010006230030010000000000000000000000000000000000100000023003
000000000000000000000000000000000000001031000000000000000003300000300000000000000000000000000000000003000000000000000206005000000001000000000000000000010000500003000000
000000000000000000000000000000000030000000000000000300000003333000000010060100000000000200200000000000030000000000030030000000000000000000000000000000010600360010000013
000055000000000000000000000003333333003333000005110000003330333000000010000300000551335033000005500010000000000033333333330310000305001000000000000000050033303303303333
000000000000000000000000033000000000000000000000000003300030000000000000000000600003000033000000000000000000031010000000000000000000000003300000000000000000003300000000
000000000000000000000000333000000600100000000000000030300030000000003200000000000010000303004000000000000000000000000000000006000000000033300000000000000000330000000000
000000000000000000000000003000000000000000001000100000000000001000000010000000000000000003100000000000000000100000000030000000100000000000300000001000000000000100000000
001000000000000023003000333000000000100000030003000000310000000000010000230030000000000333000000300023003001000000010000000030000000000303100000000006000023030000000000
000000000000000000000000333000000000050000400000001033302000000000020000000000031000000033000000000100000001000000000000001000030030000033300000002000000000003300000000
000000000022020003003000333300000000000000000200200033330002202000000000000000000000000333300000010003000000003000000020100000000000300033030000000000030000031330002002
333033333333333333333333333300000000000000300300333333333330300330033333303330003000330333000000001313033033030333303330000003000000333033330000000000050033030333313033
