000000000000000000000000000030000000000000000000000000000001000000000013000600000000010000200000000300000000000010000000100600060200000000000000001000000000000000000000
000000000000000000000000000000000000000000000000100000100500000000000000030050000030500000000000010000100000010001000000000000300000000000000000000000000000000100000100
000000000003000000000000000000001006000000000000000000000000000000040040000000000010000030000000300000000000000000000000000000003030000000100000000006030300000010000000
000000000000000000000000000005000000000000000000000000000200000000000000000003000000000000002100000000001000000000000000000000100000002601000000010000000202000000000000
000000000000000000000000000000001000300000000000000000300000000000100000010000000010000000020003130000000000003032000000000000030006000010010000000000000000000000000000
000000000000000000000000000020001000000000001000305000000000000220000000002000000000000000100000500000000000000000003000000600000022010000002010000000000000001000000000
000000000000000000000000000031330330000000303333000006003303333333330330303030000000000000003333000000000000000000000010000000033330333333301310033000300033333330030003
000000000000000000000000000300010000000000001001000000000000000000000000003100000003000000000000030000000100000000000000000050000000300000000000003000400000000000003000
000000000000000000000000000000000000010000000006005310000100000000000600000000000000000050000000000000000000000030000000000000000000000000000000000000000010000000000000
000000000000000000000300000300001000000005000043030003030000300000000300000003000003000030000000000000000000060060000010000060300001300003003000503000000030000000000000
000000000000000200000030333300000000000000000000003033300000000010000000000000303300030000001033330000000000300000000000000000030301300000000303333000033030010000000000
000000000000000000000333333300000600000000000000000333030000000000000000000005303333000000031333331010000000000000100000000000333330350030003333303001000000100001000000
000022022000000000000000333300002206000000000000000033330000003000000003000000003333221000000133330000030000022022000000000000000333300000000003333000000003000000000000
333333333333333333333000330303333300400000000100000033000000000000000000000000000313005333300033000000000033303033333030100000000330300000000003303333133300000000000000
