000000000000000000000000000003001000000000000000000010100000000120000300000000000010000000300000000000001000000000100000000000000000000000000000000000000000000000000000
000000000000000000000000000000100000005000000000000000000000000010000200000050000200000050000000000000000003000006000000100000000000000000000000013300001000000060000000
000000000000000000000000000000001060000000303333001000030000003002000310000003330330333336030000100000003000000000000000000000333333000000030000000000000003333300000000
000000000000000000000000000000000000100000013300003000000000000030003000033000000000000000000000000000030000000000000000030000000000000000300000001000000020000000410001
000000000000005000000000000000000000000000000000000000305100001000006000000000030000000000000000030000500000003000000005000000000000000030000000100000000000000000000000
000000011110000000000000000000100001111004000000000000501000001000000010100000001000000000000000000000030111100000000000000100000000000000005000000000000000000000020000
000000000000000000000000000000000100000000010000300030000000000300330100000000000303000000000000003303300000000000010000000000000000033333130000000000000000000030033333
000000000000000000000000000000000000000000000000000000000000100000000000000000010000000000000000000000000000000300005100000000100000000000030000000000000000000000310000
000000000000000000000000000000000000000030300000000060000100000000000000000000000000000000010000000000000030000000500000000001000010000000000000000000000000000000000000
000000333333300000000000000300003000000000000000300000000000000000000000000000000003000000000000000000000000010300000060000000000100000000030000000000000000000000000003
000003000000000000000000000000000000000000000000000000000000000000003000000000000000000000000010000000303000000000000000001000300000300000003060000000000000000000000030
000000000000000000000000000000000000000001000050050350000000000000000000000003000000000001050000000000000000000001000100000000000000000000000000000000000010000000000000
000000000000000022020000020000230200000000000020000000300300000002002000000000030200002202000000000000100000023000220000000000111100000012000000200001000000000003000000
333333300000033333333333333333033000000000336311000005003006000333633300000003330403033333300000000050000033300333333350000000001000033033533330313000103000000001033333
