000000000000000000000000000000100000600000000000000000000000000010000000000000030030000000060000000000000000003000000300010000000030000000000000000003003000000000000040
000000000000000000000000000000000010000000000000000000000100100010000000100030500000000130000000000000000000000000000300000000000000010000000000000000000000003000000003
000000000000000000000000000000000100002060000660000000000300000000000000000000301000000660100000050002100300000000000000006600000000100000000000060000000000000000000000
000000000000000000000000000000000000060000000600400100000000000000000000000000000000000500000000005066000000105000000000006600000000050000000000000000000000000000000000
000000000000000000000000000000000000066000000600000000000000000000000000100000050000000661000050060066000000000000000000006650000000000000001020003000000000010000003000
000000000000000000000000000003000004006000000600000003300003000000000000000030000000200060000000000060000000000000000001000000000000000000000000000000000000260000000000
000000000000000000000002000000100003303333333133300000000010000133333300000003360033332533000000001313303000003033000003033333000003000000000000000330000100000003030333
000000000000000000000003003001000006000000000000000301300000000000000003000000500000300000000060000000000000000000000000000003000000000003000066000000000001000000000000
000000000000000000000000000000000000000000000000000000000000000001000000000000000000000000000000000000000001000000000000000000000000000000050000000004000000010000000000
000660000000000002000000000000030000000000002000000020110006606000300000020000003000050000013000000000000100000000033000000000000000030030000006600030000000010000000000
000660000000000066000000000010000000000000000000000000000006600000000000660000000000030000000000000003000003000000000000000000006600000000000006603000000000660000000000
000660000000000066000000000000000000000030000010000000300000600000000000661000000100000000000000000000000000000000100000000000000600000000000000300300000000660001000000
200660000000000066000000000000000000000000000000000000002000100000000100660000005000000000000600000100000000001000000000015000000600100000002006600000000000600000003000
333333333333333333333330003300000003300333000000003000033331033000000003333130020000330303300000005000010000000033333300000000313333000000003331333000000100331330020000
