000000000000000000000000000000000010000063000000000000000030010000600000000100000000003000000000000020003000000000000000000000060000000000000000300100000000000000000000
000000000000000000000000000000000010000000001000000000000000001000000000000000000000000000000000001000010000100000000000000000000000000000000003010000000010000000100300
000000000000000000000000000000000000000501000000000000005030000000000000000030100000000000000005000000000010000000000000000006000000000000000000000000056000000000000300
000000000000000000000000000000000000030000040000030003000000000060000000000003200000020003000000000000000010000000000000000000000000000000000000000060000000000000010000
000000000000000000000000000000010010000000030000000000000010010000000500300006300000660010001000000000000000000066000000500000060000000000000600000000000000000000003000
000000000000000000000333000000000003000300222020033000000000000333000020201000600000660000000000000000010333003063000000000000000000000000000005000210000000300002230200
000000000000000000000000000000000003533333033330300000000003330003000053331333330300333330000133330000010000001033033000000100301133200000000000000330033320031133333333
000000000000000000000000000000000000030030000000000000000000000000000000000000000000100000000000000000000000000003000010000000000001000000010000100000000006000000000000
000000000000000000000000000000000000000000000000000000000000040000000060000000000000000000000100050030100000000000000300330000000000030000000000000000000000000010000000
000000000005010000000000000000001000000100600000003000000000300000000000000000000500000000600005010000000000000000000530000000000050100000000001000000000100300000000000
000000000000000200000000000000000000200000002000000000000000000000000000100000000000000000000000000000000000000000000000000000000000000010000000000000300000000000010000
000000000000006600000000000000000006600000000000000000000000000000000600131000000000001000000000600000160000000000500500000000000000000010000000000305010000000000003000
222020020000006600000000000000000005603000000000000000000000000000000000000002000000030000023000000200200000000033300024220000100030000000006500000000000031300000000000
333333333333333333300000333300030013330100000330310000000000000000000000000000313303000000053331333330130000000000000203330033030333300001003333300000000000000000000000
