000000000000000000000000000000000300000000000200000000003000000000000003000000606000000000001000000000000300000000000000050000010000000000000000000000000000000100000000
000000000000000000000000000000010000500000000000000000000000300000000005000100000100000000000000600000000000000000600000000000030000002000000000000010000000030000310000
000000000000000000000000000000000000010100000000000001030000000016000000101000060003100000000030030000000003000000000000000000001100000000000000000000000000020000010110
000000000000000000000000000000000000300000000010000200036000500000000000000000120000000000000000000066000000000000003000000006000100000000000000000000000003600005000000
000000000000000000000000000000000000000030000000000000430000010005000000000000030003300000000001000066000060000000003000006000000000000000000010000000000000060000000000
000000000000000011000000000000000000000033000100000000330005000001100000000000000003000030000000000066000050020000000000000000000000002002600000000000000000600001300000
000000000000000000000000000000000000333333000000133303030000100000000000333333000033006010000300000333301030333300040100000000333333031303300001000000000033331033333330
000000000000000000000000000030000000000000000000010000000000010000000000201000000000000000000000000000000001000000051000000300000000000000600001000000000000001000003303
000000000000000500000000000000000000000010000000000020000000001000100000000000001000000000400600000010000050300000000000000000000000000000000000001000010000000000000000
000000000020000011100000000300020000000000003000000000000000000000000000010000000001000001300000000000300000010000000000000000000200000006030030000000000000000000000003
000000000660000000000002000300610030000000030000000000010001000000000002660000000000002000303000000010000000000000000100000000006400000000030001000000000030000100003003
000000000660000000000000000300660000000000000000000000000000300000000000600300000000050000300000000010000000000000000000000100006000000001020600000000000002000000000023
020020000660000000000000003300060000000000000020000000000000301020020060160000000000000003000000300000300100000000010000060000016600000030330000000520120000110000000013
333333333333033333333333333333133030400001303330600000000000100330333333333030000000333333300000000000000333333300000000003000133300303003012000000333000300000033333300
