000000000000000000000000000000100100000014000000000013030000000000000060000000000000000000000000000000000000003000000000000000000330000000000000303000000000000000000003
000002000000000000003000000300000000000000003000103000000000000000001000000020000003000030000300030001003000000113303000000000300005000000000600000000302000003000000001
000000000000000000000000000000000000001000301030030001300000000000000600000000000000300000001000000000000000003030000000000030300330300000003000303000000010300000000000
000000000000002000000000000000500000000001200000000550000000000003000000000002000040040000320006000000000000003000000030000000005500600000000055000000000010000100000000
000050000000000000000000000000000000000000003000303033000000006100000003010000000000000000000000000006000000033000000000013330033301000000000303300001050000000500000000
130033300000000000000000000000000003300000000000000000033000100300000000000000000000000000310000001000000003133300000030130333000000000000000000000130031300600033330100
000000000000000000000000000000000000010300000000000000100000000040000000030050030000000000000030000000000003313300000000330333000000000000000000000000000000000000000000
000000000000000003333000000000000000000000000000000000000003333000001100000010000000000000000000000000301003333300000000000010000000000100000000000000000000000000000000
000030000000000000000000000000100000000300004002000000000000000013002000003000003000200002020301000000050000000000000030000000001000300000200000500000000300001030000000
300000000000003003333000003000000303100000000001000000000003033300000300000000000030300000010000000000000300033300000000000000002000000000000000002000003000010000000103
000000300000000055000000003000000300000033003000000000000055000000000000000210000030000000000000000000000005500020000000000000000010000000000000000000000020000000010030
000000000000000333300000333000033300000000000000000000030333100000050000040036003330000050000003000000103030330000000010000000031005100005000000003001000000000000013330
000000333300000000000003333300003030000030133033000000300000000130003000010030013330330053300000001330000000040000030003300000000000300003330000000000010000000030033033
000000000000000000000033333300330330000000000000000000000000000000000000000003353333000000000000000000006030000000300100000000000000000000000000000000100000300000333030
