000000000000000000000000000000000000000300000300000000010000300000300310000020000000030000000000000000000000000100000001000010000000000000000000000000000000000000010000
000000000000000000000000000000000000000000000000000000000000000000000000000000000000000000000000000000000003000004000000000000000100000000000000000030001000000000000000
000000000000000000000000000000000000110100000000300000030000000000000003000000000000011000000002000000000000000000000000010000011010003040000000000000000000046000003200
000000000000000000000000000000100000001500000000100000000010000000000000012000000300000000000000030000000000000000000000000000030000000002030000300001000000000000000003
000000000000000000000000000031333300000000000000000000000050000000000000000003333310000000000100000000000000000000300000600300000000000000003330330000000000000000000000
000000000003300000000011111103333002000000000033000111110000330000000000000000333500010000000000000000000012111150000000015111000030600000000033300011101100000000000000
000000000000000555000000000003333003300033003060000000006000000053500000000003303000333330000000200000000001000000030001000500033333300333300330010000000000303310000010
000000000000000000000000000000000200000000000000100000000000000000000000000010000001000310000000000000000000300000000000000000000000000000000103003000000600100100000001
000000000000000000000000000000500000000000000000000000000000000000000010300000000000000010000000003000000303000000000000100000000000000000000000003000100000000001000000
000000000002000004000011010000000000000000001400000002003000200000300001305000000000001300000000100001000000010003002000000000000000000000000100000000000001001000000000
000030000000030000000000000000000000000000000000000000030030003000000300000000000000000000000000000000300000000000000030000100000000000000000000000000016000000000000000
333333000000000000000000000000000000000000000000000000000003300010000000000000000000000006000000033031306000000000000000000000100000033303300000001500000000000000000030
033330000000000000000000000000000000000010000000000000000030000000000000000000011010000000000000000333300030003000000000000130330000003303010000000000000000000300000000
333300000000000333333333333305550000000000030333010000000000000013333433033300000100003003305550003033000000000000000000000000055000033330010055000000000033300330000000
