303000000000000000000000000330300006000000000000000002000030100000000000000020000000000000000000005100003033000000000000000000000000000000100000000000000030000003000000
000000000000000000000000000000000000000000000000000000000000000001000000030000000000000000000100000000005000000000000300100000000000000001100000030000000000000000000000
300000000000000000000000000030000000000000000000000000003000000061000030000000003000000000000010000000005010000000000100000000000000000000000306000200300000000003000010
000000000000000000000000000000003000000003030033300000000000000000000000000000200100000060000200300000000000000300000000000033031100000000000000000000000000003330000000
000000003000000000000000000000000000000000000033303000000000000030000000010000000000000000000000000060010130000000000000000333000000060006000000000000000000103330000000
005000000000000000000000034000000000100000000000000000000050000000000000000000100000000000003000000100340000000000500000300000000000001001000000000000000000000030000000
303000000000000000000000000030300303000003333300301000003000000000100000300000000005333333030000030000060300030330303030303303300000300333330000030300000000333033030000
000000000001100000000000000000002030000000000000000001100000110000600000000000000000000000000030000000000003010000000000000003000000300000010000000000000000001100000003
000000000001100000000000000000000000000000000000010011100000100000000000000000100000000111000000001000000000300000000000010000000000000000000000000000000000001103010000
000000000000000000000000300000000000000000000000000000000000300100000000000000000000000000000000000000000000000000560000000000000000000000000000001000000000000000000000
000000000000000000333000000000000030000000006000000000000000000000010000001330000000000000003000000000000000100000000300000000010000000000000000000000000000000100000000
000000000000000000333000000010000000100000000000000000005000000000000001003000400000000000000000000010333000000000000030300300000000000000000000030000000000000000010000
000000000000000000000000000000003400000000000000000001000000000000030000300000000000000000000000000000000015003000000000000001000034000016000000000020000000010000000340
333333000333333333303300000300000003033330000000000333336033300000000033533030300030000333300000003133003303000033030000000000000000000000000330330000000003333333000000
