000000000000000000000000000000000000100000000000000000000000000000000000000300003000000000000000000000000000100000000000010000000000030000000000000000000000000000000000
303030000000000000000000000000000001000000303000000300013000000000001000000000000000000000000000003030300006000100000000000000000050030000000000000000000000000503300000
000000000000000000000000000000600000110600000000000000000300000000000000000001000000000000300000000000000000000000105000000000000000033100000100000010000000010003300300
000000000000000000000000000000000000000000310000000000003000033000000000000000030000000010000000000060000000030000000000000000010030031033330000005000030100000000300303
000000000000000000000000000030000000000000000000000000023300300000000000000010000002000004200000000000003000333000000000003000000333303000000000000000303300000000000000
550000000000000000000000000000000000000000550000000000003000000000000000000000000000100000000000065500001003330000000000000000403330031000000001010001030010000013300000
000000003000000000000000000001033000000400000000001333003000040030003000000003333330333033010000500300000033333033133300300300300033330000000000300033331300300003030000
000000000000000000000300000000105000000000000000030000050000000000020000000000000010100010000000000000000000000000000000000000000000000000300000000030000000000000000100
000000000000000000000300000001000013000003000000000000000000000100330000000000000000300000000000000010000000000006000003100300000000000000003030300000000000000000000000
000000000000000000000330000005000000300000000000000003000000000000000000000000000000313000000000000000000000040000000010000000030000100010000000000000000000000000100000
000000000000000000300330333300000003303303000060000005000000000300000000600030000000330003300000000100400000005000000000000000001000000000000000000000010000000000000000
000000200000000003333330000000003003300000000400002013330003030000400000000000000000030000000000023000000000000000000003000100000000000000000000000000000200000000500000
000000000000000033300330000000000003000000000000000030050603300550000000000000000000310000000000000000000000000000000005500100000000030000000000000000000300000001000000
333333000033333333333300000003000001000000000000130303333030363600000000033330000000000000000030030000005030000000000000000000000303300000000000000330330000033300300000
