000000000000000000000000000000020000000011000000000000010000000000100030003000000000000003000300000000000005000000000000000300000000000001000000000000000000000000001000
000000000000000003000000000010000000303000000000000000000000000000000000000000000000000000000000000000000000300000100000000003000000000000000000130000304000000000000000
000000000030300000000000000000000000000100000303000010000000000000000300000400103000000000000001100000000000300000004110003030000000000000000000000400000000000000100004
000000000000000000000000000000102000000000000000006000000000000000000010030000000000000000000000000000100000000002000000000000010000000000001004200000000000000000000000
000000000000000000000000000000066000000000000300100000000000000000000000110000000000000000000000000000100000000030000000000000130000000000000006600000000000000000000000
000000000000000000000000000000066000030000000000100000000000401000000000000010000000000000000000000000000000000000002000000003000000000000000006000000000000000000000300
300000000000000000000000000000333000000500500100300000000530300300000000050000300400003333303303333000400000300033330310000000030003300000000333300100000030001003033030
000000000000000000000000000000000000000000000000000000000000000000000000000000010001000000000000000000050000000600000000030003000000000000000000000000003100000000000003
000000000000000000000000000000000000000000000000000000400003000000000000060000000000000000000000000000000000300000000000000000000003000030000100000000000000000000000000
000000000000000000000000041130000110000000000000000000300000000000000100000000000000000130000000000000411000000003001030300000000000100000000000011000000000030300000000
000000000002000000000020000002000000000600000100050000000000000020000000100000030000000020000000000200003000000000000000001200000000000000000000003000000000000010000000
000000000066000000000660000000000000010003030000000000000000030660000000000000006600000060000003006001000000000000000000006000000000000010006600000000000400000010000000
000000000066000000000660020066002000010000000000000000000000013060020000050000006600000060000000003601201000000000000000006600000010030000006600200036000340000000000300
333333333333000330333333333331033333000303300000003303030000000303333003313333330300003360000003003304303000100000000003333000303333302000003303003000000000000000030330
