003300000000300000000000000000300000000030000000000100000000000000000000000000000000000003000000000100300000000000000000000100003350500000001400000000300000000000000000
000000000030300000000000000100000000003030000000100005000000000000000005035300000001000000000000000000000000000005000310000000000000000003003000000000000000000010000000
000000000000000000000000000000000000001000000000000012000000301100000000000000000000000000000003300300000050000000000000000000010001000000300003000100000000055000000001
000000000000000000000000000000520100000000030000000000000000000300000000000000000000000010001000000000000136000000010000000600000100000010000000200000000105000000000000
000000000000000000000000000000000000000000000000000000003000000000020000000000005000000000000000000000030000000000000040000300000000010000000006030000000000000000000000
000000000000000000033444000030000330010003044000000003000000000000000000000004440300000000300003004440000321111040000003000033000000000000002011100000000034400000100000
000000000000000000000000000000000000000000000000000000333000003033333000000000000000000000050000030000000303333300100000000000000000000010030303333303330000000000000333
000000000000000000000000000000000100000030000002000000000000000000003300000000033000100300000000000000010000000000000000000030000000000000000000000000003000301000033500
000000000000000000000000000001000000000000000001000000000000000000000000000000003000000000100000000000000000303000000000003030000000000500000000000003303000000000000000
000000000003311000000000000000004600000000000033100010000000000000000000030000000000000003000502000000000000000010606020000000000100000000000000000000000000033000000000
000000000000000000000000000000000000000000000000000001000000000004000000100100000000000000000500010000000000000000001000000100000000000000000030000000000000000001000000
000000000000000000000000000000000000300010000000004000100004000000000000000000000000000000001000030002000000000000000000000000000005000000000000000000000000000000000000
221110000000000000000000000020611000000300000000000000000000003000001022010000000002000000000000003000000000000000000060000000000005121611000060033030000000300000000000
333333330000033333330000033333030303033330300000301000010000000030033333303030003000000000000003333303030001000003033000000000000030300333030000000000000030000034000000
