000000000003000000000000000010003000000000000030000000000000330000010000000010003000000003000000001000000000000000000003001000010010000000300000000000000030000000000300
100000000000000000000101031000003010000000101000000000000100000000031010000020000030000000300000000000000030010000000000000000000000310101100000100000000000030000000000
000111111111111111111111111111110100000000111111100100400011111011111100000000000210000000000000000011111131011100000000000000111101010113010000000000400110101110101010
000000000000000000000000000000000000010003000000000300000000000000000030000000300000000001002000000000000030000000000000000000000000000000310030000000000300000000001000
000000000000000000000000000000000000000000000000000000000500000000000000001006610000000000066010060000000000000000000000000000000030000000000006000000000000000000030000
000000000000000000000000000000000000400030000000000000000000130003001000010006600000010030066000030000000000000000000001310000000000100000000000000010600000000000000000
000000000000000000000000000000000003033330000000030330300000005000003000000330330303001033033013000000600001000034030000003330000000000000003333060033333000100000000000
000000000000000000000000000000030000600000000000000004000000003000000000000005000010000000000000000000000000000000000300000300000000000000000002000000000000000000000000
000000000000000000000000000000000000000000100000000000000000000000000000000001000000100000010103101000000000003000000000003010000000010000000000000101001010000000000000
000000000000000000000000001000000300111111300111120000000000000111301110000000000111000000431103100000111200000000000001111011000000000010000000300110040100011110000010
000000300000000030000020000002000001300000003000020000000000003000100000000000000000000000300000000000000000000101000030000000020000000003000000000000000000000000200000
000000000000000000000660000066000000000010000000000020000000000010000000000000000000001001000000000000000000000000000010000035600000000000000000000000000000000006600000
000000000000000000000660000066000030000000000000000001000300000000000000000000000000000000000000100000000000000000000000000001060000000033000000000000000000000006600000
333333000033333333333333333330360000000000040000000033003303000000000033333300000000030303000000000040001333633033331360000000333333300003000000333000000000000003363330
