300000000000000000000000000000500000000000000000000000000000000000060000000000000000300000010003000000000000000000005000300000000000000000000000000000000030003040000000
000000000000000000000000000000001000000000000000000000000000000000010000000000000010000000000000000000000000000000000000000000000000000100000000000000000000060000300000
000000000000000000000000000001000003000000000000000101000000000001001000010000000000000000003000000000000010000001300000004400000000000030000000000000000000000010000000
000000000000000000000000000000001000000000000000000000000000000000000000000000000100000000000000000000000000000000000000000600000000000000000000210000000000000000000000
000000000055550000000005555500055050000000005505530010010005050000100600000000000000000000010303030305315000000000000000300000300000000050050000000000000000330530335545
000030000033330000003330333300030030000000030303300000010003053000000000003000000000000030000000011003533000000000003000000000000000050030330000003000000000000013304300
000000000000000550000000000030030003300000000000000000030130000055000003000003300003000000033000000000000330000301000030333333000000300000000550000000000530000000000000
300030000000000330000000000030003000000000033000000000000000000000000130003000333000300030001301000055000101010030010003500300030000000000000333000300000000000100010000
000000000000000000000000000000000010003500000000000000000000000000000000000010000000000000000000030000000000000000030000330000000000000000000000000000000000000000105001
000000000000000004400000000000000000000060000440000003101010000000000000000000004110000000000004000000000000000000000000000050000000000000000004400003000000030000000000
000000000000000000000000000000000300200000000000000000000000000000000000300020000003000500000000000000000000406000300000000006000000000000600003000000010000060001000000
003330330000000000000000000000303030000000000000000000003000000005550510333000000500035555500010000000000000000000000000003300000000400555500060000000001000000403001305
000000000000000000000000000000000000000000003000205000130000000030333300000000000000310330300000000100000000000000303000000000000000303033330002000010030000000000000303
333000000000030333333330000303100000000000053333300500000000003000000003300000033203000000003303300000003005000000000010200000055000000000000333303000000030000000000000
