000000000000000000000000000000000000000000000000000000000000000030000000001000000003010000003000000000000000330000000000000030010000000000000000000000000000100000000000
000000000000000000000000000000000003100000000000000301100040000000000000000000000000000000000000000000000330000000000000000000000000000000000000000005000000500000000000
000000000000000000000000000000000000000004000000000000000000000050000000000000004004000040000000000000300000000000000000000000000000000000000000000000006000000040000000
000000000000000000000000000000000000000000000000000000030000000000000003020000000000066000000000000000300000000000000000002030000000000000030000003000000000000000302000
000000000000000000000000000000000000003000000000000000000000000000000000660001000030066000000000000000001000300000000000006000000000000000000400000000000000001000066000
000000000000000000000000000000500220000000000000000000000000100010000004060200000000066000000000000000000004000000000000060060600000000000000000032000000000000100060020
000000000000000000000000000030333330030333000000100000000000000300000033303313030330303333300004000000000000000000030001063313000000000310333303333000000000300333003030
000000000000000000000000000000000000000000000000000000002000000000001000000000000000000501000000000000100000000000000000100000000000000000000000011000000000000000000000
000000000000000000000000000000000000000000000001000040000000000000000000000000000000000000300300000000000000000000000000000000000000000000000000002000000000030000000000
002044000000000000000000000400000010000000000000000234430000500000000000000000020400000003400000003300000000030010050000000000000000000004410060000102044000000000000000
066000000000000002000000000000030000002300000000000600000000000000001000000000600000000000000300000050000000000300000000000000500000006000000000000006000000000000000001
066000000000000066000000000000005100006000000000006600000000000000010000200000600000000000430000000066000000300000000000000000000300006000100000000066000000000000000000
066000000000220066020000000000000000036020100000006600000000000000031000000020660000000200000010220066020100000000310230000000000000006000300000000066000060300000000000
333333333333333333333003033301000003333333000000003333030000000333333300000010333001000003033003333033333001600033305300000000500000033303330000000333300000000000000000
