000000000000000000000000000000000000000030000004300001003000000000000000000000010000000303000000000000000000000000000000000500000000000100000003000000100000600000000000
000000000000000000000000000000000000000000000550303000000000000000001000000000066000001101200100000000010003000000000000000000000000000200000000000030000000000000002100
000000000000000000000000000000000000030000001011000000000000000000000000000000066000353110300011100000000000000000000000000000000001000000000010010000000300000000111100
000000000000000000000000000000100000000100000000003300100000000000000000030000060000000000000000100600000000030000100000000050000000000000000000000000000000000000000000
000000000000000000000000000000000000000000000000000000000000000100000000001000006000000000000001000000000000000000001000100000000000000000000000000000000000005000000000
000000000000001010000000000000300000000010020500000020000020000000205000000000060000000000000000001010000000200000500000000000000200000000000000000000001001000000000000
000000000000000000000000200530020050000000033300303033000002005303330300000003332330303033033333000000000333310301020050000000033330000000003030303000200500000003333504
000000000000000000000006600000000030000000000010010660000000100000000000000303000005000001010000006066000000000000000300066000000000000000000066000011000000000030000000
000550000000000002000006600001000030000004031200000660000005503000200000000000000000000000000000100066000000000000005000000000000000000020000066000000300300035000030000
000111000000000111100006600000000010000000001100000660003003110011010000000000000000005000000000100060003000000060011100010000000011011111000066010030001000000100000033
000000000000000000000006600000000000000000000000001660000000000000000030030300000000040000000000000066000000000033000000066000000000000000000066000000000000000110000400
000000000000000000000006600010000020000100000000000630000000000000000000000000000006100000040000000006000100000000000000036000000000600000000066000000000000000030010000
020000000020000000000006600000000000000000000003000660000200000000600000000000000000000000000000000316000000000002100000010000101000000000000061000100000005300000000000
333333333333033333333333333300000000000030336333333333133333330303330300000000000000000200500100013000330000000003313330333033000000030030333333033100003033330330000000
