000000000000000000000000000000001000000000000001000000000000000000000000000000010000050000300000000000000000000000000000000000000000000000001000000010000101000000000010
000000000000000000000000000050500000000000000000000030000000000000000600500303500000000100050055000000300001000050055000000000000000155100105001600000100000000000000000
000000000000000000000000000000030002100050000010053300000300000000100001000000000000000000003000000030000000000000000000000000033300000010000000000000000000000000333000
000000000000000000000000000000000300000030000000000000000000003000000000030003000000000000000000000010000000000000000000000005000003000300010020003030000000000000000000
000000000000000000000000000000000000000000000000000300000003030000000000000000000000010000000000000000000000000001000000000000000010300000000000000000000001000030000003
000000000000000000000000000000030000000000000000000000000000200030000000010000000000000001000000000000200001000000000030000000000003300000300000000000000000000000000530
000000000000000000000000000033333360040300000000003333333303303020000033033330000000000105064000013333333000000033300330300000030003330303333303330000000030003003300033
000000000000000000000000000000000000000000000000500000000000000000100000005000000000000000000000000000000000000000000000000000000000000000000000300000030000000600000100
555000000000005055500000000000000005055500000030000030000000000000000050550000000010000000005500000000000000000000000000000000000000000005000100060001000050551000000000
000000003300000000000033300000030010000000000000000000003330000000000000000000000000000100030020000030000000010000001000031000003000000000000003000006000000000000330101
000000000000000000000000000002000000610000030000000000030000000001000000000000003000000000000000000000000000000060000000000000000100000000000000000000001000000001000000
000000000000000000000000000300000010000000001000000100000000003000006000000000000000000000000000000001000000000040000000000000000000030003000000003000000000000000000000
000000000002000000000000003330000100060000000000000000000010033000001010000000030000000000000000000000533000000000000000000200000000000000000000000000000000000000000200
333333333333333330033330003333000333330003000000000000003330003000000033300330000003000000003300333300030000300000000000330333000000000000000101000000000003000333330030
