000000000000000000000000000000000000030000000000000000010100000000000000000000500000000200000000000300000000000000103000000000000000000000000000010003000000000600000000
000000000000000000000000000400300000000304000000000000100015103000000000031003000000000000000000000000000000000000000000030004000000000000003000000000000000100010000000
000000000000000000000000000000300040000001000000000000030000000000000001060000000000003000000003000000000010000000000000003003000010000000050000000000000100000030000000
000000000000000000000000000000000000300000000005000000000000003000000000000000000000000000300000000001500002300500003000000000000000000000000000000002000000000000000000
555000000000000000000000000000000000000000003300000100000000000000000000000000000000006000000500000000300066303000663003005000000010100060000000000006030000000000000000
000000000000000000000000000000060000000000000000001000020000000000000000050000000000006600200000000100100366020006602000000000000002000030020000100060020100000000000022
000000000000000000000000005000000000000050303333633333330000001333336300000503330303301333300100000000050330330333333000000050533306000030103303330300033300000000033333
000000000000000000000000000000000000000000000000300010000010000000000001000000000000000000430000000003000000000000000000010000200000000004000000010016000000100000000000
000000000000000000000000000000030000000100000000000000000000000005100001000000000000000000000300003000003000000000000000000000000000000000002000000003010000003000000000
000000000000000000000000000000000000000000100000600010000000000000000000000013003406000030000000000003003000000000000000000000030000000000030001000000000001000010302000
002000000000000000000000000000200000100000010000000000000000000002000000000000003000300000000000030000000002000000030000000000000003000010000000000000000000000000300000
066000000000000000000006600001000005050000000600000010000006501006000000520000010000100000000000000000000000000000000000000000550000000000001000000000000000000005550000
066020000000000000022006600206632000000000006603200000000066002060620100000000000000000002200000503000000000000000000010000000000000040002000000010016600000040000000000
333333333333333333333303333303330330000000303313103000003033303303330300000000000000333533000300003333313000000000000003033330000000000000000000050303303301000500000000
