000000000000000000000000000000000001010000000001000000000000000000000100000030000000000050060015000300000100010000000100000001000000000000000000060000000010000000000001
000000000000000000000000000000000000000010000000000000000000000003000000000000000400000000000000000000006010000000000000000000006000030003000000000300000010000000000000
000000000000000000000000000000000000000000000000000000000000001000000000300030100000000000000000100000000000000000600060000000000000000000000000001000000000060000000000
000000000000000000000000000000000000000000000000003000000000000000000000020000000000000000000000040000000000000000000000002010000000000000000000000003000000000000300000
000000000000000000000000000000000000030000006600010000000000100000000000060000000000000000505000000000000000000000000000066000000000000000000300000000000000000000000000
000001111011111000000000000000000001001011006000010002120100000000202000000000000010000000100000000010000010100100010003006100000001000300000000001000001100000000302250
000000000000000000000000000000000000000000333033333333030033330033330303033330000000500000000331330000000000000000000003033330300000003313330000000000003003330330360333
000000000000000000000000000000000000000000000000000000000000000000030000000000000000000000000000000300000000000000000000000000300000000000000000000001000000000000000030
000000000000000000000000000000000000060000000100000000000500000000000001000300003100000003000000000000000000000000000000000000200000000000103000001101000000000000000000
000000000000000000000000000006000000100500000000000000000000000000000000010000601100001000000000000000000000000000000000000003000400000003000000000001000060000000000000
000000000000000000000000200000000030000000000000000000000003000000010000003000000000000001000000000010000000000000000000000000000000000001000002000066000000000000000000
000000000000000000000006600000000000100000050000000000000000000000000000000000000000100000000000000000000106300000030003000000000000000000000066000000000000000000000000
000222200000000000000006600000030000000003000300000010130300000110111100000001003600000300000000000005032006601011011110030000100000000604020066000110011100000001000000
333333333333330333333333333300000000331033003333300000000030330000000000000000030000003333300002003333303333333300000203330333300000033033313033303000001003000300010000
