000000000000300000000000000000000000000000000000000000500000000000005000000100000000000000000000300000006001000000010000000000000010000000000000000000010000000000000000
000000000000000000000000000000000000600000000000100000000000300000010005000000050000000000000000005500000000006000000000000000000000505000001000005000500055000000000000
300000000000000000000000000031000000000000005000011111100100000011011000000500000000003000000000030000000000030000000001000000000000000000000000010000000400300000000000
000000000000000000000000000000000013000000000000000000000000000000000000000000000000120000000000000000000000030000000000000010000000000000000200010010000000000050000000
000000000000000000000000000030600000000000000000300010000000000000000000000030000000100001000000000000000000000000001000000000000000000000040000000000000000000000000030
000004414111000000000000000000010440000000000000000000001411100000000322000000000000000000014011003000003000000003001010030044001000000000010000000000000022050000000044
000000000000000000000000000000000003330030000003000033330000010100333033330330000030333333300000003330305000000053303330000000333333033133333330310030003303333300000000
000000000000500000000000000000000000000000000050000000303000000003000500000000400000000005000000000000000000000300000000000000000000000650500000040000003000000000000000
000000000000000000005550000000000050000030550000005000010000005000000001003030000000000000000000000000000000001000000000000000000300010000000000000000000000000000300000
000000411111100000000000000050300000000000005000000000000000000010501000000040000000011011000000043000000000003000000000000000400000031111101011100000000000000000000000
000000000000000200000000000000000000000000010000000000000200003000130000000030000000000000003000100000000000000200000000000000000000000000000000060000000000000000000000
000000000000000000000000000000000001000000000000000000030003000000000000000020000000003005400000030000000000000000000000000020000000000300000000000000000000000003000000
000000000000000000000220000050000000000000220000010111000000055006000000000000000104000000400000000001044000000010110000000000000000001000000000000001011100000000000000
333333300033333333333333333333330030000000333033300000003333303000000031000330001000000033303303300000001000000000000000000000000013000033330003603000000001000000000000
