000000000000000000000000000000000000000000000000000000000000000000000000000000000000000000000000000000300000013000000110000000000020000000003100000000000000000000000000
000000000000000000000000000000000003000000000030000400000000000000000000000000000000000000000000000000000000000000000000000005020300000000001000000021000000000020000000
000000003000000000000000000000002000000000100000000001000000000000000200000000000000000000003000006640000000000000000001000000660000000000000000000060000001300600000000
000000000000000000000000000000066000000000000000000000000000000000000000000000200000000000000000306600000000000000000000200000600001000000000000000060000000000000006600
000000000000000000000000000000066000000000000000000000000000000000000003000006300003000000000000006010600000000011000006300000660003000000000000000660000000300000006000
000000000000000000000000000020060000000100000000000010000000020000000000000006600000000000500000006600000000000000000006600000660000000002200001000060000000000002006600
000000000000000000000000000033333331050000600000000000000333303000040000300603333631000000000060003333300000000000000003033304333330033303330000000333330000000033333330
000000000000000000000000000000030000000000000000000000000000000000000000000000000000000006000000001000000000000000005000000000000000000000000000000000000000000030300000
000000000000000000000020000000001000203000010000000005000000000000000000000000000000010000000000000000000300000000000000000000000000000001000300006000000000000000100000
000000000002000000000660000000000001600100000510300000000000000000000003000000000200110000000000000000000030020000000000000000003000000002300000000100000050000000300000
000000000066000200000660000000000006300000000000002000000000600600000000000000006031000000000000000230000000664030000000010100000000000066000200000000000002000000000000
000000000066006600000660000000000006600000000000060001010000000666000000001100006600000000000060006600000000660000000000003300001100000356005300000000000000000000005000
000022020066006600000660000005060106600000100020066010000000000602000000000000006600000000000001206600000200600000000000000000003000100066006100000600022000000000000100
333333333333333333330333330000000003333300333333333333300000000303330000030010330033000000033333233333300333330300000000000000000000033303333333330035333000000000000000
