000000000000000000000000003000030000005030000000110000300000000000000000000000000100000000000000000000000000000060000003600000000000000000000000000010000100000000000000
000000000000000000000000000000060000000060000000100000000000000000000000000000000000000000000000030000000000000000030000000000000000000000000000000000000000000100000000
000000000000000000000000000000000300000000100000000000000000000000000000000000000000000100000000000000000300000000030000000000303000000000000060000000000000000000000100
000000000000000000000000000000000300000000000005000000003000100000003300010000000000000000000000000000000000000000000000300000000010000000010000000000050000000000011000
000000000000000000000000000000000030030000000000000000000000000011000004000000000100100000000000010010000000000000000000000002300300000000010010003000001000000000000000
000100000000000000000000000032020020001040005000000202000000000300000002202000202002003200201002000000000000000000020320000200022000000000000000003000300010010000020000
000000000000000000000000000033333330000000300000003113330500010003000043001333333303030333033033333333013000000034303033333003303303330330330120000333330300300000303303
000000000000000000000000000000000000000030006000060000000000000000000000000000000000200003000000006000000000000100000000000000100000000000000000000000000000000000000030
000000000000000000000000000000010000000300000000000000030000000001000000000000000000000000000000000020000000000000000001000000000000000000000000000050000000000000000000
000000000000000000000000000000003000000000000000000000000000000000300000000000000000000000000000000050003000000000000000000000000000051000000000000000000000000001000000
000000000000000000000000000000000003000000003000000000130000000100000000000000100000000000000310000000000000000300000000000000000100000000000000030000000000000000000000
000000000000000000000000000000100000000000000003000000501500000000000000000000000000000000040000000000001000500000000000000000000000000000000000000000000000000000300000
000220000000000202002022020000000000601000000220000000000000000000000000022000600500000000000010005000201000000000010000400000000000000000304000000020200200000000100000
333333333333333333333333333300000001000010333330333333330000000333333003303030000000000200000000003003333000000000000000000000000000030000000333333333003300000000000000
