000000000000000000000000000000100000000000000003000000000030001000000000000000000000100010003000010000000030000300000000030000004000000003000000600000000100000000000000
000000000000000000003000000003000000000000000000003000000000003000000000000000000000000100003033300000000030000100000060333300010000000030000000000000000003033303000063
000002000000000005550000000001005000000300300000001000000000400000001000000000001000003300000000000000000000150000005500006300000300000300000030000010002000000000005500
000066000000000003300000000033300010000000000000003000000003300000066000000000000000000000000000000000000333000000033000000330000000000000010000000000066000000000000300
000066050000000000000333330030060003330300000006000000000000000001066050100000000000000000000000003333300300301030300000000000033330053000000000660003066000000000000000
000033033000000000500000000000000000101000000066600000000000500000033033000000000000000000000000000000000000010000005000000030000010033000000000666005030000000000000500
050000000000000000000000000000000030000000333300300000130000000050000000400003303300303330000301130000100000000310000003033003300000000000003033303020000000336030001000
030000000000000000000000000000000000004000000500000000000300000060103000100000000000000030000001000000001000030000000000300000300000000000000000000000000000000000001000
030000000000000333330000000010006030000000000500000000010000000000036003330301000000000000000000330000000000420000000100306000000010000000000000006300000000600000001000
000050000330000000000000000000000500000020003000000000000000000000000304000000001000000000400055500000121000000300030000001000000000030000200000500030000000001000060000
333000000000000000000000000000033000000660000001000000003030000000000000000000000000000300000033000000600000010000000000330000000000000006603310000500000040000000000000
300000000000000000000000066000100010000660000000000030103000000000066000000000033300000066010100000030600500000000100000000000000000000306003000000500000033333100000000
000000000000000000000000066600000000000330100003030000100600010000066600000030000000000066600005000000330300100000000000000000013066000003300000000330000000000000000000
000033333333000033333333333300000040500000333330000000003000333333303000303300000000133303000000000500000000040033333000001303030333000000000000333000001000000020330300
