000000000000000000000000000004000000000010000300000000000000000000000000000000000300000000060001000001000000000000000000000000000000110000000000000003000300000000000000
000000000000000000000000000300000000000000000300000000000000000000000000000000000006163000000000000000000500000000000000000000000000000000000300100000000000000000000030
000000000000000000000000000000000003056000000000000000000004000100600000000300000000000000010000000000000000010000066000300000000000400000000006600000200400300000060000
000000000000000000000000000000000000066000000000000000000003300106000000000000600100000000000000000000000000000101060000000000060300000000000046600000010000000000060000
000000000000000000000000000000000000005000000010000000300000000006600000000000000000000000030001000001010000010003036000000010000000000010000006000000000000000050066000
000000000000000000000000000000003000066500000000000004000000000056610002030000000130000000001000010000050000000000066000000300000000000053030006100000000030000000066000
000000000000000000000000000000000003323333000000000100000000000333330300000000001000000100600000003133333000000030333330000000033033300000003333133033333300000003333303
000000000000000000000000000000000000000000000000000000000000010050000000030000000000060000000000000000000000000000000000000000000000000000100000000000000000000000000000
000020000000000000000000000000000000000000000000000050000300200000010000000000000000000000000300000000201000000000000000000003000000000000306000010500000000000300000050
000660000000000066000000000400000000000000000000000060313006600000000400100000001000000100000000040000600000000000000000000000000100003660005000100000000000000000000000
000660000000000066000000000000000000000000000000010066000006100000000000000000000000006500000000000000600000000010020100000060001000000660000000000000000003000000000000
000660000000000066000000000000000000005000000000100000000006600100001000000000000000006600000000300006000000004000000000000600000000000000000000000106000003010000000000
000660000000000066000002000000200000000000000000365006000006600001300000000000000000006000100000000060600000000100001000000000000000000660001000000000000000000000000000
333333333333333333333333333330333330000000333363330033333330330333330330333330000100113330003301363313033001000000101000000000303313133303310000000000000000000003103003
