000000000000000000000000000000000000000000000000000000000001000000000000000000103030000000000000000000000000000360001000000000000500000010011000000005000000300001030000
000000000000000000000000000000010000300000013000000000000003000005300000000003003000000004000000000000000000400005000000000000333300000000000000000000000033030000000000
000000000000000000000000000030000030000010300000002000000330000000001000300000333001000000004000300000000000000000000000001000333305000000000000000006000003030500000000
000000000000000000000000000000000330000001101000000000000000000500000050000003300330000000000000000000000000000000000000030100333330100000000000500000000030333000320000
000000000000000000000000000000003000000010000001000020000000005000540030000003031330000100000600006000000000000000010000000000000333004000000000000000000030333300350000
000000000000000000000000300000003330000600000000000000020002502300000010030001033300000220130000006600000000000000000000002002000303000001000000000301220200333300000001
000000000000000000000003300033033330000000000000033333033303333000000000330003003330333300300000003313303000000000000003333300333033300000000000000033003333333330000000
000000000000000000000003300003000000000000003500000000000000000000000000000000000000000000000000300033030030400010000000000000000000000000006304000000000000000000000100
000000000000000000003333300000000000000000333300000300000010000000000000503030040300000000301000503303000000300000030030000000000000000003000000000000000300050000000000
000000000000000000003333305000010000000000333305000000010000000000000010000030000001000000300000003033050000000300000000000300000030000000000400000000000300000136100000
020000000000000000033333333000000000000000303333012000003000030000000011000330200000000003300000000133330000000000000300000000060000003003000200000300003300000000000000
660000000000000000333303333000000000000030300333066010000000000000600003003036600000303030300000006033030000000000003331000000003000061030021600000000330000000000000000
660000000022020003333303333000030000000002003330056000300000000000000000033336600000000333000030003133330000000000003330003000000400006010006030000000330300010001003006
333333333333333333333333333300330000000000130335333033330000003000000033303313330133333333311303000333333000301030333330033000000000133330333333303333333000000000033000
