000000000000000000000000003300000000000000000002000000000000000060000000000000010000000006300000000000000000000000001001000000000000000000002012000000000000010000000033
000000000000100000000000000000000000000000000000000100000000010001000000000000000000000000000000000000010000300000000000000300000000000000100000010001000000000000000000
000000000000000000000000000033000030000000323303000000000000000000000033000003333030300000133000000000000000000100005030000000010000000000000333033330000000000000000000
000000000000000000000000000000200000003000000300000000000000001000000000000000500005000000000000000000003200000006000000000000003000000000000000000000000030000000000000
000000000500000002000000000000000000002000000005000000303010000000210000000100000030000000000000006050000000000000000030000000000000000000000000000000000000003000000100
300050003333500000002000000300000100000002000300030300000433350003000000000000000200000000300500030000350300000030330000000300160000003333500050000000000001000000000000
000000000000000000033333300003003000300033000000000000010000000000003300003000000000333300000000000000000000000000000000300000000000000000000000000000006000000003303000
000000000000000000000000000000000000000030000000010000000300030000500300000000000003000003001000000000000000005000000000100000000000000000330000000000030000000000600000
000000000000000000000000000000000000000000000000006000100000000100000000000000000000000010000000000000000010001000000000010000003000000000000000000000000030001010000010
000000333330333300000000000000000000000000000000000000000016000000000000000030000000000000000000000000110333003000001300000000333303300300100003004000000301000035000010
000000000000000000000000000000000300000000000041000030006000000000100200030010010000000003000030000000000000000003000000000000000003000000000000000000033003000000030002
000000000000000000000000000000001000000000000000003500000000100000000020000000000000000100000020000300030000000000000000000010000000000000000000000000200000001000050000
303300000000000000000000000030002000000000000000030333300000103000000600030003000500303300000030020500000000000000000000000002000030000001033000000000000210330000331300
000000000000000000000000000000000000333000000000000000003303000000000000301000000000000000000000330500000000003000000000003633000000032030010003000010003300000000000020
