000000000000000000000000000000000000000000000000000000000030000000500000000000300000000000003000000000000000000000000003000000000000000000000000006000010000000000000030
000000000000000000000000000000000000000040000000000000003000002000000000001000000000000000000000000100000000000000000000500030010000000000000000010000000000000000000000
000000000000000000000000000003030000000010000000000000000060003003100000030000000060033300050005000000000330000003000003300000000300000100000000000000310000100000000030
000000000000000000000000000010000003300100010000100000000000000000000300003000000000000005000000000000000331000000000020300010300000000100030000000000000000000034000000
000000000000000000000000000000005003300040000030000000000000130000000000000000000066000000000000000000000130000000000660200000000000000000000000000030003003003300000000
000000000100000011000000000000033000300000001100000000300030010030000000000000000066000330000030000010000030003300000603300000001100000100000030000001000000333300001000
000000000000000000000000000033300333330330100000000000300013330000000000000001333330333533300000100000000330333330133303363333000000300000000000005000000130333000001000
000000000000000000000000000000000000000300001000000200000000603063000010000000000000000000001000000000000000000001000060000010000000000000000000000012000030000000100000
000000000000000000000000000000000000000000000300000000000000000006000000010000000010000001000000000000000500000000000000000000003000000000000050000300100000000000000000
033300000100003300000000000000600000000000003000000000003300000000000000060000331000000000000000000000000301000000100000000000033300001000000000000310000003310000000001
000000000000003300000000000200000001000000000333000000020100000000000000000010000000000000203030000010003000000000300000000005300000000000000000000000003000000000000000
000050000003303300000000006600000000000000030000000000603300000030003000000000000500000036600000000000000003033000003300000000000650030000000000066330000000000000000001
000330000333303300000000006602000003010000003033000030060300000000100000000030313300000006600110000000000103033000333300000000000330000000300000060300000000030030000000
333333333333303333333333333300000000000005003333033333033330033000000000000000033330333333000000000000040333330000030000000000333332300600000033333033303333330330010001
