000000000000000000000000000000000000000000000060000001000000000000000000010000000000000000010600000000500000000000000000000000000000030000000000000006000000000000000000
000000000000000000000000000010000000000000000000003000000000100000003000400033000000000000000000000000000000000060001002000000100000000000000000000000100000000000000000
000000000000000000000000000000000001110000000000100000000000000300000000001110000105000000010100000000000000000001000000001101000001000000010001111000000003000000000000
000000000000000000000000000000020000000000010000000000000000000000000000000000000000000000000000030001000000000000100000000050000000000000006000000000500160000020000000
000000000000000000000000000000360030030000060000000000030003000000000000010030000000000200000000000000000000000030000000000000000000000000010001000006300300000000000000
000011114011001000000000000000610060000000000010100000000000001141110002100000000160140110340000300000611100000000000000250300140010000000000200000006600100000001000000
000000000000000000000000000033033303300333000000003000000000050000000033053330000000000002005100310000000030003033333333333303000000000000033003300000333350333330000000
000000000000000000000000000000000000010000001100030010000000000000000000000000000005000000000000000000060000300000000000000000000000000000000000000000000000000000000000
000000000000000000000100000000600000000000000000000000001000000000000000000003000000000000000006000000000160000010104000001000000000000300000000000000000000000000000000
000111111100000200000000000000000000000000003030000010110100000101000002000000000000000000002000000001100060000000000000200000000000000100000000000101000000000010000000
000000000000006600002000200000001000030000060000200000300000000000000060000020003010000000066001005200000003200000021006603132000000000000010000000000300000000000003000
000000000000000600000006600300000000000500060000100000000000000100000001000000006003000000006000000000000000600300600000600000000061000040000001000000100001000000000300
020000000000000000000006600600000001001100000003002000301300001300000000000000006000005000000000000200100006000600600060000000000000310000000000111100000000000001401100
333333333333333333333333333300000000000000333303331333330000000303313303033333303333000003033010003033333133333000300030333330000000000000000000001330333300000000000000
