000030000000000000000000000000000000000000000000000003303000300000600000000000000000000000000000053000000000000000000000000000000000000100000001100000000000000000003601
000000000000000000000000000030000000040000000000030000000000000000001000000000005503300000000000010000000000000010000000000500000000000000000000000000300000000000005500
000000000000000000000000000000000000000000000000000100003003030000000000000000200000000000001600000000000000000010000000200000000000000000000000000000000000000000200000
000000000000000000000000000000000010000000000010004000000000003100000000000000600100000000030000000000010000000000000006600100000000000000000003000001001000000000600000
000000000000033000000000000000000000300003000003000000030000000310000000003401601000003000036060000500000300000030010000600000000000000000000000000300000000000046600000
000000000000000000000000003300000500000010000003350000000010000000000000000106600000000002300000000000200000000000003016600000000000600000000000000000000001100006600000
000333000000000000000000000033000000000000000000000003300003330000000030003333303333000000000000003330030300033300100003133333000000030000000003330000000030003330333033
000000000000000000000000000000000000100000010000000000000000000000000000500002000000030100050000000003002000000000000000000000050500000000000000000000001000000000000000
000000000000000000000000550000050000000000000000000000000006013000000061100100000000000005000006000000000000040000000000000000000000000000000000000000000003000000000000
000000000000000000000020000002000000300000000000000000000030000303000000030000000000000000002300000000003000000000050000000000000000000000001000006000000000000000000000
000000000000000000000660000066200000000000000000000003000000000000000000300000000000000011066000000000000000000000000000000000000100003000000000000000000000060000000000
000000000000000000000660000066000000100000000000000000000000001000000000000001000000000006160010000030003000000300000000000000000000000013000000000000000300000000000003
000000000000000000200660000066001000000200000000000000000000033000000000000000000200000100316000000000000000010000000000000600300003300005000000200000000000000330000000
330000030003333333333333333333333330330030300033300000100000000000000433000000333333030000033300330000000010333003000000103331000000033330333300030000000000000000000000
