000000000000000000000000000000000000010000003000000000000000000000000010000000000300000000001000000000000000000000005000000004000000000010500300000003000000001000000000
000000000000000000000000000000000000000000000000000000000000000000000000000030600003000000000000015000000000000000000100000000000000000000000000000000100000000000000050
000000000000000000000000000066100000000000000120000000300000200000000000000050000001000000000002000000003100300000000000000000000010066010006600000000000000000000030000
000000000000000000000000000000006000000030003660000000000006600000000000000100003000000000003066000000000001000000000000000000001030060001006000000060000000000000020000
000000000000000000000000000060000400000000010360000011000300600000000000006000300000000000000533000100100000000000000000000003000000060000003600000001000000000000001000
000000000000000000000444000066000000000000020660200202230200602444000000000000000003032022022066024040000000000000000000000000000000066000000600000000100000311200030000
000000000000000000000000000003333000000000333333333333333301333000000000300000550000333033303300300000000300300000000003000000010300031303003033003000000033033330030000
000000000000000000000000000000000000000001310000000000000002000000000000000000000000000000000000000000000000000000000030000000000032000000000000000000000000000000000305
000000000000000000000000000000000000000000100000000000000000000500000005000050000000000000000003030200000000000000000000000000000000000000300000010000000100000000000000
000000000002006600000000000000000000000030000000000030000000000000000000100006600000660000000300000000000000001000000040000200000000060000010000300000000000000000002000
000000000066006600000000000000000005000000000000000010000000000000000000000003600000560000000000000000000000000000000000000600000001000000000000000000000000000000006600
000000000066006600000000000000000300000000000000010000000000000000000000000006600000000000000000000005006000050000060000000600000003005000030000000000000000000001006600
002022022066026600000000000000060004440030000030010000000000010000000000200006603000662000101000000000000000000000203002200600000000001000004440000000000000103000006602
333333333333333333300003000000000000000000000000000300000000000000030003333333033300033330000000100000000000000003133333330303000000000300000000000000000100001003330033
