000000000000000000000000000010000000000000000000000063500000001000000101000000000000000000000000300300000000300000000000010000000000000000000000000000000000000000005000
000000000000000000000000000000000000000000000000000000000000000000100000000000005000000003000000010000000000000000000000000000000000100500000000000000000000000000000000
000000000000000000000000000060010500000000000000000000000003000000000003000000000000000000000000000000000000000000000010003000000300000330100000010100000000000300000030
000000000000000000000000000000000600000000000000000000000000000000000000000000000000100000000000000000000000000000000000000003000000000000300003000000010030000000000002
000000000000000000000000000000000300000010000000000000000100000000000000030000000010000000000006060000000000000000000000000000000005000016300000000010000050000000100000
000000000000000000000000000000000330000000000000020022002000202000000000000605000000001000000020020000020000000000000000600000500030000000330100000000000000003000000000
000000000000000000000000000033036330000000000000033331033003333003000001010001000100000000033333330000000000000033133000000000000000030003330000000000000000000100000000
000000000000000000000000000000500000300010000040100000000000000000000011000000050000000000010000000000000100000005000300000000000000000000000000000000000000000000000000
000000000000000000000000000000000010000030000000001000100000000000010000060000300330000000000000100000031000032000005000000000000000000000000000000000000000610000000000
000000000000000000000003305000000000005000010000300000060030000000000003001000300300003300000010000003300006000000000060000000040000000000000100000000000000332500400000
000000000000000000033000003000000000000010000003310030000003030000000000000000000003000003000000331000000000106000000000000000000000000000330000000010000300000000000030
000000000000000000033000003000000000000000000000300000000000000001000000000000000033000030000000030000000001000000000010000000010000000200330100001000003000000300000000
000000020022020000333000003300000000000000000030300000000005003000000000000000000300000000300000300000036000000020022020000000000001000163330103000000033000000332002200
333333333333333333333333333300000003013033333330300000003330333353333300000003003333013330333333330000130033300003033100030000000000033333333333333033333300433303153333
