000000000000000000000000000000000000003000001010001000000001003050000000000000000000000030000100001000000000000000000000000000000000000000000000003000000000000000000000
000000000000000000000000000000000030000000000000000000000030000004000000000303000000000000060030000500000000000000000000060000000010000000000000000000000000000000000000
000000000000000000000000000000000000000000010000000030000001100300000000000000111100010110001000010000000000000001010000000010010000100000006500000000000011111000300000
000000000000000000000000000000000000003000110000000010000000000000000000000000010000000000001000000100000000030000100000000000110000000000100000000000000000100000000000
000000000000000000000000000000000000000000010100000000000000000000010000000000120100002000001050000000000000000001011004010100000000000000000000000000000003000000000000
000000000000111000000111110000000001000000110005501000200000002130000000100005006000000000201000550000000000000050101000000000110005501110000001011010000000101000000000
002000000000000000000000000030330000000000030300300204003133303000040030030003333330333033333030330020005000000003333000033330330030301300000000000002000003343000000000
000000000000000000000000000000006000010000000000000000000000001000000000000000000000000000000050000000010000000301000013000000000000000000000000000000000000000300000000
000000000000000000000000000033000000000000000000000030000000000003100000000000000000000000000003000000060000000000000000000000000000000001000000000000000000006000000000
000111000000000100001111110000000000000110000000013111000000000010000100000000000010000000000000001010030010000000000500000000000000000000000001110010000106000000000000
000000000000001100000001000050000000005000000000000100003000000110000000030000000000001000000010000010300010000400000000060000000000000000000000000010000000000000000000
000000000000000100000010110000000000000000000000011011000000001010000000000000000000050000000000000000100010000000000000000000000000300000000000000000000000000030010000
000000200000001100055501010000000130000012011110050101000000000010005500000111110100000000000000110010000111110000040000000003000000000000116000000130005511011000000000
333333330330003333333333333006000003003330000300036331300020000030333300010010000000303300100000003033330000000000200000000000503000000000000330333333003300000003033000
