000000000000000000000000000300000000030000200000100000000000000000300003300000000100000000000000000000000060000350000500000000030000000200000000003000023000000010300000
000000000000000000000000003010000000000000000030000000000100000100000000100000100000000010000000000106000000003000000000100003000000000033300000030000000010000000000000
000000000000000000000000000000000000000030003000000000000500000000000000000000000000300000000000400000000010004000000000005000000000000000000000000000000002500003000000
000000000000000000000000000000000200000003400000000000000300000000000000000000000020000000000000000010000000000000000000006020000100000000000020001000000000000000400000
000000000000000002000000000000000030000100000000000000000030000000200000000000000000000001000100000000000000000000000000000101000220000001000000000000000003000000000000
505550000000000002000000004000000000000000515550000000000001010000200000000000000000505500000000000000500020004000000000000000001200000000000000040000000050005000000000
000000000333000000033300000030100000000003000000000333000000000010000300000003030010000000000000030000000300000000303003000300040000200000003000000000003301000000000000
000000000000000330000000000000000000000000000000003000040010000300000000000000000000200000010000000000000000000006030000000300033000100000030000000000000300000000001000
000333000000000000000000000000000000000130110033000000010003030000001010000303001100330000000000000003001000000000000000000000000000050000300000000000000001033300000000
000000000000000000000000000000001300000000000001000000000003000000000000000000000000000000000003000000000000000100000600000000000000000300000000000000000000000000000000
000000000000000000000000002000000000000000101000010000000000000000000000000100000001000060010000100000000000000000000000000400000000000011000100000000000000010000000020
000000000000000000000000000000020000000000300000000000000000000510000300003000000000000200000000000000003100000001000010000000000000000100001200005000000000000000000000
000000000000000000000000000000200003000040006000000000000000003505550000005400030000000200000000000000100100000050555000000000060000000000400500000000000000000000000000
000000000000000000000300000000000333000000000600000000000000010000000030000000030300000003330000000000100000300000000000000000000000050000000303000000000001000030000000
