000000000000000000000000000003000000000000000000000200000000102000000000000000000000000003000000000060000000000000000000000000000001000000000010000000000000000000000000
000000000000000000000000000000000000000000000000000000000000000030000000000000000000000000030000100000000000000000000000300000030300000000001011000000000000200000000000
000000000000000000000000000000000003000000000001000000030000000001110000000000000000000000002000000000000100000010001000003000000100000000000000000006000000111010000200
000000000000000000000000000000000000000000050000000000000000000000000000000000000000000000000000020020000100000000000000000002010000000000000000000000000010000000000000
000000000000000000000000000000000000000000000000000000400000001060000000000000000000000000000000000200000000000000320000000000000000000000003001000000000300000301000000
000111110000000000000000000000000001000000300000000012110001100000000030000104300000000000000300000000006030200310100000000010000000000000000006000000000000000000403000
000000000000000000000000000000003000000000000300000100000000000330333300000000000000000000033300000000100330333300000003333003000000010000000000400330313330333500000000
000000000000000000000000000000000000113000000000000000000000010000000000000010000000000300000000020600000000000003000001000100000000000000000000300010000000000000300000
002000000000000000000000000000000030000000000000300000000000000000001000000000000000002000000000000000000000000000200000000000000000000000000100000000000000000000000000
001111110100000200000000000002000000001011000000000000000200000101000000000000000000011110100000100000000000000000110111000000000000000000000000000000003010100000200300
000000000000000000002000000000000100000000000000001000010000002002300000000000000000000000000000000000000000000000000300000000000000000000000000000000100000010000003002
000000000000000000000000000300000000000000000002000000030000000000000000000030000000000000000000000003000010000300000000000000000000300000000003000000050000000000000000
000000000020000000000000000600000000000000000000000000060000000000600000005060000000000000015000000001115000300600000000000000000000200010010001111100000000020000000000
333333333333333333333333333330033333303333333333331303333003130330333033033100000000333300300060000003000303300333313033003333300030300000000000000000003030050033303033
