000000000000000000000000003000000000000000000004000000000000000030000000500000000000000001000000000000000000003000000000000003053003000000000000000000000000000000000000
300000000000000000000000000000000000030303000010001000000003303300000000310000000000633000000000003000000000000000003630000000000000033310000030000000000030000003330000
000000000000000000050000000003300000003000000010000333000000000000000000100000000000000000000000050005000000000000060000030330000000000000000033330030000000000000000600
000000000000000000000000000000000000000000000060000000000000000010000000000000000000000000030000000060000000000000000000000000000000000033000010000000000000000000000000
000000000500000000000003330000000004000000003310000000000000030000000000033000250000001000000500100000010010330000001000000000000330000000000000000000000000000000010010
333003333330000000000000000030000000000000000000000301000000000303300300012003333000000000033330003330033000000000600000000000000000003030000000000000000030000330000000
000000000000000000000000000032130333311300000000000000000000300000000000000530000000000333010000400000000000000003000303000000000000000133330000010033010100000000033333
000000000000000000000000000050000000000000000000000000000000000000000000003060000000000000000000000000000100000000000000000000003000000000000000000000200000000000000030
000000000000000003333333000033300000000506300000000000003330000000100000000010000000000300300000001000030000003000000000000000000000030000000000000000033300000000000004
033000000333300000000000000020000000000000001000100000500000000043000000313000001050000030000000110003300033000303300000000050000000000033030000030300000000005000100000
000000000000000000000000000000010030000000010000000000300000000006000000000300010000000000300000000000000000000001000000000000000300000001000000000000000000000010003300
000000000000000000000000000000000000050000000000000000500000001000000001000000000000000000100000001000000000000300000000000000005000300000000000000000001000500000033000
300000000000000000000000000000000003033000333003300010005010000300000031000000000000000000010000000000000300000020002010000000333300033303010201000000030033010000000000
333333300000000300300003333300333330400000030000000000400063300333313300000000000000030030000000000000003333033333033030010000010000000000300000000030030100000000000010
