000000000000000000000000000000303000000003001000000000000000000000000000000000000030000000000000000000000000000000000000000300000000000000000100003000000100000000100000
000000000000000000000000000000000110000000000000000000000300000000000000003300000000000000000000300000000000100000000000050000000000010000000005010000050000000000000000
000000000000000000000000000000000001000000000000000000000000000000000030020000200000000000000031002000000000000000000030000030000000000000000000000000000013000060000000
000000000000000000000000000000000000000000100000100000000001000000000000000000000000000000000033000010000000300050000000500000000030000000000000000000000000000000000000
000000000000000000000000000000060030000000000000000000001000000000000100000000000000000000000003000000000000000000000000000000610000030000000000030000330000100001600003
000000000000000000000000000000000000000002000004000000000000000000000204000000000000000000020000000000030000000003000050000000660000000000000000000000330000000066600000
000000000000000000000000000000000500333330033333100000000000000333033003330300000000030343303333500000000000000000303030001000030333300000000000000003330300000000330333
000000000000000000000000000000000500000000000020000000000000000000000000000300010004000000000005000304000000060000100000000000000001010000000060000000000001000000000000
000000000000000000000000000000000000000000040300000000000000006000000000000000000000500000000001000000000000000300000000000000000003000010000030000000000000000000000000
000000000000000003000000000000000100000006000000000301000000000060300300000001010000000000030000000030000100000000030020000000000000000000000000300000000030000000010000
000000000000000003300000000000033000003002000001000000000000000000300000000000000030002000000000000000000000000000033000000000000300000000000000000000003000000200000000
660000000000000003300000000000030000000003100000066000000010000000330066100006000001661000100000000000000000000000036000000000000006300400000000000000000003000000000000
660000000000022003300000000020030000000000000000066000000000000000300066000000000000660000100000000000000000000020010000010010010030000000000000000000000000000020000000
333333333333333333333333333303330000000000101000533333030000000333333333333330000010330333300000000010000330333331333330000000003333300000000030000333333333033330000000
