000000000000000000000000000005000000003000000000000000000000000000000100000000000000010000030000630300000000003000000000000000010000000000000100000000000000000000011000
100000000000000000000000000000000002000010000000000000000000000000000010001000200003100000000000000000000020100000000000010600000000010100000000200102000010000006000000
111111111100000000000000000001101100000000101000002100000000000051000011011116600000011110160000000000210110200000000000000000000000021011100000000050000011101110000000
000000000000000000000000000000000000001000000000003200000000000000030000000006600010000000000000000006600630410000000000300000000000000000000006600001000000006000000000
000000000000000000000000000000000000000000000000000000000000000000010000000006600000000000000066000006600660000000000030000000000000000000000056600100000000300000030000
000000000000000000000000000000310300000000000000020020000000000300000000300006600030000150000006000336600660020050020000000000000000100000000306610000200000000000000100
000000000000000000000000000000010000600000000000033013630006100000200000310003333330000000000036333033300333333333033333000000000000000000000333030333333100000000000000
000000000000000000000000000000000000000000030500100000000300003400000000050100000000000000001000003000000000000000000000000000010020103000000001000000003000000003001000
000000000000000000000020000000000000200000000000000000000000000000000053000000002000030000000000000000003000000000100000000010020000000000000000000020300000500000000000
020000000000000000200660000000000006600000500050000000000000000060000002500000300200000000000000001110010020030011100030400000600000000002000000000660000011100000000001
000000000002000006600660000000066006000000000020000050000000200011003000000000003000000000000000000000000000000000030000000200100000000066000000000600000000000000000200
000000000066000006600660000000000006600100000660000000300000010000000010000000006600000000000030000000000000013000000000006000060005000060000000000663100005000000000600
200200000066000336600660020003366006600200000660005000000000600000000020020001336100100000001000000040030200203000000000005600060021013366000010000660000000001010106000
333333300033333333330333333333333003033033006033310000006003363000000020003033330330000000000000000010010333301000000000003333133000300333300000000503330300000000003033
