003000000000000000000000003000000000000000005000000000300000000003000000000002000000000000003000300000000010003000000000030000000000000000000030000501000000000000000000
000000000000000000000000000000000000000000000000000000000000000000000011000001001000000000000000000000000000000000000000000000000300000000000000000000300000100000000000
000000000000000000000000000000006000000330003333010400000033330000000000000003030003000000000030610300333000010000003330000013000130300000000001000001010000003100033033
000000000000000000000000000000000030000000000000003000100000130000000030000000000000001000000000000000000000000000000000000000000000000000000000100030000006000000000000
000000000000033302000000000000000100001000000000000000000000000000000530020600000000000000005000000000000000300000000300000000000100000000030000000300200000000000000000
055000000000400000000000000000000000010000000130000000000100000065000000000001000000055000000000500100000003000001000000500000000000000000000500000000100010060000060000
000000000000000033330000000033333000300333040333010000200000333003001500330300000333030000000503330303303305000011100330000000000303330000003000001010333003330330033333
000000000000000000000000000000300000000000000300000020000010000000000600010000003030000000000600000000000000000000000000000020000000100000000003130000000000000000030000
000000000000000000000000000000050000000000000000000000000000001100000230000000000000000000000000200000030000000000000000030030000000000000300300030000000000030000500000
003333333300000000000000033300000001330000000010000000000000010000030000000000000000330000000020000000000000100000000000140000000000003300000000000100003000000002030000
000000000000000000000000000000000000000000000000000000000000000000000000030000000000000000000011000000300000000000000000000600000000000000000110000000000000030000000000
000000000000000000000000000000003000600000000010033020300500000030000030000060000000000000000000000000000330200000000000000000030200000000000000000000000300000000000000
000000000000000000000000000000000000000000005006000000000000000000000000000400000000000000300100400000000000000000000000000000000000000000100000000000000000000000000000
003333300003333333300033333300000001000030000000000033303013000030333300001300000000000003300000003333303003003003033300000000003003300300330050000000000033303000100333
