303030000000000000000000000065000000000000000000000000000000100000000000300003000300003000000600000000000000000010300000000000003000000000000000001000000000000000033300
100000000000000000000000000000000000000100000000000000000000000000000600000001000000100000000000000000000000000000000000000000000000000010000000000000000300000601000000
000000000000000000000000000030000300000000100000000000000000000000000000100000005000000000000000000000000000000000000000005000000000603000010000000000050000000000000003
000000000000000000000000000000000000000200000100000000000030000000000003000000000000000100000000000000000000300000500000000000100000000000003000003000000000000000030006
000000000000000000000000000000000000000600000000000000000000000010030000000000000000000000000000000000062000000000000000003000000000000000300000300000300100030003000000
000000000000000000000000000002201000006600000000000000000000000000003000000000000000000003010000000003000000000000000000020000000000000000000000000000000000230100000000
000000000000000000000000000030303300333333000100033333333033330000000033303300100000000000033333000000000002000030301333031333300000000000000000000000000003003030000000
000000000000000000000000000030000003000300000005000000000000000000000000000000000000330000000000000000000000000000303000003000100000000000000000000000000000000000100000
000000000000000000000000000000000000010600000000000000000000003000000000000001000001000000000000000000000000000010000000000000000000000010000000000000000100000300000000
000000000000000000000000000000001000000000100000000000000000050040000000010000000000000000000002000000000000000000000000000000000000001000000000000003030000000030000010
000020000000000000000000000000003030000000000050030100000030000300500000000000000200000600000000000000000000000010000000000000000000500000000000000010000000002000010000
000660000000000000000000000000000000050000100000000000000000000000000030301000006600000065050066000000000000000030000000010000000000000066000000000000003010066010000000
000660000000000000000022000000000000000000000200200000000520000000000000000100006000000000000066000020000000000000000000000000000000000066000000030000060000060330001000
333333333333333333333333333300030000300000000003033333033003333000000000030103303331000313030333000033303330300300000003033333000000033330303003330030000003033313303330
