000000000000000000000000000000330000000000000000000000100001200000000000000000000000000000000060000000000000000000000000000000003630000000000000000000000000000000000000
000000000000000000000000000030033000000000001000000100100400000000000000010000000130000000000003000000300000011000000000000000300330000030000000000000010300000000000000
000000000000000000000000000013303000200000500000000000000000000000000000000000200000000000000000060000003000000000000000000000333000000010000000000000000000000000100000
000000000000000000000000000033335006600300000000000000000000030000000000000000300030000000000000000000000010000000000330600000333330000000000005000003000000000000000000
000000000000000000000000000000303006600100000000000000000040000300030000500003600006000000300030000000333000000000000336600000033336000000000000330000000000100000000000
000000000000000000000003300003306006600000000000000000003033000060300000000006600000600000000000002000033000000020000310600000330330000000001000303006300000000000000030
000000000000000000000003330030353333333333000000030010050003300000000000000000303330000001000000003303333000000033303533333003030030000010030333030000000000000000000000
000000000000000000000003330000000001000000003004001000000000000000000006001000033300000100600000000003300000000000000000530003000000000000003100000000000050000000030010
000000000000000000000333330000000000003000000000000000000000000010000000000003333000000000000000003033300000000000500002000000000000000000000603000000000000000403333000
020000000000000000003333330000000000000000000000000001000000000100000306000003330300001000002000201003300000000000000000000000000000000300000000000020000300000003333300
660000000000000000003333330000000030300000300000000000000000000000000300003000333000000000006000003331300000000000000000500000000000000000000000001660000000000003303000
660000000000000000333333330000003330000000300000010000000000030000033300000003333300000000000000003333000000300000000000000310000000000000001000000660000000100003330300
660000000002202000333333330020003300033040003000000002200000100200033300002003303300003300006000003635300000312000333001000030000020000000000000200660000000000003333300
333333333333333333333333333331333331033330000000333330300000003333300333330103033001003330033331050333033331333016030000000000300033300000303333333330033300000003033330
