000000000000000000000000000000000000004000000000000000000000000030000000000000000000000000000000000000100000000010000000000000000000003000000000000000000000000000000000
000000000000000000000000000000600000000000000000000000000000000000000000000000000003000000000000000000000001000000000000000000000000000000000000000060000000000000000000
000000000000000000000000000000011000000000000031000103000000030000000000000000000000000010000000000000000000031000000000000000000300000030000000000000000300000000000060
000000000000000000000000000000000000000000003000003000000000000300000000000000000000000000000001000000003000001000000000000000026000000000000001200000000000000000000000
000000000000000000000050000000000000003003300300000000000000000000000201000000000000100050000000000500000000000100000001000000050010000000000000010000005005000003000000
010000001131100000003333000000000000000000000100000000000103110000000033300000000000001121001000013330000000000000000000030000333000000000000000000000050030300000113110
000000000000000000000000000033303300000000300000333333030000000000000000000603303633000000033431330000000330000033330100000000000000030100033303330003300000000051000000
000000000000000000000000000000000000000000010000000000000000000000000000000000000000000000500000000000000600000000000000000000100000000000000000000000000000000300000050
000000000000000000000000000000030100000000000000000030100000000000000000100000000100000000000000000003000010000000000000010000000000000000000000000000000000000000001000
000000000033100000000020000000000000000100000100030030030000000000300000000000000000050000000000000200000000000000100006000000300000000000000001000000331100000000000000
000000000000000000000000000000000001000000000000000000000000000000010300003000000000000000000000000000000001000000000000000000000101000000000000100000000000003000000000
000000000000000000000000000000000000000000050000000300000000000000000000000000000000010003000000000000000000000000000000000000000000000000000000000000001000004000000000
000000000000000000000020000032000000113100303000001000000200004000000000033000110000010000000000000200000000001012000040003000000000100131130100000000000000000000000000
333333330000033333333033300003330000000000000000300030000313000300000033300300000000000000030333330033001000000003333000000030333303000100300000200300000313330300000000
