000000000000000000000000000000000000000000000000000000003300000000000000100000000000000000000000000000000000000030000000000300000000000000000030000000200000000000100000
000000000000000000000000000300000000000030000000000000003010000000000000000000000000000000000000030000000000000033000000060001000000000200000000030000000000300000000000
000000000000000000000000000000000000010000000000056000003300000000300000000000060403000000000000000000000000000033000000000000000000030000000000000005000000000000000010
000000000000000000000000000000010000000000000006100000003001000000000000000100000000100000000000003000000000000303010010300000310000000000000053033000000000000000000000
000000000000000000000000000000000000000000000000000000003000000000000001000000000000000000000000000000010000000033000500000000000000000000000003300003000110000000000000
000000000000000000000300000000030000000000000000000000003300000000000000000000000000400000030003300000000000100033000000601000400005000000000333300000000000000000000000
000000000000000000000300000000000000033033000000033033000003003310030000333330000000000000030000000000000000000030000330000303333310606000000333033000000000333030000000
000000000000000000000330000000000003306000010000000000030000000000000000000000000000000000110000005000100000000000000000000000000030100000000000000000000000002033300000
000000000000000000033330000000000003310000100000300000030001000000003001000000003000000000300000336300002000000000000000010003000000000030000050000000000000000103300060
000000000000000000000330000000000003300000000005000000000000000000050000000030000000000200000000003000000000000000300000000000000000000000000000000000000000000003000000
000000000000000003333330000000050003000000000000030003330000010000332300000000300000000000000033313000000100000000000300000000030000000031331000000000000010000001500000
000000000000000003333330000000000003300000000000000033101000000000033300000006000300000000000003033300000000000000300000010000000000000030300030000000000000000003000000
000000000000000233300330000003000033000000301030002333000000000023030000000011010000100003003133000301000000010300000003000000003000002333000100600303050000000003300003
333330000333333333330300303300000003003033300010005303300000000033000000000003333300000330330013003003033603000000000603000000000000030333303333000000000000000103003033
