000000000000003000300000000000000003000310000000000000000000000000000000100103000300000000600000003300300000000000000000000000300030000000000000000300030000000000000000
003400000033303000003000003300000003000003003400010000000020003000000000040003000003003430000000333000003000000000000000030000000000300033300034000300000300000331000000
000000000000000000000000000011103030000000000000003000000000000000000030000000000000060000001100000000001000030100003330030000200000000600000100000001000000130003000030
000000000000000000000000000003000010000003000000000000000000000000000000000600000000004000000000000010000000000000000000000001000000000000000000005000000000000000000000
000000000000000000000000000000000000005000000000000130000000000060000000030000003301000000000000000000000000000000000000020000000000000000000000000000000001000000103100
000000000000000000001110000000000000000003000003000000001100001000004000000000000001000000011000000000000001000000004003300000000000103003000000000000000001005000000000
000000000000000000000000000000033000000000000030000000003000600310000000000300000000000000002000000000000000333000033300000000000000000000000000000000300000000000000000
000000000000000000000000000000000000000000000000000000050000000000000003000000000000000000000030000000000600030000000000000000000000000000000300060000006000000000003200
140110000000000000000000000000030300401100000000000000330000000000303014011000000000000333000000001001000100000000411000030000000000000030330000000000033001000001430000
000000000000000000333330003000000300000000005000000000000000000003000001300003000030000000300000000001000330003600000003300600000000000000000000123000000000000000000003
000000000000000000000000000000000000001060013000000000000000000000000030000000000000000001000000000000006000000000000100000000000000000000100000000000000000000001000000
000000000000000000000000300000000003000000000000000000000300000000000000000030003000000000000000100000110000300000000000000000000000000000000000000000000000100000200000
000000000000000000000000000006000000000000000300010000000000000005030000000100000000000000000100000000000000000000000000000000000000010000000000000003000000000000000000
333300033300000003330000000000000003333100330000000000000003300000000030300004000000000000103313000303000000000033330000000001330000000000000003330000000010300003103000
