300000000000000000000000000060010000000000000600030010000000000000000000010000000004000000000400000000000000000300000000000000000000000000000000000000000000000000000000
300000000000000000000000000300000050000000000060010000100000000000000020010000000000000000000000000000000000000000000003300000010000000000000100000000000000300030000000
000000000000000000000000000001000000350000003300000000000000000000000000001000000000000004600000030003300000000000000000000000000000000000000000000300010000003000010000
000000000000000000000000000060000000000000000000000001000333030000000000000000000000130033000000000000000030000100000000000000000000003030006000000100000000000004333330
000000000555555550000000055000030506500010000000000000000300000000000000000005550000000000000005500000000005555506000000000000000001003500000000000555000000005000300000
000000000333330000000000033300003300000003500000000000000000400000000000000030000000000000000000030000030000303000000000006011000000000000000000000000000002003330000000
000000000000000000000000000000000000000000500000006200001300000000000333330000110000100000000000000000000000000000000003333000000003313000000000330300000000300001300000
000000000000000000000000000000000000000000000000000000000100000000000000030000200000300000000000000000000000000000000000030000500000000000100000000000104030000000000000
000000000000000000000000000001000000010000000000100000000000000000000003000000000000300000000100000003000001000000000000000000000000000140000000010000000030000000000010
000000000333300000000000000010000000000000000000000030000003330000000000000000000000000000000000001000000010000001000000030000003000000300300030130050000000000000000005
033333000000000000000000000000033300000000000101000000000000000000000000000600000000000000000000000000000000000000000000000001000000000200000000000000000003000000000000
030000000000000000000000000003000010000000000100000555550000000000000000530050000050000000000000001000000000000000555550000550055000000001000000000005555500000000000300
000000000000000000000000000002000000000000000001100333330500000000000000003300000330000010000000000000000000000000333010003330000000000300000000060000030300000000000003
130000000000000000333333300010010600303010000133100000000006000000000000000000000010000000033330000000030000003300000310001000000000000000100000000000000000010003353000
