000000000000000000000000000000000050000000000000000000000000000000000000000000000000000000000000000000040000000010000000000000003000006030000000000000030000000000000000
000000000000000000000000000002000000000000000000000000000000000000001000000000000000000000000000001000000000000330000000001000000000000000300010000000000600000010000000
000005000000000000000400001010000010100000111110000001004000010021000011101000000000000000000000000100000110000100000501111100000000000000001111100110000000003000010000
000000000000000001000000000000000000001000111000000000000000000200030011100003000001000100000300103000300111000000000300110010010300000000001111000111000000000001003000
000000000000000000000000000111000000000300011010200000000000001000001001111100000000000000010000303013000011000010000000111100000000000003000001100111000000000000000000
000000000000011000000011111111002050000000100010000100300001000000000110001000000000100300015000310000030110020000000001001100030003000000001000100110025500003010000030
000000000000000000000000000033000300000000333331300003000000000000000000333333000300001000000000053000300330033300000003333033000000030000003333333010363310000003001300
000000000000000000000000000000000000000000000000000000000030000000003030000000000000000000000000000000000000001000020000000000000000000000010000000000000000000000000000
000000000000000200000000000000000000000000000000000010000000000001040002000000030000000000000000100010000000000000000000000000030013000000001000000000000000300000000000
011100000000001100001111110000101500000010011100030000000111001000001001000213000000005005000110004000013110110000000004000510010000001100000000050400001201110001000000
000000000000001110000111000000000000000000000000500000060100000000000001100030001000000010000000000000004110000000000000000300110000000010000000000000000060000000011000
000000000000001110000011110000000100000100000000000003000000000100000011105000000000000100000000000000000001100000000000300006011000000000000600003000000100000000000004
000000000000301100255100010000000000111011000000000000010000000000000011000151100000000000000011000111011510001000000000113011100020500033000000010005110100000000000000
333333330003003303333333333300000000000000333333300000003313333000000033103030000000000000033330330000000333333300000000000000330333333333330000000011000033333030000001
