000000000000000000000000000003001010000001000000000000000060010000000000000000000200000000000000060000000000000300006000000000000000300010000000000000000000000000000400
000000000000000000000000000000000000200000030000000000000000000000000000000000000000000000010001000200000000300000000000100000000100000000000000000000000003000000001000
000000000000000000000000000000000000600000000000000000401000200000000000000000000000000000000000006600000000000000060000010013000000001002000010000000000000000000000000
000000000000000000000000000002003000600000000300010060000006600300000000000000000000000000000000006000000000001002000000010003006000100010000000000001000050000000036600
000000000000000000000000000066000006600000000300001330030066600000000000000000000000000000000000006300000000000006000000000000000100001000000000000000000000000000000600
000000000000000000000000000066000606600000000000000100002000600000122000000000000060000020000000000600000000000006040000300000000022000000000000030000010000030002006600
000000000000000000000000000033333033303300100000000000003330330330303300000000000000030313300000003300130000003033030000003000033003300000000000000000000000000003333310
000000000000000000000000000000000030600000000000000000004000001000040010000000000000000000000010000000000300000000030000000000000000300000000000000000003010000000030000
000000000000000000000020000000000000000001000000000300000000000000000000004000000000000000001000000000000030000001000000000000000000000000003000000000000000000000010000
000000000002000000000660000000000000000000000000000002006000000000000000000100000000000300000000000000000000020006000000000200000000000000000000103000000000000000600100
000000000066000200000660000000001100000000000000003006000600000000000002000010003000000000000000000200030030660066300000006301000000000000000200000000030000000006600000
000000000066006600000660000000000030000100000000000006016603000000000006000001000300300000000000006600000003060066100000006000000000000003006600000000000000000050600000
000022020066006600000660000000005040000000000002030016100600000100501060000000005300000000000000006600000200660066010002000600000000000010002600000001000000000006600000
333333333333333333333333333030000000000000033301330303033330331000000033033330002000000600000006003303330330331303001303330330000000000000000333330300330300000003333330
