003000000000000000000000000300000000000000000000000000500000000000030000000000000001000000000000000003000000000000000030000000000000100000000000003003000000000000100000
000000000003000000000000000300000000000040000000300002000000001600000000000000060300000030000003000001000000000000000030000000000001005000000000000000000000000200011200
000000000000000000000000000000000000000000000000000066000000004000200000000000000000060006000060000000000000200000000000000000000000003000000001000150000005000000006600
000000000000000000000000000000010100000000000000000066000030000006600000000003000000000000000060000000000000000000000000000000000000000000000013010000005003100000006600
000000000000000000000000000010060000000000000000000000001000000006600000000000000000010000010060000000000000600000000000000000000000100100000000000000000000000001005003
000000000000000000000000000000000000000003000000020066001000000006603003300000005000000000020060000300020006000004000000000000000030200000300000000000300000000002006000
000000000000000000000000000000100003333333000000031333033030333330330330306033000000000000051333030333300033333300000000000000000000033303330000000000000003033003333333
000000000000000000000000000000000000000000000000000000000001000000000300300030000100000000000000030000000000000000300330100000000000300000000000001000410000000000300000
000020000000000000000000000000000000000300000030000000000000000000000300000000000000000010000000000060000000000000000405000030003040000502000000300000000000000110100000
000660000000000002000000000400000000000013000300005020001006600000000000000000000000000000030000300000004000000000000000002000106000000006000000000000000000000000002000
000660000000000066000000000000000000000000060505050660000006600000000000100000000000000000000000000000100000000030000030063300000000000500100005000000000000310000066000
000660000000000066000000000000000000000000000005000160000006600300000103000000000030000000010030000000000000000000000000066030000000000036000000000000000000000000060000
200660000000000066000000000000000000000030000000002660002006600000000000000001000000000000600000000000000000000000000000066000000000000066000030000000000003000000066000
333333333333333333333303033310000000000100003030333333333303003030000010001000000000000000200000003030330000000000000003333333303033333303330000000006000330043033313033
