000000000000000000000030303000002003000001001000000300000000000000000000000000000000000000000020000000000030303003030300000100000000000000000300000030303000000000000003
000000000000000000000000000000000000000000000000000010000000000000000000000003000030000010000400000000000005030000000000000000000000000000000000000060000000000010100000
000000000000000000000000000030000000000000000000000003300000303330000033310330000000000000000000000000001100000000000003300000000000000000030000000000000000103303300000
000000000000000000000000000000030000000000000000001000000000100600000000000300000020000000000000000000000000003000300000000000010000000000000000000000000000000000030000
000000005550000000000000005500000130550000000000000000000030000020000000006000000000000000006000000050030003000500000550000600055000300000000000000000005500000000000000
000000003333000000002500000300000000333300000000003330013333000000000000000000000000000304000000000333000100000451000030000000033330000000030000000000010333330000000000
000000000000000000003333300000000000100000000000000000000000000000000000000000006003000000000000000000000033300000330000030000000000030000000000030033000000001100000000
000000000000000000000000000003030333030000001000035031000300040000000000000000000000000000000000000000000000000000000000020000000000000000000000000000000000000000000000
000000000000000000000000000000000000000060000000000000000000000000003000000000000001000000000000000000000000001000030000000000000000000000000000000200000000000000005000
000033333333333300000000000000000103033333000000000001001000001000000001300000000000000100000003303333003030000000000000000003333333300000000000000000100000000003330033
000000000000000000000000000000000000300000500000000000000000000010001000000000000000000000000000000000001000000000000000000000050000600001003000000000000000000000000000
000000000000000000000000000000000550000000100100300000000000050000000001300000350000000000000010000000000000000003000000000000000000000040000000050055000000000306000060
333300000000000000000000000050000060000000000000000000000000003000000000001000333300000000233530000000000000000005000033333000100000000000000000002000030000010000000000
000000000000000000000000000033330000000030000000300000003030006000000000000006010010000000300000000000500300000001000030100000000030000000000000010300000000000000000000
