000000000000000000000000000000000300000000000000001000003000000000030000000000000100000000000004033005000000000000000003600001003000300000000000000000003300000000000000
000000000003300000000000000001011000501000000000000000000010000000000000000000000035000003000011000000000000000000000000000131000000000000000000000000000000033000000000
000000000000000000000000000030000030000005000030001000000001111003000000000000000000000000000000000004111000000000000000304111000000000000000000000006000100000000000000
000000000000000000000000000000000006000000300000000000000000010000003000000000000001000000000000010000000001000030000000003002000000000000000000000500000000000000000000
000000000000000000000000000010000000000000000000000000000000000000000000000000000000010000000000003010000000000000000003000060000020000000000000000000000300000300000000
000000000000000000000000000000030000000000000000000030003000000000000000000000000001050000000603000040010000000000000000010000000000000001000000000000000000000005010501
000000000000000000000000000000000000000000010000000000000004000000000000000000333333000000000100000000000303003000001000000000000000000000003333330301000000000003400100
000000000000333000000000000000000000005033010000030000000000000000000000000330050000000000000010000000001000000300006000000033000000000000003000300000003030000000000100
011110000000000000000000005500000530000000000003000000000000330011110300000600000060000000000000000000000000000001101000100000000030000000550010000000005100000001110100
300000000000000004111000000000030000020000000000000041110100000300000000040000000301000000010000000000000000000030000000000000000000000100000000111000000000200033000000
000000000000000000000000000000000000000100000000000000000100000000000000000000000000000000100000020040000030300000000000000513000000303000000000000100000000000000000000
000000000000003000000000000040000000000000000010030000000300000000000100000300000000000306000000000001000005000000004000000000000000000000003000000000000100000000000000
003330000000000000000000000000000001000001000000000000000000000000330000000000000000000000000000000000000006000000333000000000000000000000000000000000000060000000033300
000000000000000000000333333333333000040030003300001000000000000000000100040000000100000000005000000000000000001030000010000000000000033333330000000000000000000000000003
