000000000000000000000000000001000000000000006000000000003000000030000000003300100000000000000000000000000003000000000001000000000000000010100000000000050300000000000000
000000000000000000000000000003010000000000050000000000000000000000000010000000000000000000000000000000000000000000000000003000000005010600000000000000433300000000000000
000000000000000000000000000000200000000000000000100000000000000000000000000000000000332000000010060001000000000000300000000001001100000200000000000003333300000000000000
000000000000000000000000000006040100000005000000000000300000000000000000000023000000060000000100020000000001000000000000000000000110006600000000000033303300000000000000
000000000000000000000000000036600020000066000020310000000000100000000030000660000000066000100000660000003000000000000000000000000000006600000100003033031303303000000000
000000000000000000000000000006000000003003000000000000000200000500300000000660000000066005000000600000053000000000006010060000000000000600000010000003033300000000000000
000000000000000000000000003333333333003300033333000000330030000000000033330330000033333330033040333130303000003100000000002000000000033033330003000101313300000000000033
000000000000000000000000033300003330000000000000060000000000000000033300000001030000000000000003100001000000000000000000000030000010000200330000003000000000000000000000
000000000000000000000000333306003333000000000000000000000000000000301300000000000000000000001033330010000000000010400000010000000000000033030000000000000000000000010000
002000000000000000000003333350330330000000000000600000000000000003333000000004000010000000000133330000000000000000000000000000000000000000300000000002000000600100000010
066000000000020000000033333303300130003000000000000000000001000033330000000000500000000000003303300000000000100003000003003000003000203310030000000060000000000000000002
066000000000660000003033333303030330000010000000000000000100103000333006000000000000000000003336300000000000030000000000000003000006600330030000000066000000000030000066
066000000000660000003033333300300330000000001000000000000000003030300006000000000000030000003333330000000000000001000000000003000000603313000000010066000000000030010060
333333333333333333333333333333333330000000000000000000013333300333330336433635000000000630033330310006030000003300000033333033333303330333030000004133033303333303330303
