300000000000000000000000000030000000000000000300000000000000000000000000000000000060000000000000003000000300000000100003300003005000300500000000000000000000000000030000
000000000003300300000000003000001000000033010033603000110000000010033000000050000000000000000300300000455000000100000000000000110100003000000000000000003030000001111000
000000000000000000000000000000000000030300000000000000000030500040000000000010003000000000100000000010001000000000000113000000000000000000000000500000000050000030000000
000000000000000000000000000000000000100000001000000300000000100000000010000000000000000000400000000000000000000000000200000030000060000000000000000000000000010000000000
000000000000000000000000000000000000000000300000000000000000000003000000000003003003300000000000000000100000300100000000000000000010000000000000000001000000000500000000
000000000000000000000000000000000000000300000000000000000000000000000000000000060002000000000000010000000000000000000000003000100000000000000000000000000030000000300000
000000000000000000000000000000100001000000000000000000000000000000000033333031000000000030300000003003330056000030333300000000333233300000000000000100000030000003330303
000000000000000000000000000000000000000000003001000000000005000000000000000030006000000000100004000500000300000000000500000000100000000000000600100030100030000000300000
111100000000000000000000005501000000000000000005511110003000000000003001100000000000001033060000000300000111001000003300000000010003000000310000055000010000000000000330
000000000000000000001000001100000000000001000001300000010000000000000000000000000000003000000000000000000000600500000600000030300000000000000003000000030000000006000000
000000000000000000000000000000000030300000000000000000000000040000000020000000000000000000000000000050000000000001000000500000010000000000000000000000000010230000000000
000000000000000000000000000000000000000060000000150000050000000000000000010600001000000000000000000000000000000000000000030000000000000000100000000000030300000000000001
000000000000000000000000000000000000000300300000000000000010000000000000000000000000000000000003000000030000000010030000000300010000000000005000000000103000000000000000
333333330000000000333333333300000000060003330333333333330000000000000033333330000033000030000000000000001333313300001000000303000000030000003333333000030300000000005000
