000000000000000000000000003003000000000000000030030000000000000000000000000000000030030000000000100000000000010000000000000000000000000000300000200000000000000000000000
000000000000000000003000003000000000000001000333300000000033043000003033000000000030000000060350333300000030000000000000033333010000001000063300000000003000330330000003
000000000000000005555000000000005000005551000000000033330000000033333000000000000000000000000000000000000011001061333300000000006000010005100000000003000000000000033330
000000000000000000303002000003300001000303000000000000001000000000000000050000320000000000000000050000001000000000000010000000010000033330000000000002000000000000000030
000000055500000050000333333033000000350000000000000030000000000000000000000003303330000010000000000000000155000000000000000000000100030003000000000333303000000100000000
330003333300003000000000003000300000000000000000000000000000000000000000001000330030330003300000000000000330410000000010100000000003300060000000000000003000000030000000
000000000000000000000000000000003300000010000000000000000000000001000000333330005100000000000000000313333000050003000000000000000503000000000330003000000000000000003004
000000000000000000000000000000010011000000003000000000302000300000030600501000000000000003000000000002000000000000000000000000000000000000300000000000300100000100000300
030000000000000033333330000033000000000000000000000000300000003000400000000000000000000003003000100000003000000000000003400000000000100000300000003630000060500300000000
000050003333300000000000000000020000000010350000000000000205501000000000000000000506001000000001000005550033003000000000000300000355500000500030555000150000000000000000
333000000000000000000000000000000000000000000000000220000000053000001000000003330000000000033301000000303000000000100000300000010600300000000000303303000000000000000000
330000000000000000000000000000000000050000001000033303100010000555000000030601300000330531303000000000000050000155500000000000000000033303100050000330100000010005550300
000000000000000000000000000000000003301050330010300000303000030333000030000130000000000063000000003000030000000003000000000100100000100000003000030002000033000330330000
000000000000000000000033333300003300020000000000000001030003000000050000000000000030000000000000000000000000000000000300313330100000000000000000000020030000000000000000
