000000000000000000000000000000000010000000000010000000000100300000000000030000000003000000000003000000000300000000100000000000100000500000000000060000000600000300000000
000000000000000000000000000000100001010000050000303000000000000000000000000000000000000000000000030001000000000000000005000000000100000000000000000000000000000000000000
000000000000000000000000000000000400000000000000000030330000030100000000000000000000003300310010000000000000000000000000000000030000000000000000001000000010000100000000
000000000000000000000000000000000000000000200000000000330000000000051000000020000000005103300100300000000004000000000000040005000000001010000000000000000000000001000000
000000000000000000000000000000000600000000000000300033330020000000000100000000000000000333300000000000000000000000200000000000000000000000000000000000300000000000000000
000000000000000000000000000000000000000000000000000030332022000000000000000000000000000033000000000000006000010020020100000000001000000000000000000000000005010000000000
000000000000000000000000000000000003333333003130333303030300333000000000000003333333303303000000000000300000000030333330333333003000300000003333333000100000000000000000
000000000000000000000000000000000000003000000000000000000000000000000005301000003000000000000030000000060000010000013000000000000030000000100003000000000010001000000000
000000000000005500000000000000000000000100001000000000000001000000000003500000103001000000005000000000600000000300000000000000000010055000000000000000600010000100000000
000000000000000000000003303300000000000003000000010000000000000003303300000000000000000000000300000000000010003000100000003103000000000000000000100000000000003000031033
000000000000000000000003303300000000000000000001105000003000000003033000000060100000000000000000003030000000000000000000030003000000000010000000030100010000000000133030
000000000200000000003000333300000000020000000000000010000000000100013300000030000000000000000000030020000000000000000000003333000000000000000000000062005000000030500303
000000020220000000003000333300000000022000000000100001500000000000003000000030100005000040000000002026000030000000000000003333000000000000000030000102000000000103003031
333333333333330033333333333300100003031310000100000010000000005353333000000030000000000000000333303333333333330300000003333333030300000333000000000330333300333130303333
