000000000000000000000000000000000000000000000001000333503000010000013050010010000000000000000010000000000000100000000000000000300000000000000003050003000000000000000005
000000000000000000000000000000000300000000000106050000000000000000000000000006000300003003000000000000100002000000000000000000001000000300000000000050000000000000000000
000000000000000000000000000000000003000000000300000024300000000000000000002000000000001600000000000100200000000000000000000000010000100000000030400006000000000000000200
000000000000000000000000000000100060000002000000010500000000030000000000003030000000000000000000000500003000000000000000000000000030300030323000000000003001000000000003
000052000000000000000000000000330330000066000001000000003000100000000333330330000520100006660000003303333000303000000000000000333330300000603000000000006600000000133343
330033300003000000000001110000033300000006000000000000000011300010006630000003300330000506600111002001000003033000000100300000303000000003660000000000000000003003000030
000000000000000055000000000000333000003330006000000033300000000333303000330000100000003330300100030000000003330000050000000000000000033033330003333303333000000000010060
000000000000000033350000000000000000000000000040300000001000000000001020333500000600303335000000000000000000000000333500000000000300000010100030000100000000000000000010
000000000000000000000000000000000000000010000000000000000000000000000000000000001001000110000000300000000000000000050000000030000000000600000000000003000000000010000000
000000000002000002400000000000060000000200060000500300300030000040300000024001000000000200000000100000000000000000004000000001000000000000000000300000030000000000000000
000000000003033000000000000200000000000000000100000060000000003010000000000000010000300001000000000000000100000030000000000000000030003000200600000000000100300000000010
003303033333333000000000006600000003030303000000000000230005030000000030000000133030300000000010000000300000100000503030610520000003000030300013030001000000005200000000
003333030000000000000000006600101003000003000000030000330000300000001000000000033300000000130000300000100003000000100101300310000030000330300033330005010333003330011000
003330000000000003333333333300010000000000000500000000000000000005500000033300033000000030000000006000000005500400033330000000003000000303000003300000500000000000000010
