000000000000000000000000000010000030002000000000000000000001110000000000000000200000000000000003300000000000001053030000000000000000000000000000000001000000000000000010
000000000000000000000000000000300003000000010020000500000000003000000000000003000600000000000000000100050000000000002000300000100000000000000000000000020000000000000300
000000000000000000000000000000000000000004000060000020001000004010200001000000000000030100000000040100003000200000006000001000000000400020300000000000660000010000030000
000000000000000000000000000000000030000000000600000660000040000006600000000004000000300000000000000000000006603000066000000000000000000060000100000000000000001000000000
000000000000000000000000000010000000000001000660000650000000000006000000000000000000000000000030000000000000000000066000003000000000000660000040000030660000000000000000
000000000010000000000000000000010000030000200660000160000030000006600000003000000000002202000000000010000006600020006330020020000000000163000000000001611000000000001000
000000000000000000000000000000003000013333331030303333100036030300300300300000000030330003300333330000000333013333033333330333023333303333330000000303333000000000000000
000000000000000000000000000000001000000000010000000000000000000000000000000060000000000000000030000000000000000000000000000000000000003000000360030000050000000000000000
000020000000000000000000000003001000000000000001000100000000000000020000001000036100000000300103000000000000000000001001110001000100000000000000000000000003000000000000
000660000010000002000000000400000003005000000010000000000003000030660000010000000000000000000066300000000000004000000000000000030000000000000000000000200000000100010004
000660000000000066000000000000000000105000000010000005000000000001660000000000000000010000003066100000003000000000000002000000000000000000000000000006600000000000000000
000660000000000066000000000000005000000000000000000000000000000000600000000000100000000000000000000000000000000000000000000000010000000000000000000300000000000001000000
200660000220200066000000000000000000320020002000000000000100000200160000020200000000400013020066040000000000000000000001001000000000000001000000010000600001220000000600
333333333333333333333003333300000003330303000000000000000000000333303303303330000000000000033333630000000000000000000000100000300000000000000000000330303333033110003330
