000000000000000000000000003300000000000000000000000000303000000030000000000330000000000004006000060001000000000000000000000033000000000006000100000000003300000000000300
000000000000330000000000003000000000003000005003030033000000000050000000000300000000003615000000000000000000333000000000000030000000010000000000000100003000000000000033
000000000000000000000000000033000333000000000001000000000300050000000000000000300033000000033000336000000000001000000000000000000000033000333000003000000003000000000100
000000000000000000000000000000000010000000000000000000000000000000050000000000000000030003000000000000000000000000000000100500003001030006000000000000000100000000000000
000000000000000002000000000050000000000000000000000000000000000000000000000000000000100000000000000000000000000000500000006000000001000300100000000000000003000000000000
000550003333500000002000034300000000000000030335000000000000102000000500303030000000000031300000000005500000000000050300000343500000000000000000000001034300000000030350
000000000000000000033333000000000000000000000402000000100000000000000030300101000030333000000000000000000000000000000000300000000000000000000300300333000001000000000000
000000000000000000000000000030000301001000000000000010000100010300000000000003000000000000000000000000000001000010000000000010000000000000050010000000000050000001000000
000330000000000000000000000000000300000002000000400000000000033005000000033000051000000001300000000000000010000001000000000600003000000000030000000010330100000000003001
000000033000333300000000030000000000000000000030000030000000000030600000000000000000300000000003000000000300000033000000000301010000000010000000000001000000002000000300
000000000000000000000000000000001000000000000000030000000000000000000000000000000000000000000000000000000100000060000000000000000000006000000000000000000030000000000000
000000000000000000000000000000000000002000010600000000000000000000000000000000000000000000000003000032000011000053030000000000000240000030000000000000000000020000000000
000000000000000000000000000000003430500002000000300055000030350000003000000000005500003330000000000000002000000000000000000000000100203033500000500000000000000000000000
000000000000000000000000000033300000000033000000000003000000000000000000010000000000005000000010000100033000000000000000000000000000300000000030000000000000000430000000
