000000000000000000000000000000000000000000000000000300000000201000000000000000000000000001010000000000001010000000000000030000000000100000000000000000000000000010000000
000102000000000000000000000300010230000000000001000000000030000000304000020001000000000010000000000600000000000300000000000000000000000010000000000300030000000000200003
000000000000000000000000000000000000000001100000200000000003000000005200000000000030000000000040003100000500000000000000000000000003030020000000033000000200000000000100
000000000000000000000000000060000000000000000006600000000000000001000600000000000000040000000000003001000000000030000000000000010033330000005300033005000600000030000300
000000000000000000000000000000000000000000000000000330000000000000006600330000000000000000000030003000000000000000000003000000003333330000000033000000006000003004000000
300030000000000000000000000000000000000000000006100330300000000000006603030000000000000000000330303000000000020000300001000000033330330000000303333300106600000000000000
000000000000000000000000000004000000000000303333300330000000000133333333300000000000000000003030000003303000000000000100000000133333000031333303030330331300000000000000
000000000000000000000000000000000030000005000000000000000000000000000000001000000000000300000300000000000030000001000000000000000000000000000000050000000000000000002020
000000000000000000000000000000060030000000000600000000000000040000000000010206600000000002000000000000002000030006000000001020000000000100030000000000102000000000000000
000000000000333002000000000200000000000003000000330030000000033300000000000000001000000000060000060000033000030200050030000000000000000000000030000000000130020000000040
000000000003333000000000006600000001000000006030000000000000530100000000000100000000000000000000000000333030006600010001000030000000000000000000000000010033000000000000
003300000333333000000000006600000000000000003300330040000033030300000000000000000000000000000000300033333100006000030060000000003301300000000003000400000030000000000000
033303003333333000000000006600000000050001000300330100000133333301000030003000000000300030000000300303000000006000000600000300033313000000010333130300000030040060000030
333300033333330003333333333305000000000000303303000033333033333000330340000000000000000000000000003533003330100313333031000000333300000000000303000000000030000330000000
