000000000000000000000000000000000000000000000000403001000000000000000000000000000000030000300000000000000000010000000001000000000000001000010000000004000000000000000000
000000000000000000000000000000000000000000000000000000000000000100000000003333000300003000000010000001330100000010010013000006000000000003301000016000000000000000030000
000000000000000000000000000000000300333000000000000000000000010000000000033300000050100000000000000003300000000003000031000000000000000003000031000000000000030001000000
000000000000000000000000000000000030133003000100000000000000000000000000033300000000000000300000000013331000000000000000001100000000000033306000000000000301330000000003
000000000000000000000000000000000000333000000000000000000060000000003100330300000000000001000030030033030000000000000000000030000000000333300000000000000003300000000000
000005050000000000000000000000101000333000000000000000500300000004000000303300000050000000030000000330330000000000000000000000500100003303300000500000000003310000000000
000000000000000000000000000033330300303333001000030010000000000003330033333300000000300033000000003300300003033300330333033330000001030333000033333000000030230303323130
000000000000000000000000000010000003000000000000000000000000000000000001000010100000100000000000000030000000000000000030000000000000000000000000001300000000000001000000
000000010000000000000000033010000000000000000003030001000100000000000000000000010000000000000000100000010000005000500000000000010000000000000000000000000010000000003330
100000000000000333000000333000000000000000000330000000000000030000001003000001000000000330000000000000000000000000000000300000033300000000300003000000000000000600003330
000000300000000333000000333000000000000000000333000000000000000000000003030000000003031300001000000000001000000000000000000000033300000000000000000030000000000000053330
000000000000000333000003333000300003000000003333000500000001000000000023030310000000033300000000000000000200000000000000000000001000000000000000060000000000003000030333
000000000000000333000033333000000000001000030330000000100000000000300003030000000000033030003000055000000000005000060000000060133300000000003000000000000000000000330030
333333000333333333333333333060330030000100334000100000000100000000000030630303333330330033000203000000000003000200000003000000333333300000000000000000000000600603333030
