000000000000000000030000000000000000000530000000000100000000000000000000000000000000000003010000100110300010000300000600000000000000010300002000000000000000000000000030
000000000033300003000000000000001310030000000605500313500003310000000100000000100000000303000000000000055000000000030103003000000000000000000000000000030000000000000300
000000000000000000000000000011100000000000000001000100000000300000430000000300000000000000100000010000000000000000000000000030000000003030000100000010000000000020040000
000000000000000000000000000000000030000000300000006000003000000000050000000000000000000300000000000001000000000000000000000030000000300000000000000000000000000000200000
000000000000000000000000000000012030000000000000000000000000000000100300000000000100000500033000003000040000000100050000000230000000303000000000000000000000002333000000
000000000000000000011110000004000300030013000000030003000003000010000000000030000000000001100000000000000110000100000010000103010000100010000300011000000000010001000000
000000000000000000000000000033333300000000003333300000000000000000000000000003303033001060000003000030300000000000000003030030000000033330330000000003033333103300050000
000000000000000000000000000000000000000000000000030000000000000620000100000300000000000300000000000600000003000000001000000000130000000000000100000000000000000000000000
000000000000000000000000005500000060000000010000000010000600000000000300030000000000000003000033300000000000000000000550000000000133000000100000000000005500000001006330
000000000000000000041100000000000030000200000000000030410000040100000000000300000000000000030000000500000000000010000000000000400000000000010000010101000000000410004000
000000000000000000000000000000000000000001000000000000000000000100000000010000000000000000000000000000031000000000000000000000030000001000030000000000000000000000050000
000000000002333300000000000000000000000000010300003000003300006001000000010000010203000000000000000000000000000000000000040000000000030500000010000000000033030000000000
000000000000300000000000000000000001100010000000000000000000000300000000000110000030000003000000000000000500000000000301003000000000000010001100000000000000000000000000
333333333333300000300003333300020001000000333333300003000000300000330300000003060030033333000000000000030333330300033330000000100000000013160000000010333300000000000001
