000000000000000000000000000000000000000001000000000000100000300000000000000030033030000000000133300000000000000000003000000000000000000000000000000000630000000000000000
000000000000000000000000000000000000002000000001001000000030000000000300000000036003000000000033000000003010003000000000000000000000000006000000000020000000000000110000
000000000000000000000000000000000030300000000000000000003300500000000000000003503300000000035330300000000000000030001000030000000003000000000000000000000000000000000000
000000000000000000000000000003000030000000011000000000000000000000000000100003003330060000030133500010000005003065000000000003000030030010000000000031300001100001000000
000000000000000000000000000000033330000000100000000000060063000000000011100003030300000000030003300010000000300000000000000000000000300000001000000050000031100000000000
000000000000000000000000000000033330000000111000500000010000000010000001130003130310000000031303300000000000000001000000000000300000000002000000000200000011100000000000
000000000000000000000000330003333330030000363333300000000003300000030033333330330001000000000033300003300000050000000000000300000000033330300000000000330003033300000003
000000000000000000000003333030000000000000000000340003300000000000003000003000010000000010000000000000000000000000004100000000000000000333300000000003033000000000000000
000000000000000000000003330000000000000000000000300033000000001000000000000000000400003000000000000000000030004010001003010000000000000303000000000013130000000000000000
000000000000000000003303333000000300000000000060030333300000005000300000000000000000000000000000000000003000000000003000000000000000310333000000003100333000000020000000
011000000000000000003303333000100000000000010030030330156000000000000000000000000010000000000000000000000011000000001000100000100000310033300300001001303000000000003000
111000000000000003333303333000000000000000000300030333300000303000000000500000100000000000000060000003033113000010000001110000000000330333300000333303003000000000000000
111000000022020003333303333000000000002202000000030300305000031000220200001000000000000010000002000003013111000000306001110030000333010333300000313000333000000000002202
333333333333333333333333333300033000033603000000003333300303333333003300000000000000000000033330333333333300333600033113333333330360333033333333333333030300100103313033
