000000000000000000000000000000000000000000000300103310000000010001000000000000030000030000000000000000000000000000000000000000003000030000000000001000000000000000000000
000000000000000000000000000000001000005500000000600000000000000000550000003000000000300050000005000000000000003000000000001000030000000000000000000000000000000000001500
000000000000000000000000000000000000000000010010000100000600000000000000000000000000000000000000000000000000000000000000000000300030000050000000000600000000000000000000
000000000000000000000000000030000000000000000000000000000002000600000000000000030000200000000000001000000000000100300000000000000000300300000000000010000000000000000000
000000000000000000000000000000030000000000000000000000100000000000000000000000000500000400000003000000003000000000000000000500000020000000000000000000000000000000000000
000000000000000000000000000000000000000000231020000000000000333060000040000401000002001000000000000000000000020200000000000000000033300000002000002000000000304300000000
000000000000000000000000000003000003333033303313233033333133303333303300000003330330000000000333330000600033331033103300030000303303306000000330300000000000010350330503
000000000000000000000000000000000100000000000600000300000000130000000000006000000000000003000000000000000030100000000000000000000005003000030000000006100000000000000000
000000000000000005500000000000000000003000000000000000000000000000030000000000000000000000000100000100000100000000000000000000000000000050000000000100000000001100000000
000000000000000000000000000030000000000000000000000000000000015000000000000000050000000000000000001011000000000000000000000000000000000000100100000000000050000300000000
000000000000000000000000000000000000010000000030000000000000000000000000000000000010000000000000010000300000000000000000004013000000000000000000000000030000000000310300
000000000000000000000000000000000100000000001000000000000000000000000000300000000001000010000000000000000000000000000301000000000000000030010000000000050000000000000000
000000020002020000000000033300300030000000300033300001000000000000001000000001130000000010000000000000303003030020000020000000000000000500000000100000000000000000000000
333333333333333333333333333300050000010000333033300000000000000333033300000000000300300030010000003033333313030303333030100000000000033300330001000331333340003000010000
