000000000000000000000000000000300000000200000000000000000000001000000000000000000000000000000000000000000000000000000000000001000040000300600000000000000000000500000000
000400000000000000000000000000000000000000000000100000000000000000400100000003000002000000000000000000000000300000000003000000000000000000000000300001000000000010100000
000000000000000000000000000003003000000000000000000000000000000000000000000000000000000000003000000000000000000000100000000000000000200000000000010000000040000000000000
000000000000000000000000000000303000001000000000200000001000000004000000000000000000000000000000000003000000000000000000000000000110000000000000003000000002000300000000
000000000000000000000000000000010000000000000000000000000000000001000000000000000000050000000033000000000000601060063000000000000000000000000000000000001300000005050000
000000000000000000000000000000310240000300002000000000010000122000300000000000000000002200000000000000000000003230000000000000000000000530000000001000010001000000000022
000000000000000000000000000030333330000000330330301000003333333000000000000303333003033303305002000000001003033303330033333333000000000001000000000000010000000003003030
000000000000000000000000000000000200100000000000000000000000000033000300000000000010000000000000000000000000000000000030003000000040000000000000000000000000030000000000
000000000000000000000000000000000000300000061400000001000000000000000000000010000000000000001040000300301000000000040000000100000000000000000004000300000000000000004000
000000000000000000000000000000000000000000000000000000060050110300000010010000000000000000000000000000000000030000000000100010000000000000010000000006000000000000000001
000000000000000000000000000000000000000000000000500000000000000100000000010000000000000003005050000300000000000000600000003000000010000000600000000003000000000010000000
000000000000000000000000000010006000000010000000000003000000000000000000000000000000000000000000000000000000000000000000000100000000000100000010000000000000000001500005
000000000000220020000002202000000000020000000000010000000020000000000600200200000400300000000000000120000000600000000000000022040000000220200320000100203001000000001000
333300333333333333333333333303360033333313010000000000000330333000000033330336000000033300000000003333330000000000000100130303000060000313333330000030333303330030000000
