000000000000000000000000000000031000000000001000000000000000000010000000000401000000000030000300000000030000001000050100000000000030000000000000003000503000000300000000
000000000000000000000000000000000000030000000000005000000000000000003000000000303000000043000002000030000000000000000010000000001000000000000000000100000000600030000010
100000000000000000000000000000000100000000000000000000000000000000000000010000004000000010020000031000000000100014110002000006000000000000410000000041100020000023000000
000000000000000000000000000000000000000000500000600660003000000000000000160300300000003600060000000000000000000000000000000000000000000000000400000000000000000000000000
000000000000000000000000000000003000001000000000300060005000000600030000660000300000006600061300030030000000000000010000005000000060000100003000000000110000000000000000
000000000000000000000000000000000000000000000000000611033000000000001000660000000000506600060000000000300000000000000006000000000003000000030000000000000060000000000000
000000000000000000000000000033000000000000000000003303030000000336000033330030000000003333333330330000000000000033335333333300000000000000001000020031303131333330000000
000000000050000000000000000000050400000000000000001000000005003010000000105300000000000000000000000000600000500000000000000000000003000000500000000000000000000000000000
000000000002000000000000000000002000000000000000000000000020200050000000000000050000000300000000000050000003000000000000000003001000300000000000000000000000000300000000
200000214110000000000000000014110000010000200000210000001411000000000010000000000302000000000000000000000100100000000000000050004000011000001000030000000030000000000000
600000000000000066000000000000000000000000600000000000000000000000000000000060000000005000000600000010000010010000000000000500006600000001000000000000000000000010066000
600000000000000066000000030030000000000000200000000300100010000000000000000010030000000000000000000000300000000000003000000000000600000000001000000030030000010000002000
600000000000000066000000000050000000000000600000000000030000001000000000000003000000000000003000000000300000000000000000000000000000000000000000000000000000000000066000
333333333333333333333330000033303330300000330333302000006331033000000000000003333333100000000000010330000030333003000000000000033303300003000000000330000000000003300301
