000000000000000000000000303000030300300000000000000000100303030000000300001000520010000303003000000031000000000000050000000600000000006030000010002600000000030000000000
000000000000300000000000000000001000000000000000000000000000003000000000000000000000300000000000000000000000000000030000050020000000000000000300000000000000000000000001
000000000000000000000000000000000000300000000000001000030000000001000033000000000000000000000000003300330330000001000003300210000100000000000313000010000000000030000000
000000000000000000000000000000000000000000006100000000000000000300000000000000000000000000000000005000000000000000000000000000000000000000000000000000000100000000000000
000000000000000000000000000500000053000035000000000300210000010000010000000000000100000100530000006000000000000000000000000000006000000000150000000000000000001050001000
000050000333000002052500000350000030000200000000033330000000003000205200000000300000306000333300000000300300000400020020030000030000050300130000000000000051000030002052
000000000000000000033333300030100000000000000000003300000030000000003300000060100000333300000300060000000000000030000130000000000000033330000000000000000033330000000033
000000000000000000000000000000000000010000000000000000000000000000000000000000000000000000000000000300000000000000000100000000030000000000000000000000000000000000000000
000000000000000000000000000000303001000000000003000000000000030000000000000000000000000000000000300000000000000300300000000000000000000005300001030000000001000050000000
000000333003333300000000000000000340000100000000033003330000013000000300000030000003000005000000000000000000500000000000000003330030000000500000000100000063003330003033
000000000000000000000000000000000000000000000000000000000003000000000000000000000000000000000000000000000000003000000000000000000000000000000000000000040000000000000000
300000000000000000000000000000000300000300000010000000000000000000030030000000000000010000340000000000000000000000000003000000000000000000000000000000000000000003000000
333300000000000000000000000000020553003500003330000000000000500333300000033000000000000000000333000000500000205200000033333014000000000303300033000000050000300003303000
033000000000000000000000000000000330010000005030000000000010000003000000000000000000000000000000000000000000000300000000330000030010000000600000000010001000000000330000
