000000000000000000000000000000000100000000000000010000500005001000000000000000000000000000000000000000060130000000000600300000000000200000000000000000000000000000000000
000000000000003000000000000000000000000000300000100000030030010000000030034000000000000001001000000000000000001000000000030000000000000000010000000000000000000000000001
000000000000000000000000000000001000000000000100000000000330001000000000000000000000000100000000000000000000000000000000330100000230000000000100300033000300000000000001
000000000000000000000000000000000000000000000001000010000333003000000000100000060000000000000000000000000000000000000003333003006600103000030000000303300000000000003010
000000000000000000000000000000300000000000000000000000003333100000000000000000001000000000000000000000030000000030000103033003006600000000000000000003100300000131000000
000000000000000000000000000000000000000300000000000100003333003000000000000001003000520000000001000010000300000000000003133003006600000000000000000303301006000330000000
000000000000000000000000000000000100000301000000003303333310033030000000013000000000333333300000010000010003000000000003300303030330030360330330333333033303333030010000
000000000000000000000000000000500000000000000000030000000000000000000030000300000000010300000000000600000000000100005000000000000000001000000000000000010000000000000001
000000000000000000000003000000000000003000000000030000000000000000031000000003000000000000000000000000000000000010000000000000000000001003000000000300600000000000000000
000000000020000000000033000300000000130103000200000000000000000000000000020000000010000000000000000002000033000000000000000000000000000000000002000300000000060000003000
000000000660000000000333300301010033363000006600000000001030000031000000660010000000000000000000300066000333000000000010000001500000000000000066002000000000000030000000
000000000660000000033333300300000303330003006600003000010000000000003300660000000000000000000001300066000315000300000330000000000001000000000006000000000000030000000000
000000000660000000033333300300000131333003000000000000000105000000103300660300000000000005000000100006000330300000100331000000001000000000000166000000000006003000000000
333333333333000333333333033300303333330333333300000000003300330633033333333000000100000000003330303333300333003303300131000000310000000003003033300300000006100000000000
