000000000000000000000000000000000000001000000130000000000000000000000300030000000040001000000000000000600000000001000000000000000001000300000000100000000030000303000000
000000000000000000000000000001000006300000000000000000000000000000000000000000000030000001000100100000300000000000000011030000040033000006000000000000300000100000000000
000000000000000000000000000000000003000000000000000020000000000000000000000000002000000000003330000000000000010000000000003000601000000000010000000000000500330034002003
000000000000000000000000000000000002000000000000000660000000000400000001000000066000100000033330034000000000000003000000000000000000000001000000300100000033300030066000
000000000000000000000000000000000030000000005000060003100000000000000020000000006005000600033040000000000000000000030030000000100000000000000000000000100033000030066000
000000000000000000000000000000000010100000000000000600000000000000000000000020066300000000003330030300000000000200300030000000000000000000000000033000000033330000066000
000000000000000000000000000033303301000000040000033363030000000010000000000003303033100000000330330000200000000030303330050000333333000000010303333000000000331335333603
000000000000000000000000000000000000000000100000000000000000000000000000000010000000000000000000000060000000010000300000000000000000000010005000000000010005000000000003
000000000000000000000003000000300000100000000000000000000030000000000000000000000000000000000000000000003000000000000000033000000000030000000000000000000000000000001000
000000000020000000000033300300330003000300000000100000000303003000005000000001030500000000000000000002000010000000000000333003160000003000000003300000000001000002000600
000000000660000000000333300300330030000000000000000000023300103000050000000000000000000000001001003066005006000000000003033003006600003000000000000003000010000000403000
000000000660000000003333300303031030010000000000000000030333000000000000000004001001030000000000000006000300002300000300330003006600000000000000000000000000000000000000
000000000660000000033333300333030000000030000300000000030333003000003000010000000030000000000000000060000000003300005000333003000600000000002330000000000000000000000000
333333333333333333333333333331033300030000000000033033300333303100000033333333133333000003033200333033331303330300300003303333333333310000001303333000000000000000003000
