000000000000000000000000000000000003000000000300000060000001300000006030000003000000000000000000010330000000000033300000000000000000000000003330000000000000000000000000
000002000000000000001000000000000200000001000000000000303000300303330000200010000000000500000050000000000300000000000003000000030002000003000200000100300030000000005003
000000000000000000000000000000000000000000000000000000000000303000100000000000000000000000000000060010010100000000000000020000000000000000060000000000000000000060000003
000000000000000000000000000000000000000001000000100000000000031002000000000300000000000003300000030000000000000000000000000033000003000000000000000000100000030300030000
000000000000000000000000000000000000000000000000000000000000033400100000000003000000000000300000000000000001000001000000000033000000000000000000000000000000003030000000
300033330000055000000000000030003335010000000000100001000003033000001452000003000005000323300033000003000300000500000010003033000013350000000000000500000000030300003300
050000000000000000000000000005000004000000000000010000000333333003333300001000030000303333333300003000030050000000000330333330050000000000000003030000000013133033330000
333000000000000000000000000001300000000000006003000000003330000000010000000130001000000000000000000000000000000000000000000000000000000001000000001000500000000000000000
000000000050033333000000000000300001033000000000310000000301000000500000000100000300000030433300000000020000010000000003330000000530300000000000000530000013330000030000
300000000000000000000000000330000000000000000000000000033000100000000000000000000000000000110000010000001000000030000000001000000000000000000000000000000000000003000000
000000000000000020000000003300103000020000000000000000300000000000000000000000000000000000006200000000003000003000000001020000050000000000000106000010000000200000000000
000000000000000000000000033300000000013000000000000003330000000000000000000010030000000000000000000001000000000000000000000000000000000000000000000000000100060300006005
000000000033000000000000333300000060000000010330000030330001000000330030003330000030000000000000003003333000000000100000000000000330030010010000000300000500000103060330
000003333300000003333333333300100030003336003000033333300000033333000005000000000000001010000003330000000030300000010030003333333010000000000000000000000000030000500000
