000000000000000000000000000000000600100000066000000000000000000000003000000000003000000000300000000000000100000000000300000000000000000030000000600066000100500001000000
000000000000000000000000000000000000000000000000002004000000010000100000000000000030000230000100000310000010000000000000000060000000000020000000000010000000000000000000
000000000000000000000000000000000000000000000110011000001000000500000006000000003000000050000000000006000000000001000001103000000000000660100000000000110000100100000001
000000000000000000000000000000000000003005000060010000000006000000000000000000300000006000000003350000000000000000000060101000000000000660000066000000000001000000000030
000000000000000100000000000001000300000000000000011000300000000003100000030000000000006600001000000000000000003303000000100000100100000600000066001000000000000100000001
000000000001111110000000000001135000000001000000011000000000000003000000100000000010006000010102100000000010000000000001030103000001000360000066000000000311100000010600
002000000000000000000000000000000000000000303333003333030000000030000030000000010000330333600000003000000002010000000003333330010000033333330033333363333300000000000000
066000000000000000000000000006000000000000000000001000100060300010003000010000000000000000506000000000003000000000000000000000366010000300000000000000000004000000000000
000000000000000200000000200030000000000000000500000000000000000006006000010000000000000000000001000000010000000000000000400030000000050000000000000000300302000000100000
000111000000001100000006600000000001000000000600000000000001100113000000600000000000000000000011100000000100000000000000000000030010050000000000000000000011000001000001
000000000000001100020006600030030000000000006600010000000000003110012000660000000000000000000000003100000011002000000010000000000000000003000000000000003061000200000000
000000000000001100000006600000000000000000006000000000000000000110001000660000000000000000000300060000000110000000000000003000000003000300000303020000000011000000000000
000000000000001100000006600000000000000000006600000000000000000110000000660000000111040010130001000000000010000000001111110000000000000000000100100000000001000001000011
333333333030003333333333333300001000000600033033313030003330313303330333333330000150000600033333133303000333333300000001000000333333000200010020010330300000303630000000
