000000000000000000000000000060000000000030300000000000000000000000001000000000001000000000000010000030000000003000000000000000000000000000000000000000000000000000000300
100000000000000000030000003010000000000000000000000000300000030000000004000000000000000000000000000000130100000300000300000030000000000000000000000030000000000000000000
010000000000050000000000000001000000000000000000000000000000100000006500000000000005000000500100000003030010000000030000000000000000500000000000000000333000000000310000
000000000000000000000000000030000000000200000000300000000000000000000000002000000000000000000000005033300000000010303000000000000006000002001000000103310000000000303000
000000000000000000000000000000000000006000000000000000000030000600000030066000000000000000000066000033000100000003313000000000000010030066000000003033330003031060300001
000000000000000000000010000003000000000600000010000000100001000000010501066011000000000000000066000033000000000033030000100000000000000066140010003030030000000000001000
000000000000000000000000000000000000033333030333300000010000000000333300333331100003000000003333333303303000000033103330000000001001000030333333330333333303033000000000
000000000000000000000000000000000000000100000000003000001000000000000000000010000003050000000000300100000000000000000000000000000010000000000000000000000000000100000000
000000000000000000000000000000000000000000000000030000000000000000003000000001000000000003000000300000003300000000000000000030000000000000300000030300003000000000000000
000000000000000003330000000000030000000000000000000000050003300000000000000000100000000000000000000000000100003001000200003000000000000100000004300005000000000050000300
000000000002000033300000000040033000000000001000000000000031310000001000000000000200000000003000630000000000001000000100100003000000003003000000000000000000000000000230
000000000066000333300000000000333000000003000000000000000033000000010000000100000000000000000000060000000000000000000000000000000010000000003000000000000000000001006210
000000000066003333300000000033036010000000013000300003003333300300000000000000000000000000001000000000000000000000000030000000000000000004003100000000300000000000002600
333333000333333333333030333333033333633330000000000000000430303010000003003300000000000000000000000310333033303000000000050000013333033030300000000000000000000000033330
