000000000000000000000000000000000000000000030000000400000000000003000000000000000000000000000000300000000000000000000330000000000000000000000005004000003300000050000000
000000000000000000000000003000000000000000000013000000000000000000000000000000000000000000000000000000003000000000003330105000000000001000000000000000003300002003600000
000000000000000000000000000000200000000000000030000000000000000002000000000320000000000000000300000400000000330010003003300000300000100000000005000000030000000000000010
000000000000000000000000000000200020030000000000300000000006000100000200000660000001002100210000000000000003033000303000000000000000200000100030300033300000000000006000
000000000000000000000000000000000660000000200006000000000000000000006000400600000100000006060000000000000303313303330306000000000006600000060000000333333310000000000000
000000000000000000000000000000000660000033000001000000000000010003006000000601100030003006600001000000000333030030350000000033003006600000660000000333330000000300000000
000000000000000000000000000033300030001000300000000000130001000033330333333333033003333003300060010305000030000033300003333333333333333133330000000033000130333300006110
000000000000000000000000003300000001000000000003300000000010033000000100000400000050000000011030000001000000000000000030000000003000040000200000000000000000000000000000
000000000000000000000000033301000000000000000033300601000000033000000000100510000000010000000000001000030000003000000000000030000000000000000000000001303000000010000000
002000000000020000000000330000100000000010000000000000520033000000000000300000003000000000000300000030030000000100000000000000300000000000000000002000000100200000000000
002000200000660000000003333000000000000000003331000000061033300000000000000000000300000030000000301000000000506000003000053000000003000000000000666000000000200020000000
000006600000660000000333333300000000000000333303100300600033333000100000000000000000000000000000100000000000006000000000000000300300000000040000066030000000000060000000
000006600000660000033333330000100030000000331030000000663333100000000000030000000000100000000000130000003000006600000000000000000000030000000000006000000000000600000000
333333333333333333333333000033333330000000333000033333333330000000000000000000000000000000033003000000000033303300000000000000000001000000003333333000000033033330030000
