000000000000000000000000000030000000000051000060000000000003030000000000000300000000000000000000010000030000000000000100000100000000000060000000000005000000000000000000
000000000000000000000000000000000300030300000060000000000000300001000000000000000000000000000000000000000600000000000000000000000000000000000000002003000000000000000000
000000000000000000000000000000003000033001000000001000003000000000000003000060000000000100000000000000066000000000000000030000000000000030000000060003000000001000000000
000000000000000000000000000000000000330030000300000000000000000000200000000600330006000100000000000000060003000000000000010000000000000500000000036003000000020002300001
000000000000000000000000000000000000036030000000000000000000000006600000000600030000000000000000000000066000000000060000030000000000000000000000066003000000660000000001
000000000000000000000000001100100000030000000050000000000000010200600000000400030030000000000000000000006000000000000000130600000001100300200300061003000000660000000013
000000000000000550000000000005500003333303001000000000150000060303333330333326303303000000000000003300333055000005500603333300000000030330033333333333130330333300000000
000000000000000000000000000030000000000000000000000010000030000000000003010000000001000100000000000000000000000000000000000500000000000000000010030000000000003000000030
003000000000020000000000000000000300000030005000000000001000101000000000000033000000000000000000000000300003000000000020000060003000000000000000103000000230000000000000
003000000000660000000000000000000660000000000000000000303000000000001000000000100000000000000130000100000003000000000660000010000300000000100000000000000000000004000006
003000000000660000000000200000000660014010000000000020000000060000000000300010000000200000000000000012000003000000003260000000000000000103000000000000000000030000100001
003000000000660000000006600000000660000000000000000660000000100000030000000000000000000000000300400066030033000000000660000002500000010000000000010000000000001000000000
003000000000660000020206600000000660000010000362020660000000001020002000000000000000000010060000112066000003000000000000000000000000020660000000020300000000000000000100
333330333333333333333333333333331330000000030303330333330003000333333300000000550300036000300001003033333300330333331030000000000000033030003333303055400000000000020000
