000000000000000000000000000056000310006000000000030006010000000000000000000000000003000000000000000000000000000000000030006000000000000000000000000000000000000000000000
000000000000000000000000000000300000000030000000000011010000300000003000000000000000000003300003006000000000010000000000000000000000001000000130030000000000036330000003
000000000000000000000000000000000000000000000000000000000030000000000300000000000000030003300001000000100000003030000000000000600000503000300300000000000000000330000000
000000000000000000000000000000000000030000000000000020000000000000003300000000000000000033313006000300000000000000000000000000033000000010000000003000003000030330000000
000000000000000000000000000000000000000000000000000000000000000100333330000000000000000333300000003000000000000000010000000300660000000000000000000000001000003150000000
000000000000000000000000000003000030000001000000300000000000000003313300022020000030033300300000000000100000220000020025000130610000000000000000202000000030333330000033
000000000000000000000000000000005001000030000000000000000000000033016300033033304033100333000000021000000133333333330030300033333033300000003333333003000000330033000033
000000000000000000000000000001000000006020000005000000000000000000000000000000303000000000000000000010500000003000000000000030000301000000000000000000000000000000000000
000000000000000000033000000000000300000000000000000100000000000000000000000000000000100000200101000000000000000000000030000000000005305000001000000000000000000000100000
000000000000000000033000000000000100000000000000000000004000000000000000300000000000000000000000001100100000000000000330000000000010000000100000000000000000000100000000
020000000000000000333000000000003300000003000000301000000200000500000000000300000500020003000000000000000000000000003300000000000001000000000000000120000000000000600000
660000000000000003333000000000033336500000000000000000006600001600000100000000000000660000010010000000000100000000030330000000000000000000000600000600030000000000000000
660000000022020033333000003000333036600005000020200000306600001000000000000000000011663000000100000000030010000000333330000000100000300030000000000000000000000400000000
333333333333333333333330003333333003133333333333333000333330333000000000000000000002330333100030010000030000000333310330100000000000000000000000000333333300000000400000
