000000000000000000000000000000000600000000000000000000000000000000000000000000000000000100000000000000000000000000000000000000000100000000000000000000000500000000000000
000000000000000000000000000000000000000002000000030000000000000000100000000000000000000010000000000006000000000000000000000000000000000000010001000000000003000000100000
000000000000111111111111111110110000030066000311100000051110161100400000000101011000004001000100010004000011100003000000111111000306600040000161101000000013000660304000
000000000000000011111111100011110100000066001110100000000010011000000000000101110010000001000100000000000100110600000001001010000006600000001011000000000004000603000000
000000000000000111111111111100010100301060001111100000000100101000000000000000110010000010000000000300100111110000001000001101000030603000101011111000000000000600000000
000000000000011111111111111101101000020066111113100005001113100000000001000051100000000010530000000000000101110002001551111110002016600100101111111000000000000660000001
000000000000000000000000000033001313030000400000000000000004000033333330500303330330300003300000000333331030030000000300000030333003333330310000000000000033300330333333
000000000000000000000000000000000000060000000000000000031000003000000000000000000000000000000600000000000000000100000000005000000000000300000000030000000000000000000000
000000000000020000000000000000000000000000000000000000000000000010000000000000000003003000000000000003030000000200000100000000000000000000000000000000010000000000000000
000400000000660000010111100011010010003000000001000011110010101000036600000130000300110010000030110011111003006600000010000011111111010110301101010110111100030160000310
000000000000660000010111111011110000000003000000000000101211000000006600030000000000141100003000501010100000006600000000000000006111110111031011530005011100000000000010
000000000000660000100111111001101110000000000000011001001311111000006006000000000000111113100003003115111000006600000000000000010111111000101111110000111000000000000001
000000000200660000155111110010111110000600001000600001551011111002006600501010001000113114100000010111011002000000000000000000110111111111001101100101111000100010000103
033333333300333000033333333000000010332303000030030000330000000332503300000000000000000000000000013000000003103300000001003000006000003313303330330000000000010053001133
