000000000000000000000000000000000000000000000000000000030500000000000000000103100000000000000130000000003500000000000000000010000000000001000000000050000000000600000000
000000000000000000000000000010000003000000000000000030200000060000000000000000000000000340013000000300000000000001000000000100000001000000000100000000000000000000003036
000000000000000000000000000000050000000000000000000000500000100000000000000300001000001000000000000000000000001000000000000000100000000000000000030000000300000000003150
000000000000000000000000000001000000000000010000000030300000100000000000002000000100000000000233000000000000000000000000003000000000000000030000004002003300000000400000
000000000000000000000000000000000000000000000100000000000200000000000000003000000060000000001530030030500100000000000000000000005100000000000000000003300300000000000000
000000000000000000000000000000000040000000000000000000300300000000220200000000000000000000300033030001000000000000000000000000000000000000000000000003313300000000000030
005335000000000000000000000000000000000330000000003030300000000333053300000000033350000010030330000000000005035000503503300133000500000000000000000333300300000003333333
000000000000000000000000000000000000000000000000000000030000001000051000600000000000000000000000000000000000003000000000000000050000000000000000000000063000000033000000
000000000005000000000000303000005000000000000000000000000005000050003301000300000000000000000005010000000010003000000000003030000050050000000010500010000000000000000000
000000000000000000003000005006000000000000000000000003000000030000005000000000000103000000000000000000000000010000120000000050000000000001030000000001000000000000000000
000000000000000023333000300000000000000333030000000010003000000000000000000000000333000000000000000000000000300000000000003000000000060230306000000000000000100000000000
000000000000000033003000000000000000000003000000000010000000000000000000000000233003000000000000030000000000000000000100000000000000100330030020000000000000000000001003
000000000022020033303000003010012020033303000000000000000000000000003100000003003300000004000002020000050000300000000000000030000220000303600002202000000600000000000000
330003333333333333333333333333330300333003030000300000000000000033304330600333330333000000033333330300033203300300000002133003303333313003303330333330000300000110153350
