000000000000000000000000000000000000000001050000000000000000000000000000000000000000000000000001000000000000000000001000000000010000000010000000000003000000000000000000
100000000003000000000003001000000001000000300000000013001000000000013000100000000000000000010000600304300203001000000100330110300000000000000000000000000100000001000000
110110000000000000000311111011001000000000000000000000000000003000000000033000000000000000005000000060000011311130005003111110000000000001000000000100000000000003000000
000000000000000000000000000000000000000000000000000000001000000000000000333100000000000000001000000101021000000000333000000000000000000000000000000000100000000000100000
000000000000000000000000000000000000000000000003000003000000000000000003033000000300001000001000500000000100000003033000100000000010300000000000000000000000003000000000
000000000000000000000000000000010040000100060000000103000200100000000003033000010300000000000000050003000000000000333000000000100030000000000000000000000002000060100000
000000000000000000000000000030000003333030000003030035330033330000000033333333100633000000000333330000200000000033303600000010030333300000000033333000011030033033333030
000000000000000000000000000000000000000000100000000000000030504000000000000000003000000000100000001000000000000000000000000020000300100000000000000100000060300000000000
100000010000000000000000000000000001000000000000005300100030010100000000000001100000100000000000000000000100000000100011000000100000000010000030010300000000000000000000
000000000000000003300000000010003000000000000000031111403010110100100000000030000000000000000000000003300110310000000000000000000030000001003111150110000000033000000000
000000000000000033300000000000033000001000000000000000000100000000000010000000001030010000000100001001300000000001000000000000000000000100010000000000000000333030000000
000000000000000333300000030003033000000300000000000000000030300000000000110003000000000000000000000333300100000000003000000000000000000000001000003000000003333000000000
000000000000000333300000030003333000000000023000000000000000000000000003000000000000000000000003000303300000100030000000000000000000000000000000000000000001333600000000
333333000333333330333330333330303330030130000000001000000000000000050000000003333000350333033033300030033000000010000000033033100333000000000000000000300033003300000000
