000000000000000000000000000000300300000000000000000100000000000000000100000000000000000000000000000000000010000000010000000000300100000600000000110000000000000000301000
000000000000000000000000000000000003200000000000030000000000000000003000000000000000003010000006001030000000000000000000000000000000000000000200000000000000000000000000
000000000000000000000000000010000606600000000000000030000003000000000000000000000000660000010000200050000000000000000000000003000000000000006600000000000000000000303540
000000000000000000000000000000000006600000000000000000000010000000000001000000000000660000000000000003000000000300000000000000000000000000006600000000003000000000000000
000000000000000000000000000000000000600100300000000001000010030001000000000000000060660000000010000000000000000003000000000000000000000000006600030000000000000000000000
550000000000000000000000000006002000600000000000000000000000000000030000000001000000033000000000000200200000000002002600013000000000000000006600000000000002002000000001
000000333333300000000000000003353330333330000003033333003333000000000030363300000330000303000000003303333303333033033300000000000000003003303303330000000030310303303300
000000000000000000000000000010000000000000000300000000000000000000000000000000000100000003000000000000000000000000000000100100000000000003000000000000000000000200000000
000000000000000000000020000000000000000000000000000000000000000120000000000000000000000000000000000000000000000000010000200000000000001000000100000000000000000000000000
000300000000000000000660000000003200000000000000000000000000000665100000100000000000000300300000000000000000000000055506600000000030000000000000000030000060000000000000
000000000000000000000660000000300000003200000000000000000000000660000000000000001500000000000002000000000300000000000000600000000000000000000005000000000003000000000000
000000000000000000000660000000000000010000000000000000030000000600000000000000000005000000000000000000500000000000003006660000004000000006000000000006020000000000030000
000000000000000200200660000000000000000000300000000000003500300610000002002100300000000000055000000000000000000500000006620000000000055000000000050000001000000000500000
333330000003333333333333333000003000000333001000533330301300003333033033333300000000133130000000030000000000030333303301633300033301001000003313335030000000000030000003
