000000000000000000000000000000000000010000000000000000000003003000100000100000000000000000000000101010000000000000300000000000001000000000000000000000000000000000000000
000000000000000000000000000000000110100000000000100000000000000000100001010000000000000000000000001101000000000600000000060000111101000000000000000000000000002030000000
110000000000000000000000000000300100010103000000001000000000000300000000100000000010000000000000000010003000000000000000033010001000000000000030103310000000003303000030
000000000000000000000000000000100000000300300000000005000000000300000000001100000000000000330000000001000030000000000050030000000000000100003000010000300056033333000000
000000000000000000000000000000000000000000000000000000000000000000000000000000000000000000000000000500000000000000200000030000000000000010000030500000000000333000000000
000000055500000000000000000003300000000030555000003000305550001001000000000000000000000000000000000001000155000000000000330000000002000000000330000001000000030301001000
000000000000000000000000000033303333333303000000000000035500030330333330000330000000001300033036030003330000000000000033331333333000000000003303303000003033003003330333
000000000100000000000000000000000000000000000000000000000000000000000000000030000000000000000000000000000000000000000000000000000000000000000030000000000000000000010000
000000011110000000000000000300000000000000000000300000000000000000100100000030000000000030000000300000003000300000000000103000000000300000000000000000100003000001111000
300000000100000030010000033030000000000600020030000000001100000130400100003301030010100020160301100000330010000011000000000000000033000000001100000500000000000000010000
300000000000000030000000333300000000001000000303300010000000000000030000033330030000000000000300000003333000050000000003000000000333310001001000000040000010000000000000
000000000000000030000003333300000000000000300033000000000100001000000003330330030030000000000300000033333000140300000000000000000033300000000000000000000000000000000000
000000000000000330000033333000000000000100233133000000000000000000001003433330330000000003030305000030330000000100000000000000003033005000000000000005000120303000000000
333333333333333333333333330033300330020000033100000000000000001600000000303053333333000000033033333332300000001000000003303303030000101000000010000000010000000003033033
