000000000000000000000000000000000000010000000530000000000000020000000000000000000000000000110330000000000000030000000000000000000000000300000000000030000000000500000000
000000000000000000000000000000000000000000003000000000000300000010000000000000000000000000000330100000000000000000000000000000000000000330000000001000000000030000004050
000000000000000000000000000000000000000000000000010000000010030101000300030000000000000000000100000000010000040000000000010000000000000000000000000000000000000000000000
000000000000000000000000000000000000003030100600000000000030000000000000000000001000000300000330400000000000003000030050000000000000000030000000000000000000000000000020
000000000000000000000000000000000000000000000000000300000000000000000030030100000000000000000300000500302033000000010002000000000000000300000000000000013043000000000000
000000000000000000000000000000000020000000000010000000000000001000222003010000000000000000000000000100000000000000006200000030000100000060000000000000050001000000000300
000000000000000000000000000033333030000000005000030000000333033333333300000033303333330333333000300000000000000000000000000000001000003000530313033000000033300330000000
003300000000000000000000000000000000000000003320000000000003000000000000000001000000000000100000000010000000000000000000001000000000000000000000000003300000000020000000
003300000000000000000000000030000000030000000300001000000130100000000000000000000000000300000000000100000001000000001000000000010000000000600000000060300000000000030000
000000000000000000000000000000000000000000000000000000300000010000100020000000000000000030000005000000000000000000000000000000000030000001002000003000000000300100020000
003304000000000000000000000000000000040000013304000000000033040000010000000000000000000003000000130000000000000000100000000000000000000000300100000003304000000003003000
003000000000000000000000000000000000000000003020000000000030000030010130000000000010000000000000000000010010006000000000000000000000001000010000000003110300300001000000
000000000000000000000000222000022100000000336000001000000000000000000000000001001000000222000000000000000100000000000000000030040100000000000000000000000000001000000200
330003333333333303333333333300333330000000030003330133303300033000000000000000006000333333000000010040010333333000000003333333333333333133330000000330003300000003330333
