000000000000000000000000000003000030000000001000000050000000003000003000160000000000000000000000010100000000000500000000000000000000000000000000000000000000000001000100
000000000000000000000000000000000000302000000030055000100000000550000000000000000000000000055000030003000000000500000000050000000000500000000000000000000500000000000000
000000000000000000000000000000030060000004000000000000000000300000000000000000000004000000000000000000010000000000000000000100000000000011100300000001000000000000000000
000000000000000000000000000000005000003000002000003000000000000000000000000000300000000000000000000000030000030000000000400000010000000000000030000000000000000002000003
000000000000000000000003000000300000030003000000000000001000000031000000001000010000000000000000000000000000000000000020030000100000000000000000300000000000000000030000
330001111110000000000000000000010000000056300000100002000001000000020200500000000000005000300002003300011000000000000000000000000100000000003300010000000000000000000000
000000000000000000000000000010010003033100002000003333333030300033013300100003333033000010003333030000010033033000010330010000033330003033330000000003303000000000000000
000000000000000000000000000000000000000000000000400000000000000000000000030103000000000000300000000050000000000000000000000000050000000000000000000000000000000000003000
000000000000000000005550000000005000010055000000000000056005005000300000000000050000000000300000000030003000000000010000500003000006000000000000000000000300000005000000
000000400111100000000000000000030000000000000000000111100000000000000000000000011110000000030003000000004001111000000043000000000000000300000011010000000100001000000000
030000000000000000000000000000000000100000000000000000000000000300400000000300030000000000000001010000000000000003000000000000000300001005000000063000003000010000010000
000000000000000000000000000000000000000000000000000000000000001000000001300000000000006000000000001600000030000000000000030010000000000000010000000000000000000000000600
000000000000000000000020020000000000000600111100000000001111400330001100000100000000000000010110001000030030000000000500200000010100003000100001010000360011011000200200
333333333033333333330033333300000000333330000000030003330000000000000000000003003033000000000106105333333330033333333330335030100000000000003103333330033300000003333333
