300000000000000000000000000300030000000003000000000003030000003000000000010000000000000001500010000000300000000000000100300000003000000000000000000000000000003010000000
300000000000000000000000000000000000000000003000000100000000000000003000000003000050000000000000001010000000000000000000000000300000000000000000000000000000000000000000
000000000000000000000000000000000000000000000000000000000000000000000000000300000000000000010000000000000000000100000000000000000010003000000000000000000000003000000000
000000000000000000000000000000000200000000000000000000003000000000000000000000003000000000000000000000002000002000030000000000000000500000000000000000000000100000300000
000000000000000000000000000030000000000000006000050050010000000000000000100000000000000000100000000000030300000004000000000000000010000060000300000000200000000000001030
555500004444000000000000000000000000444000001000000000000000000000000036044000000010000000000010500000030001000000000000000000550300001444000000000000100000000000000130
000000000000300000000000000033333300000030000000000000000000000000030000000330331300000000030330000333063333313000100000030303000004000030300000000333030000333300033333
000000000000000000000000000000000000000005000000000000403000000000000000100003000000000000000000000000001300050000000030000000000000000000003000010030000000030000000003
000000000000000000000000000000000000000000000001030111003003000000000000000000000000000010000000000500000300000000000100000000000000000000003000000000000000300000000000
000000000000000000000000000010000000000000000000000000600000100000000000000000000000000000000000000100000001400000000000000000000000000000000000000001000000000006030000
000000000000000000000000002001000030000400000000030000500000000000000000201000001000000000000000005000100030000000001010000030000030000000000000000000002000000000000000
000000000000000000030300000000000000000000001003030000000000000150103000000000000000000000000000000000000001000000000000000000500003000000000000000300000030000000000000
000000000000000200030000000000000002000010020003005050035055000000003003000000000000000000010000000044400555500000000110000000620003000000001550000000000004400000000300
333330000333333333333333333000303300003300030333000000030000000333033533033300000033003333300000010000030000000001300303333330033333330333000001000303330000000300000000
