000000000000000000000000000003000001000100000100100000000000000000050000000000600000000000000030000000003000000000000000000000000000000000300000000000000000000000000000
030400000000000000000000000300040000003060000000000000003000003000000000000000000000000000000000000304002006000300000000000000060600000010030000300001000000040100060003
000000000000000000000000000000000000000000010000000000300000000000000000000000000100000000000000000000000030300000001000000000603000000000000000000000000000000000000000
000000000000000000000000000000000000000000100000000040000300050000000000000033000000000000000000000000010000000010000003000000000000000300000000000000000000000000000004
000000000000000000000000000000100000000000000000000000014000000000000000000000000000000000300000000000000000030000000000000000000000005000000000000000000000000000000000
000000000011110000000000000000000100000000000000000000001012020010100000010000003161000003000222200000000000000030000000220000000000500000000000000042212000011210000000
000000000000000000000000000031333330000000033330330000005300333333300300000000000000303303333303330300000333000033333033333333333333000000003333001330303300000000000000
000000000000000000000000000000013000300001000003301000000000000000000000030000300000000000000000000010150005000000030000300300000005020000000000000000000000000000000000
000000000000000000000000000000000005006000100000100000000000000000020310000300000000000000000000000000001003000100000000304000000000000000030000000000300000000000000000
000000000000000000000000000000000000000001000000000000000000006000000000000000030010000000000000000001304000000000000000003000000003000000300001000300000005050000000000
000000000000000000000000000010210000000000000000000000000000000000100005000000000000000000000000000000000000000000000000000000000000000000000000000000000000000000000000
000000000000000000000000000000000000000000000000000030000000000000000040000000000003000600100000000000600000000000000000000000000100000033000000000010010000100000001000
000000000000000022220022000000202000221000000111000600003000010000000000000010220000022000000030010001111033000000011110000030002020300000000200001000020000603000100000
333330333333333333333333333303133332303503000000000001000333030000000000200003331313333030330033030000000000000000000000000000030033000000003333333000000033330330000000
