003000000000000000000000303000000000333353000000000601006030003003033300060000010000040301003333330030000000000000001000000000010003000000030330300200000000000000000000
000000000000000000000000000000000000000000000000000000000000000000000000000000000000000000000000000000000000001000000000000000000003000000000000000000000000000000000000
000066000000000000000000000000000030000000000000010001600000660000001000000000000000003000000030000000660000000000000500000000000000000000000000000000000600000000010000
000063000000000000000000000000010000300000000003000006300000630000000000000000000000006300000150000000630020020000032005000010000000000000003000000600000030000000000005
000066000005050000000000555000000000000010030300000006001001060100000000005050003000000505000000000000660000050500005000000300000555003130000060010000000003310000000505
333333333333330000000000033300000003000000100000533333303033030000010033333030500000000033300000303333131333303333333030000000400033000000000000000000000000000503330633
000000000000000000000000000003000000000000000000000000301000030000000000000000103000000000000100000000000030060000000000000000000000000000000000031000000000000000000000
000000000000000333333333330033003000000030050000000000000000030000000033303000000000000000000000033333300000000000000100030050303330003033030333333003001000000300000000
000000000000000000000000000000000000001300000000000000400000000000000000000000000000000300010000000300000100000000000000001000000000000000000000010500000000030000000030
000000300000000000000000000000000000000000100000000000000001000010000001000060610003000000003000000101300000000300001000000660000000000000000000000000000000000000001003
000000000000000000000000000000000000000000000000000000000000000000000010000000030000000000130000000000030000000000000000100630000000000003000000300000063000000000000000
000000003330000000000000000000100000005500000030500000000000550000000001000000000000031313000030061000000000000000000000030660000000100000010051001000006000054000030000
000000000000000000000000000000000300100033000333300000000000333000001000000000000030000000300000100000000000000000030003003303000000000101000000000333333000003330300000
000000000000000000000000003310000330000300000000010000000000000000000000000330000001000000000000010000033000000000000000000001100003300000060000503003000000010000120000
