000000000000000000000000000000100000000000000006000000000000000000000000000130000000000000000030303000000000000030010000330000000000000000000000000000000000200000000030
310000000000000000030003001001000030030001110000000000003000000000000000000000000011310000000300000000030300000001000000000000000000000330103100000000020000001010030010
110110000000050000000000000011011003000000000030000610000000300330000000000000030000610010031100000000000000000010011000300000000000300010001101100000030000000050000000
000000000000000000000000000001000100000000003000000000000030000000000020000000000000000000000003000300005000003000003000000003000220030000000000000003030000000000055100
000000000000000000000000000000000000000000030300000000000333000000000000000000000000010010000000000000000000000000000000000300000660000000000000000033000000000000300000
000000000000000000000000000000000000000000053300000000000333000000040000000000000000000060000000003000004000000000000000000000000060000000300003000033300000000001000000
000000000000000000000000000004000000000000333303333333033333030333303030533000000001000000000000000000000033310300000100000000013036300000000000000033033000000000003030
000000000000000000000000000000000000000000000000000000000000100000000000000000000000300000040000000000000006000000000000000000000000000000000000000000010600000000000015
000000000000000000000000000000000000000030000000001000000010000000002001100000000030000000000300000000000000000000000000000000000003000000000000000100003000000000001010
000000000000000000300000000000000000000000000000500000010000005000000011011030000000000000000000000300300000060000000000001054103000000100000000000000000000000100000020
200000000002000030300000000000000000200010000000000002030000030001110000000000000000000000100000000000000000020000000000330300000000020060000000000000000000000002010001
000000000066000333000000000000000000000000000000000016300000000000660000010000000000000000000000000333000100660300000000330000000000000003000006000003000000000000000040
200000000066000333000000000020000000001000000000000066000000130100000000000004000001010000040000000333000010660010000003333000000100320000000001000000000000000002001000
333333000333333333333333333333313000000000000000000330330000000003300000000000000010333310000000003033033001333000533030533333001000033333300030313000300033330333303330
