000000000000000000000000000000000000001000200300000130000000000000000300000100000500000000000000000000003000030000400000000300000030000030000000000030000000000000000000
000000000000000000000000000000000000000002000003100002000000300010000000000010100000000000003000000000000000000000000000002000300000000000000000030000200000000000000000
000000000000000000000000000011110000100001000000000000000000000000000000000100000000000000050000000000000000000000000611011100003000000000000000000160100001000301000000
000000000000000000000000000006100000000030000000000000000000000000000000100000001033000006301100003000100000000000600000000000040003000000000000000001000000000000030000
000000000000000000000000000000010000000030003000000000300000100000300000000000300000000100000000000000000100000000000000011000000000030000000000000001600000000000500000
000000000001111111000011111120100000520016000022211010600100220000100200101110000111000300210110000000111011111111110002013000000023200002110100122201000000000001101000
000000000000000000000000000000330303033333000230310030003300333033033300500000300000333313300000000000000000000000000003013100330003300000000303333500333000000000000000
000000000000000000000000000000100000000000000000000000400000005000000660000500000000000000000020000000000000000060000000000003500001000000000000100006000400001000000000
000000000000020000000000200000000100001006000020000000000002000000000000000520005100000000100000020000000000200001000000000000000000200000000100500000000500000100000002
000000000000660000000111100000000000000000000001000000000001000000000000100660000000000000000002060000100101100000004000000000000006000000000003000000000000503000000066
000000000000660000000001000000000000000000000010001000000010000000005000000011000000000010000300610000000001030100000001000000000006600000000000010000000000000006004566
000300000000660000000001100000030300000030000000000000000011000000000000300660000000030000000050310000000001100000030000002000000006600030000500060000000000000000000066
000300200200660000222201300000030020000000000001201111112003000010100010200660000000000002200200600000000201000001110110000000101000600030020000002000011001111100021000
333333333333333303333003333033333330000000000000000000000033331000000033333030001000330333003033300600000000003000000003000000033303033303330333333000000005000003330100
