000000000000000000000000000060000000000000000000000000100000000000000000000000000000001600003000000000000000000000000000001000000000000000000000000000000000000000000001
000000000000000000000000000000000000000030100000060000030003000030000000000000000000000000000000000000030000030000000000030000100000300000000000000000300001000000000000
000000000000000000000000000003130000000000100000000000000003000000000060000000000000300003000030300000000100000000000000030000005000000000000000000020100000000000003100
000000000000000000000000000000100000000040000030000060100000003000000000350000300020130000000000000000000000300000000000000000000000066013200000030660012000000000024000
000000000000000000000000000000000000010000000000000000000000000000000000000000010000000000000000010010000130000000000005000000001300066000010000000660000000100000000000
055000000000000000000000000000000000510000055000000000000005000155000032030103000000000000000000000000300000000000600000030000000000026000010000000660000005000000000010
000000000033300000000000000033303050000333000000200033301000330000000003330130000000333310000003330003030331333303333000000333000303033334030000000333333310000000003330
000000000000000000000000000000000000000000000000000000000100000010000000003001006000000000000000000000000000000030000300000000000000000010000300000000000000030000000000
000000000000000000000000000000000000000001000000000000000000000000030000000000000000000000000000030000000000210000000000000300000000000000100000000000000000000003010000
000003000000000000000020000000000000200000600000000002000200000000000000006000000033010001003000300000000000406000000003000000000030000000010000030000000000000000030000
000000000000000000000660002000000006600023000000000500000600020000000000000000000000060102000000000000000000000000000000000000010000000000000000000000000000000000300000
000000000000000000000660000000000006600000000000000000100660000000010030000030000000600300000000000030000003000000000000000000000000000000000000000000003000003000000000
000000000000000200000660000000001006600300000000002100006500000001000001000000000000660000000030000000000055000000060000000000055000002000000000030000000011300000000000
333330000003333333333333333300000003030033000001333333303333033000031300000003333310333033300001300000010000000000030010000000000003033013330033000000033300000003033003
