000000000000000000000000000000030000003010030000000000000030000000000000000000030000000000000000000010000000100000000000300000000000000000000000000000000000000040000000
000000000000000000000000000000000000200000000000000000003000000000000000000050000000000000010000000200030010000000000000000001000030000000000000000000000100000100000000
000000000000000000000000000000000500001000000000001110000000001031100000000000000000000000000000000000000000330000111000000000000000000010000000000000100000000000000000
000000000000000000000000000060000000000000000000000000621000003000000000000030000000000000000000000000013050000000000010000000061100000000000000100040000000000000000003
000000000000000000000000000000000000000000000000000000000000003000000000000000000000000000000000000000000031000000000300000000000000300000000060000000000000005030010001
000011100000000000100000000060000000000010000000000000100500013000000000000000000000030000000001115000063000000002000000000130000000010000000010000000000000001110000000
000000000000000000000000000001000000000006333330333333333333333333330300000303030333303330300001003033330000000033333333010010333333300000000000000333303300103003303033
000000000000000000000000000000000000000000000000000010000000010000000000004000000000000000030030000000000000000000000030000003002000000000000000000500000000000000000000
000000000000000000000000000001000000120000300000030000000000000000000001000000000000000000000020003000000000000000000000000300005604010000000010000000030000000000000000
000111000000000311000000000000011000010004000010000000000400000000000000000000000100000000000000000000000000001000000303000000000000003000000000000000110003110000000000
000000000000000000002000000300000001000000000010340300000000000000000000000000000003000004000000030000000001000200000000016000000003300000020000000000000000000220000000
000000000000000000000000000330000000000000000000300000000002000000010000000000000000003000000000040000000000000010000000000000000000300000000000003000000060000001110001
020000000000000000000000000302000000003300503000300303000000111500060000000000200000000000000000000001102020000000000010000111000000300000000000000020000030000000000000
333333333333333333333333333333030060000000333333303000010000000300000000000000333330000000003000003300333300333300000000000000033330331333330000000300330333333330000000
