000000000000000000000000000000000003010000000600000000000060000000000000000000000000000000000003010000000000000000000203000000300000001000000000000000100000000031000000
000000000000000000000000000000000000000000000400000000000050000003000000003000300100000000000000000000550000000200000000000000000000000000000000000000000000000000005054
000000000000111000000111111100010100000011100006002000000000000444400010061113000000000005100000001000000100001010000000000100000010000000110100000100000040444401000000
000100000000000000000000000000110300000000000000000000002030000000000000100000000000200000000010303100000000000000000000000000000100000000000000000100000300000003030000
000000000000000000000000000000110000300000000000030000000000001050000000000000100000000000000030000000000000000000000000000000300000000000000000001000000301001000000020
000000000000111100001111444000111005000010313030100010000000000000002511100401100301000001100000000000000110000111006010030000000000000000110000000110000100002010000000
000000000000000000000000000030333330000000000000031333033333333031330100001000000500001000000000000333333000000000000000333333003000000000003330330000000030043333303300
000000000000000000000000000001000300000000000000000000000000000010000003000003000000400000000003000000300000010000000000000000000000200000000000000000000000000000000000
000555500000000000000000000000000000003501033000000000000001000000555000000000000000000000000000000000011000000000000000000051000000000000000000000000000003100004000000
100000000000000001011444444000000001003000011110144440410000000100000000010100000551100000011111130000011444644000010011000001011110044444400000000600100110110110000010
300000000000000011000000000000000003000000000000003000000001000300000000100000000000000000000000000001003000000000110003000000000000000000303601000001103000000000000000
000000000000000011000000000000010000000000000000000000000000300000500000116000001500010100000000000011000000001001110000000000100000000000000300000001000000000000001000
000000000000000011000000022100000000000000110430000002210030000000000100110000000010000000011144400001000010022100115000000000011444010000210000000001500001144400100001
333333333333333333333333333300004003010333000000030033000000000033330333030330000000333333000000003331313003333303333333033330000000033030330000000313333300000000000000
