000000000000000000000000000000001000000000000000000000001000004000000003000000000000000000000000060000000000050000000000000300300000000300000000000000000000003000000000
000000000000000000000000000000000000300000000000000000000300000000000000000300000000000000000500000000000000000000003000000030000000002000000000040000000300000000000000
000000000000000000000000000000110001000000000000000000000100440000000064000000001000000044000000036600000000000005000000000000040000516000500040100000003000000000000000
000000000000000000000000000000000000000000300000000000000002000000000000030000000004003000000000006600020300200030030000000000000000066000200000000030500500200000000000
000000000000000000000000000000000000320000000000131000000000000000000000000000000000000000000000001001000000300000000000000000000000006000500010000000000000000000001300
200000000004004000000000000000000310000400400000000000000000000200100000500004003000000000000000006000000200000001004000000000020010066002100000000000000020000040300000
000000000000000000000000000033333330601000010000000000003303333000000033330030000000303303333333363303000000000300000003333303333333330330013303333000000000000100000000
000000000000000000000000000000000000100000000000000000000000000000000003000000000000000010000000000000000000000000000000030010000003000000000000000000000000000400000000
000000000000000000000020000002000001000000000000000030000200011000000000000000000006000000000000003000000000000000500000000001000000000000000000001000000000000000200000
000000000404404400000660000066000000000000004004144000006100000000100000000000000000000000040000000000000000000100010100000030000000000404100000000440000000000306600620
000000000000000000000660002006000000000500000006000000006600020000000000005000000000001000000000000000000000000300000000006004050000000000000000000000000010000006600020
000000000000000000000660000060000000000000100600000030006606000000000000015000000000000000000000000300000000000000000000000030003000000031000000000300050000000006600000
000000000000000200000660000066000000000110000000002000006600000000300000004000000000600300002000004000000060000000000000000000400000000000000000000020000000000006600000
333333333333333333333333300033330000000000030033333033333330300333330011001000000000000001133033330000000000000000000003000050000000033333333300330333033000000003033000
