000000000000000000000000000000000000000000000000000000000000003000000000000000000000000000000000000000000000000301000100000000000000300000000000000000003000100030000000
000000000000000000000000003000003001000000001003000000000000000030003000000000000000000000006000321331030000000001000000006000000003000000000001000000000000000001300000
000000000000000000000000000010000062000000000050000000000000003050000000010000000000000000000000060000000003000000006000000000002000000000000003000300000000000030000000
000000000000000000000000000000000660330000000000010000001006000000000000000000000000000000000000660000000000000020400000000003000040600000000000002000000000000000010000
000000000000000000000000000000000060030100000000000000000005000000010000000001000000000000000000660000000000000030000000000000000000000000000000000000060300000130000000
000000000000000000000000000002101000335002000000000000200000003000000003000000000000000000002000060000000000002000000000000020000000300000000000000003002003000030300000
000000000000000000000000000033333033343333001000030333330030303000010010000030001103000000030134030000000033333300000003330330300030300030004000000303331330003300000000
000000000000000000000000000300000030030000001000000000003000000001000000000000000001000000300000000000000000000000000000043030000050000000000000010000000000030000000000
000000000000020000000000000000010010000000000030000000100000300000030040000030000002000000000000000100000000000000100300000000000000000000000000000000000000030000030002
000000000000660000000000000300000000000000000000000001000001000000000060000000000063010000000003000000000000000303000030000000600006600010000000000000000000000000000036
033000000000660000000000000000000300000000000000000000000000000033000000000000000066000000000000000000010033000000000000330000006006600000000000000300000000303000000000
033000000000660000000000000000000000000030000000030000000001000030000000000003000006000000000003000000000030000000000000230000000006660000000001000000500003300000500006
033000202000660000020000000300000000000000000000000000000000300033000200000000200006050300300000000000000033000000030000330002000006600000000000003001000100300010000060
333333333333333333333303033330303330000000000000003000600033313333533300000001333303303030303000000000000333033300000003333133530333300000000000000000000033532330033333
