000000000000000000000000003000000000000000300000000000000000600033000004000300000000010000000000010000000000000000000000000030000000003300000131350033000000000000000000
000000000000000000000000003000030000000000050000000055300005500000500000000330000001000010000000000060500000003000000000000030000000500000000000030000000020003000000000
000000000000000000000000000030000000003000000000002100000200000000000000000010000000003303300000000000000000000000000000030000003333300000000010000000000400100000000000
000000000000000000000000000005000000001003000000060000006000000000300000000000003000000000000000003000003000300000000000000000000000000120000000300100040000000000000400
000000000000000000000000000030000500001330000000060000006610000010000000300000000000000060003000000000000000000040000000000000000000000000010000000000003000300000000000
555500000000000002000000000000000005555050000000066000006300000000000000000000002000000000005500000001030000000000000100000000000000000000006000000000100000000000000000
000000033333300000000000000000333300000000000000033000000300000030033300000003000000000000300000000010000000000000000000000000000000004033330003001000033310300300000000
000000000000000330000000000000000100330060000003000000010030000200000000000000000000003100000300000000030000000003000005000000000000000000000000000000000300000100000000
000000000000000000000000550000000000000000000000000100000000000000000000000000000000000000000000000005500000000000000000005500000000000001100000000000550000000000000000
003333300000000000000020000000333100001000000000000001000050000000000000000303033033000000000000000200010000000000000000200000000100010000000000300000000000033330600000
000000000000000000000660000000000000000000000000010000000000000000000100000000000000000000000063000601000000003000000006600000013000000000000000000600060000000000000000
000000000000000000000660000000000000000600001010000000006001001010003000000000000000000000003000006651000000000000000056600350000000000000000000030630000000000000000000
000000000000000000000660000000000000000000000000000320000100000500601000004000001000000000000030003600003000000055540006600001303050000020005515000650000001030000002000
000000000000000003333333000001000000003330000000000000003330300000100000000000000000000000300033313330003333333000000000330000330330000000000000000363000000000000000050
