000000000000000000000000000003000000051000000000000000000030000000000300000000300000000030000000050003002000002002000000300003000502000000500006000300000000010610000000
000000000000000000000000000002000000000000000000100000000000001020000000000000000000000000000000000000000020000050000000000000000000000003001200000000000000000000000100
000000000000000000000000000061000000000000100000030100000001000060000003000000000002000000000000000000000060300000300000000000005005060000206600000000003000000001000000
000000000000000000000000000063013000000000000000013003001030000000000000000000050000000000000000000000000660000000000000000000000010002000006104000000000000000000000000
000000000000000000000000000066000006000000006000000066300000000130000000060003000000010000000120000006010603000000000000040000000000066000006600000000000000000000000000
000000000000000000000000000066000006000000000000200006000000000600000000066000005002000000000000030106604660600000000000010000000000060000006000000000100300000000000002
000000000000000000000000000031330003033300000033353303030000000333030333333030003031000000000001003033303033033300000000600000000000033333003133033000000001000000003330
000000000000000000000000000000030000000000000000060035000000000000000030000000000000000000010000006010000000000000000020000000000600000000000000000010000000000000000000
000000000000000000000020000000000300000000000300000000000000003000010000000000000000000300000000160000000000004000000000000600000000002000060000000050000000000000001000
000000000000000000000660000000000000000000000000000000000300000000000000000000051000010000000100000000000000001000000000000033040000066000000000010060000000000000000000
020000000000000000000660000000000001001000006000000000000000000000000302000000000000130000000000000200000000000000100000000000000000066300000000000020000000105000630000
660000000000000006600660000000000005000000000000000000000000000000000066000000000600030000000010006600000000000000000000006000000020066200000000000360000000061030000000
660000000000020006600660000006000000000000000000002000003000000000000066030001002300000000000000026000000000100000000020601632006000060000000000000660000000006005000000
333330000033333333333333333300001000000000000100000000300500000000000003033000000000000000000033333333300600100000030333333333000000033333330000000303330000333030001000
