000000000000000000000000003000000000000000000300003000000000000000000000100000000000000010000000000000000000000000000000000000000000000000000000000000500000000000000030
000100000000000000300000000000000000001300004001000003100000000000000003105000000300000100100000000100000000030000000000000000000100000010000000000000000000503000000000
000000000000000000000000000060000000001000000000000000000000000003000010000000000000300000000000000000000000000000000000000000000000000000030000000000000000000000010000
000000000000000000000000000000000000030000300000000000000010000000003000000000000000000000000000000000000300000020030000000000300003003000000000000000000000000000003000
000000000000000000000000000010000000000000030000000003000000000000030000000000500000000000000000000000000000000000000000000000003040000000000000000000000000000000000000
000000000000000000000000000030000000000000003300000000001000010000000000000000000000300000005220010200020000000000000000222200000001000000030000000122000000000006000000
000000000000000000000000000000000000000000333330000000003333300000500030313001000000000000033333333333533000000010333103330333000000000500003333300300030306000000000040
000000000000000000000000000000000300000100000004000000000000000000003000000000001000000000000000300010000000000000000000000030000000000000000000000000000000003000000000
000000000000000000000000000000000000000000000000010010000001000100000000000000000000000030000000000000300000000000006000100000000030000000000000000600000000000060000000
000000000000000000000000000030000000000000000601100003010000000000000030000000300000010000000000000000000000000030000600000000000000000001100000010000000000360000000000
000000000000000000000000000000032000000000000100000000500000000000000000300000005000000003000000000000000025000000000000400000000000010003040000000300000150000000000000
000000000000000000000000000000000000000000000000000000010000010001000000000100000003000300030000000000000001010000000000000000000000000000300050000000005000000010000001
000000000000000222200022002000000000000300300020002000200030300000000005200000022200000000000000000000000000000000000000000300010000102230200222200000000000000000000000
333330033333333333333333333300000003331333333033333533333000000000010303033330333333030000000000000333005333301333333300000000000000035003330333033336033300000000000003
