000000000000000030000000000000000000030000001000000000000000000000050030300010001000003600303000000100000003000000000000000000000001003300000000000000000000000001010001
000000000030000000000000000000000000000200000000000000000000000000300000000000001000400000000000000200000000000000000000003000000000000000000000020000010000000000000000
000000000000000000000000000001000000000000000000001000000000003000000000000060000000000000000000005600050000000000000000000000000000000000000000000000003000003000000000
000000000000000000000000000000001000000000000000000000003000000000000000000100001000000000000060006000000003003000000600000000000000000500000000000000000000000000000003
000000000000000000000000000010000661000000300000010000000000000000300100000000000600040051003000600000000000000400000000100000000000000000031000000020030000000010000000
114444400000000000000011100000000666000110114004500001000104024000000200000000111000000000000000066600000104441411444030000000030000000006000000000114404400000000110000
000000000000000000000000000000003330000100000063030333000000000001000010000000000000000000001003303300310000000000000010001003000000001000000000000000000133205000000000
000000000000000000000000000000000030000000000000000000300000000000010000000000000000010000000000000000000000000000000000000000000000100000300000000000000000000000000000
000002000000000200000000000002000000003000000002002000060200000000000003000230000000000000000000000000000000000000000100000000000000000000000000005000000000000000000020
331100000000006600000000000000000000005000331101060001006600000000000040100600100000030010010000000001000000010066000010000000000000033310000000000666000000010003310000
000000000000006600000000000000000050000000000100066010000600000050000000060000000000000000000060000000000000300000000100040300000000000000000000000600000000000000000000
000000000000006600000000006600003000000000000000066000006000000000300600000000300001000000000000000004000000103066000001600000000006000000000000006660000000000100000000
000000000000006600000000006600110000000000000000032000006000400000006600020300000000000000000000000010000011100000000000000020000016000000000000006660000000000300000000
333333333333003300300000033300050000000000033330330033003000100000033033033336333300035333033030000300500000000033001003033300000013333300300000300330000000000000333030
