000000000000000000000000000000000000000000000000000050000060100100000003000000000030000000100000000000000000000001003000000000003000000000000000000000000160000005001303
000000000000000000000000000030300000000000000000000000000000000050000000000000200000000000000000000000010300400005000000000000303010000000000003000300000000000000000000
000000000000000000000000000000010001000000000000066000000000000100000000000006600000000000000000001000010000000000000030000000000000000300000130310010000000000000000030
000000000000000000000000000000000000500005000000066000000000000010005000000050600003003000000000000000000000000000000000000000000000001000000000000000000000000000000100
000000000000000000000000000000000000003003100000066000100000000001000010000000600000000500003001000000000000300000000000000000000000000000000000001300000030000000000010
000000000000000000000000000000000000000000030000066000000103000000100000000000000000000000000000001300000000000000000000000300030000000000000000000030000000100000010001
000000000000000000000000000000000000000000033233330033310033333000000033033333303333000000000000000000000000000003130003033333303033341000000000000033030300000100000030
000000000000000000030000000030000000000000000003000000300000030000000000030300000000300003000300000000000000001000010004000033000000000000500000000000000000000000000030
020000000000000000330000000000000000000000000000000303310000030100000000000000000010000031000000000200000000000000000000000000000000002000000000000000000000300003000330
660000000000000000300000000000000000000000300000000000000000300000000001000000000000000000000000006600006000000000000000000303000000060000006600000000000000600030000000
660000000000000033300000000000000060000000000000000333000033300000000000000000000000003330000000000600000000030010003000003300000000060000006500003000000000030300033300
660000000000000333330000000000000001000000000000003335300333030000303000000000002000033333000050000600000000003000000000333300030030006000006000000000000000011000333330
660000000000003333330030000000003000000000010000033333003330300000000000000000000000303333000005000600003030000030000103030330000000006000006100000000000100000003333330
333333330333333333300333333330333030000000000000030330003533300100010000000000000000033300030333333330331303333300001003106000030000030030330130333000000030303333033303
