003000000000000000000000000000000300030000000600100000000000000000003500000000000000000000000300000000000003000000000000030000000000000000000500000000000000010000030000
303000000000000000000000000000030003030100000060000000000000000030100300030650000000000000000000000000000300000005030003010000000000000000000004000000000000000000000001
300000000000000000000000000000000003000000010010100000000000000333331600000000000000000003000000005333000300001001000031000030000000000000000333000000000000000006333200
000000000000000000000000000003000000000000000000000000000000000330000000300000000000000000000300003500000001000000000330003000000000000000200003000000000000000003005000
000000000000000000000000000000000000000000000000030000000001000300000000000000000030000000000000003000000000100000000030000000000000000000000000001000000600000003001000
500000000000500000000300033000000005000000000003001000500010050300003030000300000000000065000000303000030500000000000030000000310033000000300003000000000000000003000030
000000000000000000000000000033033030000000000000000000000000000000000000000050000000000500000000000000000000003000033030000000000000033305300000000333033300000000000100
000000000000000000000000000000000000000010400000000001000000000000000000000000030000000000000000000000000000000301000000010000001100000000000000000003000100000000000000
000300000000055500000000000000003000000000050000000000000003000500000055000003030000000000055000000103001100000500000000000005010000000030000000000000000300100003500000
000000003330000000003333300010000000530000000000330330000000000033000000000033000000000000000001030200000033000030330000333000010000000000000001000300300000000100000003
000000000000000000033300000000000000000000000003330104000000000000000003005030300001000000320000030000000000000030000000000000000050000000000000000000300060000000000033
000000000000000000003300000000000000000000000000300000000000000000000000000030000000000000000000030000000000000030000004000300000000003000000000030000000000000000000003
000000000000000000003300003000000000000000000000300003000000000000020000000055030000000006000000030000000000010030000300000000000000000000503000330300000000000500000033
333333300000000003333000000000000001060000000610300000003333303030400030033030030000000000000033033033333000000000000000000000000000000000000000000003000000000000003003
