000000000000000000000000000000010030000000100000000000030000000001000000000000000000000000000000000000001000000000000000000000002001000000000000000100101010300000000000
000000000000000000000000000000000000000000000004000000300000000010000000000000000600000000000000000000000000000001000000100000000000000000000600000000000000000000000000
011111000000055000000000000000000055000000010111000000000000000000000501000000000000000000501011100000000000003000000050000000011110050000000000305000011050000000000000
000000000000000000000000000000001000100010000000600200002300003000003003003030000060000000000000000000030200000000000000000300000000000000000000000000000000000000000000
000000000000000000000000000000001400000000003000000000050000000000010000033030000010000000000030000000000000000000000030001300000000300000100010000030000000300000000000
000000000000000000000000000000000000000000000000000000000000000003000000031000000000000000004300000000000000000000100000003330000000000000000000000000000000000000000001
000000000000000000000000000000000000500000000000000000003333310000000033333310000001000000000050003030000333333000060003303303300000000000130000000000000000000000000000
000000000000000000000000000000000000000000000000000000000000000000000000000600000000000000030000000100003100000000000000060000000000000000000000000005000000000000000000
000000000000000000000000000000100000000000030000000000000010000000300000030000000000000000000000000030000001030000001000000000103000000000000000000000000001000000000000
000000020000000003330000000000000031000000000000000033305000001200000000000100111110200000000513300000000000000000033302000000000000003000000006000000000000010000003330
200000300000000333300000000000100030130100000000003333000000003000000010333000000000003000000000000000000000000003333000000000020000020000132000003100000000000000330300
000000000000003333330000330000000000000000000330030333300000000000000003332000000000000001033333300001300000000033333010000000003000600006000003000000000030033003033330
000000000000033333300000330000000000000000000430010333000000000000030033330030005000000000333333000003300000000133311000000103100000000000000000005010000301033003303300
333333000333333333333333333333333300033333033300333333300000000000333333333030000000003530330033333303333000000003030330003333000000003333303033330003130331103330333333
