000000000000000000000000000000000000000000000000010000000000000000000030000000100000000000000000300000000000000000000000100030000000000000000000000000010000000000000030
000000000000000003000000000000000000000000100100000030000000100000000000000000000000030100100000000000000006000000000030000060001000000000000000000000000000000000004000
000000000000000000000000000000000010003000000000000000000000000030050000000000000100000000000000031000000000000000000030500000000000000300000010030000050005005000000000
000000000000000000000000000066000000000101000000000000000000000000000100000000000000660000010000005000200000000100000000000030000060000000000000000000000000000000000000
000000000000000000000000000066000000000000000000000000000000003200023000000000000000030000016000000000000000000360000061000000000000000000000000000000010001000000000000
000000000000000000011111000066000000000000000000000000100000000000003011100000000000660000000000000014000000000000000301110000000000000003000100000000006000300000000010
000000000000000000000000000033000003333033000000006302003330033303000000300600003030330000000000000000100003001000000000000000130333500030000000000333003000030000305000
000000000000000000000000000001000010100000000003000000000000000000000004000000000010300000000000000000000000000010000000000000000000000000000000000000000000000000000000
000000000000000000000000000000000000000000000000300000000000300000000000000000000000000000000330000000100000000000030000000000000000000000003000000000200000000000000000
000000000005000000001000000000005000000001004000000000000000300000000100010000000001001000000000001030500000030000000000000001000050000000000000000000000000010000000001
000000000000006600000000000000000000000100400000031000060000000030000000000066046000000000000000030000000000000000030000600000000000000100006600000000000000001000000000
000000000002306600000000000001000300500000000000000050000000000000000000000006600005000000000140000000200000000030000006600000000023001000006600000100000000010000000000
000000000000306600000000000001000100000000110000000000000000000000000000060106600005100000000000110000030000000001000110600000000003030000000600000006000000000031110000
333333333300303300000003300030300000001000000000060330000005000000000000000003300001333333310000003330030000000000000003300000333003000000003301000000500233033330000040
