300000000000000000000000000000000000000000000000000000000000000000000010000000000000001000000000000000000105000000000003001300510000000000000660000000000000001000000000
000000000000000000030000000000001000000000110000000000010000000000000000000000100000000000300010000000000000001000030000000000000003006000000000000000301000001000000010
000000000000000000001111111100030114004440000020000000001111101000030000000000000001400004004111100000000000000000002010000011000000140044400000000000000111111110300200
000000000000000000000000000000000030000000000660000000000030000000000300000001000002300000000000000000000000000001166000000000000000000030300010003000000000000000006600
000000000000000000000000000000000000300000001600000000000000000000000000000000100000000000000010000000000000000200000000000000000000000000000000006003000000600000006630
000000000000000000000000000000000000000100000660000000000000000000000000000000010000003000000000000050000000000000466100000000000000310000000300000000000000000000006600
000000000000000000000000000000333332343333351003300100000100000000000000000000300000333333300000000000000334333333333330353013000050233333300000300330303300030100303133
000000000000000000000000000000000000010000000000000000000000000001000003000060000000000000000030003000000000002000000003060060000050000000000000000000000030000006000000
000000000000000000000000000000006000300000000000000060060010600001000005000000003000030000000000000000030000003000000000000000000000000001001000000000000000000300000030
000000000002000000011400444000330000000001000020001110110000000000020000001114004440050001100000000000000010003101101110000000000000000000004004400001000600000000000021
000000000066000000000000000004000003400000001000000000000000000000660006000040000100000000000060000000000000000000100010000000000000000000000000000000000000000000000400
000000000066000000000000000010000000010000000000000003101000000300660000000053000000000000003066000000000000000000000010000000000000000000000000000000000000000500000000
000000000066000000000000000000000000030000000100000000000010000000660000000000000030000000300066000300000000010000000000000000000000000000000005003000000000000000000001
333333333333333333333333333303303330000000000010000000303333330311333303333303033333013333133313330000000000000000000000000000000000033333333330333303330300000000003000
