000000000000000000000000000000010000000060060000000000000000000000000000000000000000000000000000000000000000000000000005000000005000001001000000000000000000000306000000
000000000000000000000000000000000000000000000000000000000000003000000000000000001000000000000000000000000000000000030000000000600000000300000000000000300000003000000000
111111110000000000000000000000003100000000000003000000000005000201000100011111000010000000000000002211030000000000010000000000000010110101001000000001100000000000000000
000000000000000000000000000000000010000100030000200000330000002000000005000000000000000000000000000000000000000000000030000000600000000000030000010000000000100000350000
000000000000000000000000000000000000000010600000000000006000000000006000000000000000000030000000030000000610000000000000001000000000000000000000000000005000300000000000
000000000000000000000000000000000010000300600000000000006000000000000000000000000100000030000000000000000600060003000000000000000030000000000000000000000000100301000000
000000000000000000000002000000000013333333333303300030000303000333033300050000000000330030300000003303333300033033000300000000333333300000005030000333033333333330000000
000000000000000000000000000000000100000000000000000000000000002000000000000000010000000000031006000000000000000000000000000000000000010000000000000000000000000000000000
000000000000000000000000000003200000000300000000000000000000500000000000000050010000000000000000000000000050000000000003000000000000000030000030000000000130000000000000
000000022110000000000000000001110110000000221100610000000000105000000000000000000000005000011111011000000010000000100000000500101100000000000000000000000001011110000030
000000200000000030000000000000000000033000000000000000000030000000000005000000000003003000000030500000010000000000000006000002000030000300000000100600300000000000000002
600000000000000030000000030000600000050000000003000000000000011000030000000000301000003000000000000000030010000300000036100000000000000300001000300000030000001000000000
600000000000000030000000030000000000030100000300000000000033300000030000000000000000003000060000000000000000000020000006000000000000000300000000000000000000010006000000
333333333333333333333333333300300003033333330333300300103301030333330503010000000000330313303000000000000003000000000003530033000000033303330000000303333300000003303300
