000000000000000000000000000000000300000000000000000000100030000000000000000000000000100000002000000000006000100000000000030000000000000000053000000000000000000000000000
000000000000000000000000000000000000001000000100000000013003000000000000000003100000000000000000000000000000103000020000001000000000000000000000000000000000030000030000
000000000000000000000000000000000003000000000002030400000000000004000000000000000000000000000400004300000500000000000000000011440300000000003001000410000000005000000000
000000000000000000000000000000000060003000000003000000000000000000000000400000000000000010000000000000000000000000130000000030000000000600010000003000000000000000000100
000000000000000000000000000000000000300000000000003030000000000000000530000000300000050000000000000000060000000000000000000000003010003003060000120000000000000000000000
000000000000000000000000000000000002000000000003010030500000000000005500001030000000000020000000502000000000000000000000000000000000001000300000000200000000300330000000
000000000000000000000000000000000003333031303130030003330000000232133030330331010000000000313333303333333000000000000001000000300331300000000000000333035303330330000000
000000000000000000000000000010000000000000000001000000000000000010000300000001000000000030000000000010010000000001000000000000030000000000000000000000000000000006003000
000000000000000000000000000000000500300000000000000000000000000000000003000000000000000000000000000000000000000100000003000000000000000000000000300000000000000000000000
004000044000000000000000000000001000000000000000000000000000000040000000000000000000000000000000000001000000000000410000000000603000030000000150000000050100000000100000
000000000000000000030000000006000000000000000000000000000010010000010000000000000000000000000000000103000000000000010000000000001050000000000030100000003000000002000500
000000000000000000030000000000000000000030000000000000000000000000000030000000000000000003000000000000000000000000000000000000001561000000000000000100003000000000000000
000005520000000000030000003300000000000000000100300000000000030000000000000001000000001000000000000000000000003300000550000030000003000000000000050000003000000000000000
333333333333333333333333333300000000430000130330000500103333303033103000000000000000333333300005000003030330350016333333303633333333300000003303330330033100100010000000
