000000000000000000000000000020000000000000000000000000000000000000000300000000000000000000030000000030000000000000000000000010000000003000000000000000000000100000000000
000000000000000000000000000000000000000000000000000000000000000000000000300000000000000000000000000000000000000002000000000000100000000000000000000000000000000500000201
000000000000000000000000000010000000000000000000000000000000010000301000360000000100100010000000000330003300000001000001000600000200000000000000000000000000000010002300
000000000000000000000000000005000000000000000000000030000000000000000000000001000100031101000000001000003000000050000000000000006600000000000000000300000000000000066000
200000000000000000000000000001010000000000000000020600000000003000000000000002001000010003000000003330003010050021000000060001066600000000000000000000000000006000066000
000000000000000000000000000000000000003000000000000000000000033000000000000005000000300000000000001330003000000000000000000000006000000002310316005010000001501000066300
000000000000000000000000005000000040133333000000000010300200313000000000000500000000103105003333333030033000000000000000020050034030000000000040000000055033330303330300
000000000000000000000000000000003030000000000000000001000000000000000000000000000001000000000000000000005000000030000000000000000000000000001001000000000000003000000000
000000000000000000000000000000010000000000000000000010100500000000000000000000000002000000000000000000000000000000000000000000000000000000200000000001000000000000000000
000000000020000000000033000303000030002100030300000000000002000000000003100030000000000200000000000000000000006000000000000000010000000000001000000300000000001000331003
000000000660000000000333000333300030066000000060305000000060100000000003300030000000000000000000000000000000000000300000000000303000300000000000000600000000000000330003
000000000660000000003333000353300000066000000000000004000006000001000033000030000000006000000000032000000000300000000100001000103000000000100000003200000000000011300003
000000000660000000033333000333300030066001000003000000000066000000000033300000003000001600000000300000000000000000000300000000333000100000000000033000000000000003030003
333333333333000333333333003300300033330300033303000000003333300063303330300000000000030000003330000200000300000003133302333601300003300000003333334101000030000000330001
