000000000000000000000000000000000000200000000000010000000000000000000000000000000000000010001000000000100000000000000000000000000000000000000000000000000000000000000000
000000000000000000000000000000000000000000000000000000000040000000000600000000000000000001000000000000000100000000000000000000000000000000000000000000000000000103000000
000000000000000000000000000000010000000000330000044001003100603000000003001000000100020000344000000030000000050000000000200000000000033000000100001330050000000000000000
000000000000000000000000000000000053010014010000000000006600000000000000300000000000600000000000000000000000000000000000000010003000000000003000000000000000000000000000
000000000000000000000000000000000000060030000000300000006600000000000000000030000000660000000006000000000000003000000006000000000002300000030600000000000000000000000000
000000000000000000000000000020000303300000000000100202206600000001000050001061000000603000000203200100000000000000000000000000000000000000006600005000000623000000000000
000000000000000000000000000033333330000010003333333330330330000000000000330332030000343030031333330000000000000000300003333200300000000633333330300003133033103330101000
000000000000000000000000000000000000000000000000000000000000000001000000000000000000000000000103500000000300000050000000010000600100010030000000000000000060001000000000
000000000000000000000000000000003000000030000010000500000000000010000000000004000000000000000300000101100000000000000030000000000000000300000600000000003000001000000000
440000000000000200003330000000000000000000020000000000000400000000000000000000000000300000000000000000000000000044000000000000000000010000000400000300000100000000000000
000000000000006600000000000000000050000100611000030000330000000000000000300000000000030000000000000000000000000040000000000000000100000003000000000000011000010300000000
000000000000006600000000000300010000000000600000000000000000000000000000010000000000000330300000000100003000010000000000000100000000000000010040000050006000000000000010
002022022000006600000000000600000000000030663000000000000020020020000001003010000000000000122000000000000000003000200200200600000000000010000020200000000000000000000000
333333333333333333300003333300000000000300333330000003003333303333330301000000000000000333133330350000000000000033330030340333000000000000003333303000000000000100000000
