000000000000000000000000000000000000600000000000100000000040000000000000100000010000000000000000040000000000000000000000000000000010000000000000001000010000000000000010
000000000000000000000000000000000001000000000000000003320000000020000000000601000330000000000600000000010000000010000020000000100000000000000220000000000000000000300000
111100000000000000000000000000010000000001101000000000300010000530000000000001000200001000320000000000000000000030010002010000000000000000003300100110100000000300000000
000000000000000000000000000000000000000000000000003300020000000030000000000000330010630000005000603003000000000000000100001000000050000000000300000000000000000000030000
000000000000000000000000000000000000000000100060000333000000001330000000000000003330660000000000000030000000000000100000000000000000000050001000000300000000000000000000
000000000000000000000000000000000000001230000000030303000000000030000000000000303300603210000002000000000000000610000000000020000000000004001300000000011000000000000000
000000000000000000000200000000030300000330000000033330032000000033333320000003333303303303330333032000000000000000000000033333200000000000000330303030100020000300000000
000000000000000000000000000000005000000000000301000000060000000000000003000000010000000000000000046000000300000000000000000000000001000000000000000000000000000000000000
000000000000000000330020000000500000200000001000000000000100000000000000000000000003000000000003100010000020000000000000000330010000000000003000000003001000000000000030
020000020000000000300330000000000000300000000000002000000003000111100020000500000000000000100003000101000330000010110000003300300010001000000000000200000000000001000003
660000000000000333300030000000000000100000300003066000006600040000000000040000000000000000003333000030000030000000000000333300030000166000030000000000000006000000003300
660000000000000333300330000000000003303000000000066000006600000000000000000000000000000000003333000000000300000000000000333000030000066000000000600000000066000000333300
660200000002203333300330000000000003300000000000066320006602000000000010002200000000000000030300000010000330000000000503030300330000006020000000000000002060020303033300
333333330333333333303333333320000000333003000000033033330533333000000030333330000005000000033003030000000333003300000001333003330333310333000000001003300033130033333103
