000000000000000000000000000000000000000000000000000000000000000300000000000050000000000000000000000000100000000000010500000000200002000000000000000000000000600003000000
000000000000000000000000000000000000000000000000000000000000000000001000000000000060010000000000000000000000000000000000000006000000000000000110000000300000030000000000
000000000000000000000000000000005013303001003001010000010000003000000030030010000060000000000003033303000000001000000000003333000000010003000000000330000000000030000000
050000000000000000000000000000000000000000050006010000100600000001300100000000000000006000001000000000000300000000000000000000000000000301000300000001000002000560500005
000000000000055002000000000050120000000000000000000000000002000000001040000000000000000000000000000000000000000000000000000000000000500000005052100000000010000000000000
000000544400000000000000000000000000000000000000500005300000000444000000000000500000000023000003000000000000000000000000000000044000000000300000000003000000000030000005
000000000000000033330000000003333300000033000000030313000031330500000000000303333000030333330330000000030000000000300333333000000000000313030033030333330500000000000000
000000000000000000000000000000000000010000000003000000000100000000000000000000000000003030100000200000000000000100000003000000000003000000000000000000500000000000000000
000000000000000000000000000000000000000100000000000000000000000000000000000050000100060330000000000000000000000000000032000000000300000300000000010000000000000000010000
000000033330011000000000333300000001003033000000000000001000300000000001000000003233000150100000000000100000001300011000000000333610100050000000333303300100000006300000
000000000000000000000000000000000000000000000040000000000000100000000000000005000001050000000030001000000000000000000000000000003000005000000000000000000000000000000000
000000000000000000000000000000000010000100000000500000000000000300000001005001000060000000000000000000001501200000020000000000003000000000000000003000000000000050000000
000000000000000000030000000000000000003000044000000000000000030000000500060000000003000000504400000000000000400000002000000000000000000000000001000010000004401000000030
333330000000333333333333300000000003333000000000033330003333333000030000003000353000000000000000003300300003333033330000000000400000000000003033000100003000003000333333
