000000000000000000000000000000000001000000000000000000000000000000000000000010000000000000000000000000000030030001000001050000000000000000000000000000050000000000000000
000000000000000000000000000000000300000010000000500000000000000000000000000000000000000000000000000030000000400000000001000000000000300000003000000100000000000000000000
000000000000000000000000000000030000000000000004000301030001020000030000000010000000060000000000000000000000000000000000000000000100000000000000000000000000300000000000
000000000000000000000000000000000000000000000000000300030030031000030000000000000000000300000000613000000002000000003000000003000000400000000000000000000002000030000000
555000000000000000000000000000000000000000525000003000000000003000003000000000400001000000000000000000300066000000000000030000000000000000000200000000000000000000003003
000000000000000000000000000000000000000000000001000000300000003000030000010000002000000000000001001600100066020000500000022020000002300006000000030006020000000000000023
000000000000000000000000005533303330000045000300000333330133333030000300003550330333000000000100000000055331033300000003330303333323100000050000000333333000000553330333
000000000000000000000000000000000000000030000000000000000000003000000005000010000000100000030000000000000030000000030300000000000000000000050000000000000000000000000000
000000000000000000000000000000000000300000000016000000303000001000000000000000000000010000000000000010000000000000000000000000000100000000000030000051000000000000300000
000000000000000000000003000300000000000000010000000000000000000002000300000003000000100000000000000000100000010000000000003004000000000000000030003000000000000000000000
002000000000000000000003000300000000011000000000000000000020000003030300000000100000000000000000030000000000000000000000030003000010000200030030003000000000000000000000
066000000000000000003030000300000000000000000110006600000600000050000055500000000010005000003000030000003000003300010000300004555103006000000100003000000055500000001000
066020000220200000023000303300031000000000000202031000000000200000303300003000000020000000000030330022020001000300000130003033030001006622000003300000203000000000000000
333333333333333333333003333300000000000000303333313033331333033003033100003003000000000030003333033030300313333300030000030033000000033303030033333303333300000000000000
