000000000033000000030000000000000000000000003000000500000000030000000000060000000001006003000000200000000000000000000000000000601000000000003000000000000000000000000030
000000000033000000000000003010001000000003000000000000000000000000000030000300000000000000000000000000000000000000000000001100000000000000000000000000000000000000300000
000000000000000000000000000010200000000100000000000000050000000000000000000000000000000000010000000000003000000000000100000001000000000000000010000003000000000001000000
000000000000000000000000000000000000000001000000000000000000000000000000000000000000000000000000100000000000000000000000000000000000000300000000000000000600106003000000
000000000000000000002000000030006330100000000000000000020000302000000000006100000000100000000000000100013000000000000000000000000000000000330000000000000000000000000002
000000000000000000111110000000000001000000000000600000110003101030000010000003001000000001100010000000000000000100000001100000000010000000000000300000001011010000000111
000000000000000000000000000030300003000000000000000031000000030000000000000000013006000000000000003000001003000000000000050000300003030000000300003003000000000000000000
000000000000000000000000000000000000000000003330003000000000000000000000033000000000000300000000000000000000000000000000000400000100001003000030000101000030000000003300
000000000000000000000000000003000000030000010310000000300000000000000000003000000100000300000100000000000000000000010000000000000030001033000010000000000000000000003300
000000000000000000000000000000000003000000300000000000000000000000000000000000030000000010300010000000000000000000000000000000000000000000000000000600000000000000000000
000000000000000000000000000000300000003000000000300000000000040000000000000000000000300000600000030000000000000000004000000000000000000000000000000000000000000000000003
000000000000330000000000000004001300000100000000035000000000030000003300000101000000030000400000000000000000000000000000500002000000000000000003000000000000000310000000
000000000000000000000000000000010000000000000030011000100000300000000000000000000000100000011000000010000000300000000001000301100000000000000000000330050000000000000000
333303330000000033000330000033310330013000000000000000003000000300000000000003030000000000000040003333033030000000300000006000330000000100003603033000001030000000000000
