000000000000000000000000000000300000000030000000000000001000000102000000010000000005000000000000000000000000000300000300100000001200600000000000000000001000000000000000
000000000000000000000000000000100010000000200000000000300300000030000000000000000000000000100006000003030000010000000000000000000003000000000063000000000000000000020000
010000000000000000000000000000000000000000000000000103300000000000010000010000000330030030000000000000330000000000300000000000010000000000000300000000050001000000000000
000000000000000000000000000000000000000000000000000330300300005000000000000300033330630000000000000033330000000300000000001000000000100000000301000000000000000150000000
000000000000000000000000000000021000000000000000000330000301000000000000000000363330030001010000000033300000000001000000010000000010000000000000000000000000000000000000
000000000000000000000030000020020030000240000000023330000300000000000030002002330330030001030000003333300030000010020000000000030000000000010300000000020000000000000000
000000000000000000000200000033300300033333000000033333003330333000000040310333003305330353300003003333330201010033333300002100230010000014003033333003333300000002000100
000000000000000000000000000000000000000000000300000060000000400000000000000000000000003000600000000000000000000000000000000000000050000000100000000000200001000000000000
000000000000000000030030000000000000300000000030000000300000000000000000000100000040000010600000000000000000000000000000000003000000003000000000000000000100000010000003
000000000000000000330030000011010000300000005000000000010000000000000000000000000011003140000000100100000000000000000001100000000033103000000000000000000000003300000000
000000000000000033330030000000000000300000000000000000000000003000000000000000000000000030000000000000000001100303000060000000003333003030000000000000010000300300000000
000000000000000333330030000000003000100000000003000000000000000000300000001006002300000001000003000000000000000000000030000000033300133000000030000010010000303000300100
200200000002002333330030000000000000300000000000003000000002300010001000000030300030000020100000004000000000200000002000000040030320003000002002000000000023330300003003
333333000333333333333333333301000003333303000000020000001030330000000050010012010000011303300600000000000333333000333330000100033333333343333303330000000033031300000000
