000000000000000000000000003000010000000130000050004003000000000000000000001000000000000003003000000000000300000010005030000000010000000000300000002060050200000000000000
300000000000000000000000003011000000000030000000000230003000000000000101000000000000000033050000001000003000000000000000300001000000030000333000000000000010000100000001
000000000000000000000000000000000000000000003030000000000000020050000001000100000030000000300333100000000030003000333000000003000000000000000000000000331000100000000000
000000000000000000000000000000300000003003000000000000000000004030000000000001000000000000003000000000000140000010000001300000000000000000000000600000050000000000000000
000000000000000000000000000000000000000000000000033001000030000000000510500003303000000000000000003300000000000000000000000000000103000000010000003000000000000000000000
000000000000000000000000000000000010010000000000000010000001100000000020000000000000000000000000000010301000000000000000000000000000000000000000000000000000003000410000
000000000000000000000000000030303330000000031000033000000000000000033333333333000000000000030003003300000000300030013000010333000000000000000000000100000033330330000000
000000000005000000000000000000030000000010000000000000000000030000000000030000000500000000000000000000000000100000030000300001000030000001000000203300001600000000000030
000000000000000000001110000000001010000000000000030000010000030010000000101000000100300003111000000000001000000100000003000000110000030060000000004000000112000000000030
000000000333100000000000000000033001000000010000000020000033100000000000000000030310000000000000003000060030004030000000010000000301000000000000000000000010000000010000
000000000000000300000000000003000001000000100000200001000000000000000000000000000000001030600000000300000000000300100060000000000000030100000000000311030100000000030000
330000000000000000000000000000000010000000530000011000000000100210000000100000003000000100000000000030000000000001000100003000050000003006000300000000000000001301000000
000030000000000000000200000000000000100000000300000000030000000011000000000000010000000000020000000100000000000000000000000000200000000003000030300000000000000100000000
330000000003000000333333333303003330000000000000000000300000000100000000000000000310000000003333330000013000000003000001000000333333333000003300000001033300000000000600
