300000000000000000000000000030000003000000000060000000000000000300000100000001000000000000000000000000000000000000000000000000000000000000000030503000000005000000000006
000000000000000000000000000000000000001100000000000000000060001000000000000010001110020000300000000030000000000000000000000000300001000001300000100000000000000000001000
000000000000000000000000000000000000000010000000000000000000003000000000000003300000010110000030003000000000000000000000000000000000033000000000000330000000000000000000
000000000000000000000000000000000003100000300006000000000003000000000000000003300000000003300000000000000000000005000110003000000000030000000000000360000000000030000000
000000000000000000000000000000020000000000000000003000100006003000003000000000000143000000000000000100000000000300000000000100000000000000000000003000000000000000000000
000001000000000000000000000100301100300000000000000151010005003000001000000020300000000000000000330000000000000000100100000011000000003000010000100030000000100220000030
000000000000000000000000000011000000033333300005000000000003000000010000330330000333303330033330630000000000000000000000010000000000000300033000000033333003303330000000
000000000000000000000000000000010000200000000000010030000000000000000000000000000000000000000000000000010100000300400000000000000000000000003000000000000000000000300000
000000002000000001110000000000000000000030020003000060000000030000003000000000000000001000010003000001110000000000000001100000020400030000000000000020010000300000000000
000330001111003300000000000031006006500000001110000033000010000011000000033000000001000000000000003000000000300000003000000000011100000033000000100011110000000000003100
330330000003333300000000000000000000000105004030333033000000000001033033033000000060600000300000003300000300350000000000000000000003310003000000003000033300000003003300
330330000000000000000000000000000000000000003000033033000000000000000030033000000000000000000000000001000300031000002000000000000030030033000000000003000000001003300300
000330000000000300000000002200000000030000000000000033000000000000000000003000000030100001030000030300000000350010000250000005000000500033000000010000001000000000013300
303333333333300033333333333330000003303301330333030000330000000333003030303300000110000000000000000000330000003333300300000000333003000313301100000330333000000003003330
