000000000000000000000000000000100001000010010000000006000006000000000000300000000000000100000030000000000010000000000000000000020000006000300000000000010000000000000000
000000000000000000000000000000000000000100000000000000000010003000003000000000000000060000000000000000000000000000000400003000000000000300000000000000000000000000000000
000000000000000000000000000000100004403010000004400000000000014344100000000000000000030000004000000000000600500044431000000000001033000000000001000003000004000000000000
000000000000000000000000000000003000000000030000001040000000000600000000001000000000000000000000000000000000000000000000000000000003000000000000000000000000000000300000
000000000000000000000000000000000000000000000000000000000000005000000000000000020000000010000001010000000000000000000010000000000000000000000000000300000000000000000000
441100000000000000000000000000010000000230000000000000000000000000020000000010001000060000000002000410000000000100002000000030004000130000000000000300000000000001401000
000000000000000000000000000000000000333331300133300000000030333333103300100000003000000000003330330000000330033303303030000000000300000000000000010300313333330330000000
000000000000000000000000000010000000000000030000000000000001000000000001000000100000000000000000000000000000000000000100000000000000000000000100000034001000000000001100
000000000000000000000000000000300000000030000000000000000000000000000010000001000000006000000000000000002000200000000000000000000000000001016000000000000000000000000000
444000000000444403000000000001000003000000444000000000001000300440300000000000001010300000000000000003004110000000000000000000140300010000440000044400000000000000000000
000000000000000000000000000000010030000000000000000500000000000000000000000000000000000000000000000000000000000000040000000030200000010000000000000000000000000000000000
000000000000000000000300000000000003000010000000000000003000000000040030000000000000000000100003000003000300500000000033000000030000000000000000000000000000000000000300
000020000000000000000300000001000003000000000000044010003100000000000044110000000000210000500000000001000600000334010003300000010000000010000000000000021000000000000000
333333333333333333333333333300001003333033333333301105000033333303333000001000000000000000000003003033300033333000000000333303303333033033033330033333003300100000000000
