000000000000000000000000000000000000000500000001000000000000000000300400000000000000000000000030050000000000000000030000000000000000000000000001000000000000000000000000
000000000000000000000000000000000000000000020000000001000000000000000000000003000000000000000300003000100000003000000010000000000010000000000000000000004000000000000400
000000000000000000000000000001000000110110060000000000000110113000000000003100000000500000001111110101000000000100000000011110000000000000000000000001000000000000000000
000000000000000000000000000000000000000000360001100000000000000000000025020000000001010001000000002002000010000020000000000300000000000000000003000000000000100000002000
000000000000000000000000000000000000000000660000000000000000000000000000000000000000000000000000000066010000000000065000000000000000000000000000000303000000001000066000
002000000000000001000000000001010003000000060000000000000000000002000000600000001000000000000000030366000002000000660000000020000030000000000020000000000020000003066001
000000000000000000000000000040000000303330303330300000003333333000000003033330000000000000033333303330033000300333330433333300301300303030000000000000003010000003303333
000000000000000000000000000000000000000000100100000000011000000000000000000000000000000000000003000000000000050030300000010000000000000060000000000000003000000000005010
000000000000000200000000000000000010300000000000000000000000000000010000000000100003006000002030003000000000000000000000000000033000000000040000200000500000000101200000
011111000000006600000000000000100000100000000010020000000000002000000000000006603000000600066000000000000000000010000200000000060040001000000111100000000000000006600001
000000000000006600011200200003000001000000300000020030100000000000001103000006000001000100066010100003000010002000000000000000060001000000000000000000000003001106600001
000000000000006600000006600003000000010001000005000600000000000000006000600006600000000000062000000000000000000000030010100000620000000000000000000000000000000006600000
000000000000006600000006600000230000000000010000000000000100000000000020000000500000000000006000000000000000100003000000000000060000001050000000000100000000300006600000
333333333333333333333333333300001000000000030333303033330000000010000030330333303330000040033333333333333100000000000000000000333333300000003330000100011003333333333333
