000000000000000000000000000000000000000000002000030200000000400000003000000000000300000000000030000300300000000006000000000300000050103030010000000000000000000000010000
000000000000000000000000000000010003050300000000000000050000300000000000000050000300000000000000050000000000030000003000003300000300000000050000000000000100000000000000
000000000000000000000000000000000100030001000000000000000000000000000000000000003100000003000301000130000000000000000030033000000300000000000000000000000000000000000000
000000000000000000000000000000000000000000000000000005000000003300003000000003333300000000000002003331400100000000000053330300000000000060010001000000300030003001000000
000000000000000000000000000003000000000000000000000066000003003030000000006003333300000000001006001300300000300300030003303300000000000060010000000000010000366000060050
000000000000000000000000000000000003000000000000000031001000033000000000060003333310000000000066000303300000333300063333333300000000000006000000000000000005063000000000
000000000000000000000000330000010000030000000330033033330333333000010030333333333330001000003310331603610303333333030033141030000000033333030000500001333033033330300333
000000000000000000000000030000550000000300000000000100000000000000000000000000000000000000000000000000000000000000000000000330010600000000000000000000000000000000000000
000000000000050000000000330001000000030300200050000000000060300030000000010000000000000000030000000000000000000000030100100000000000000000006003010000310001000000001002
000000000000000000000003330000003000033000000000000000000000300000001000500430000000000000000000000100000000000000000000001000000000000000000000000003030000000000000300
000000000002000000000333330000000003300100000000000000000000000000000000000000050000000020000000000000000000000040000000000201000000000000000010000333330005000000000000
000000000066000003003333330000140003333300000300300000000010310000000000100000000000003030000000003000000000000000000000000000040300020000000000000333030000005000003033
000000000066000003333333330000000003333300000130300000020100000000000000500000000000300000000000000000000010000000000000000000000000000000000000000330333000000000003333
333333333333333333333333333033333303030330030633300000000013033001000000000000000050001000000103013333313000000000000000000300333033000000000000000333303000000013233333
