000000000000000000000000000000000000000040000000000010000000330000400000000000000000000003601000000000003000231000100000003000000033000000000100050000000030001300000000
000000000000000000000000000000000000000000000000000000000003330000000000000000000000000003000000000000000000333300000000000000000033300000000000000000000000031330000000
000000000000000000000000000000000000000000000005000000000033300000000000000000000000000000000000000000000003300300000000000000003333500030000000000000020000003100030000
000000000000000000000000000000000000000000000000003000000033330000500100000000000000000010000000000000000031033000000000000000233303000000000300000300000003333300003300
000000000000000000000000000000000000000000000200000000003333030000000000000000010000000003000000010000100003333006000000000000303333600000010000000000000033300300000000
000000000000000000000000000030002200030000010000000000003300000003002000060030004000000002000000100000000330030000000000000220300330000000000000000600200033333000000033
000000000000000000000000000033303333330333000000000000023010000330303300103330060000300333300000000002003333000000000003300333033000000000000000000333331303300003333003
000000000000000000000000033000000000000000000033000030000000001000000000000000000000000000000000000000000000000000000000000000000000000000000000000600000000003000000010
000000000000000000000000333300000000000000000333300000000000000000000001000000000000000000000000000000000000000000001000000000000000000000000310000000000010000000000001
000000000000000000000003333000000000000000000033000001500000000000000000320000000000000000300000000000000000000100000000030010000006000000020030000060000000000000000000
300000000000000000000033333000000000000000033333020000003000000000000000000000000000000000000000000600000000000030000000000100000000000000000000000000000000000000000000
600000000000000000000333333000000006000000333031010000006000000000000000000000103000601000000000040000000006000060000000000000000000000001000020000000000000100000000000
600200000002200000033333330000000006000000330330000100000030000000000000000000000000000201000000001000030000000060020000000000000000000400300003220000000000020010100000
333333333333333333333333000000000003333333303000000000003033133000300000000100000030033333300000003303332000000033330000000000000000003033300333330000000300000100600000
