000000000003000000030000000000000200013000000003040000000000000000005003000000000000000000000000000001000000000000003000000000000000000100000000300000000000000300000000
000000000000000000000000000030000000000000000000000000000050000100000600000000030000000000000000000000005000000000001030000000000000006000030000000000000006000000100000
000000000000000000000000000003000000000000100000000000000010000000000000500000000000000000003020000000100000000000020000000000040000000000000001000000000003100000000000
000000000000000000000000000000020000006000000000000000000000000006030003000000000000000003000660000000000000200000610000002000000000100000030000000000000000600000000010
000000000000000000000000000003000000000000000000000300000030000516630000010060000000000000000660000000001600030000060000000000000000006000000001000000000000660000000000
000000000000000000000000000000205000000000300000040030000020000006602200000000000000000000000661220000000002040000160200020000300000000000000004100000000000600020003003
000000000000000000000000000033333350000000000000301000003333000331333300300032003000000000030333330000000033360033333333300330000000000000000000000000000001303330000000
000000000000000000000000000000000000001500030000000000000000000011000300003000000030000000000003010000310000003200003000000000000000000030000000000000000000000000000000
000000000000000000000000000000000000000000010001003000000000000000000001000030000000000003000000000000000000000000300000000000000006000303000000000000000000000010000003
000000000020000000000000000000005000000100000400000020000010030000000000000000000011000000000000000000000000000000000000000000000000006010000000300000000300000000050000
000000000660000002000000000000000000000000500300000660000000000000000000000000000000050000000000003000000060000000000000000000000000000101000000000000000000020000000000
660000000660000000000000000000000000000000665001000660006600000000003000000000003000000000000000006000005000000000010006000000000000050000000000000160000000000000003000
660000000660220020000000000000000000000000660000000060220600000000000000000000000000000000000000000600005000100000000010600000000000000000000000000060100000200000000000
333333333333333333330003003300330330010000133333033133330301033000000000000000000000003003300000003033303000000000000003301331000000300300000000033033003303333100000002
