000000000000000000000000000000000000000000000001100000000000000300020012100000000000000000000000000013000000000000000000000036000000000000000000000060000000000000000000
000000000000000000000000000000000001000000000030200000060010000000000000000000000001050000003050000000000000000000000002000000000000000000000000100000000000000003000000
000000000000000000000000000000044000002000000000000000300002000000300010130000000000000414000100001000030001000000100000010000000044000000000004040000000000000000000001
000000000000000000000000000000000000066000000000000000000066100000000005000000000000000000000000000000000000000000000000000000000000010000000030000000600000000010000000
000000000000000000000000000000000030066000000000000004000060000000000000000000000010000000001300000030000000000003000000000000300030030010000510000003001000000000000103
000000000010000000000000000000002000066000000000000010000060000010000000010200000003020020000000340000000000000003000000000000020000000000000200200006000000000000000004
000000000000000000000000005503300030033333100005000030003303331000000033330030000000303030350000000000000503303300000551303033333033030003003333333333331000000000100000
000000000000000000000000000000100300000000000000000000000000000000000100000000010000000000000000010000000200000600000000300003000000000000001000600000000000000000000000
000000000000000000000000000000300000000000000000030200000000000003000000030000000000000000010000100000000000030000000003001000000000000000010000003000003000000003000000
000444000020000010000000200000000000002000000000000000000004440000261000000000000600600000001020001002000000050030320000002000000000300000100000000000200040100000000000
000000000660000000000006600000000000066000000001000001000000300006001000000000000500000000000630000060000000103001660000066000000000500000360000010006000001003500000361
000000000660000000000006600000000000066000000000000000000100000006600000000000000000000000303660031060503000600300601000060000000300004000000000000006000000000000000000
020020000660000000020006600000000000060001000022000010000200200000360000000030000000000100000130000066000000000000660000000000000000000010002000000006600000000200001020
333333333333333333333303333300000003330333110133100000100333333303133300000550000000300000033033133003331000035030003033033303030000000000060000005303633333303330000300
