000000000000000000000000000003000000000000000000000003000000000000000020000000000030000300300000002300030000000000000000000004000060000000000000000000000000000100000000
000000000000300000000000000000000000000000000000000000000000000004030000001030000000400000000000500000000050000000000006000000000000000000300000000000000000000000000030
500000303030100000000000000003060100000000000000000000000000003000000000000000000403000000000030000100300000000600000000000010100000000005300000000000011100000000303010
000000000000000000000000000040000000000000000000001000050000000003010000003000001000300000001000000000010000000000010000000000000020000000000000200030000000000100000300
000000000000000000000000000000000001000000000000000000010000000000000000000500000001000010000000000000000031000050000000000000000065001300000036000040000001000000000003
000000000000000000000000044400000000030000000660000000000000000002000000004040003200000030000000000000000100044430000000000200000660000000000006601000020000000000000000
000000000000000000000000000005000003330033000333300001033333330000000100000003301330333333000000003333333000000000000003303333000300300000000000030301433103160000000000
000000000000000000000000000000003000300000000100000000000000000000000000006000000000000000000000000000000000000000000000600200000030001000000000000000000000001000000000
000000000000000000000000000000000000000000000000100000001000010010000030100000000200000000000060000010003000003000000000000000000001000030300000600000000000000000020040
000000000000000000000000041100005000000410300005050000005000003033000003000000000000000040300000005000303030601000000100000000000000001000000000000000000000000000000000
000000000002000000000000000001000000000000000000002000000000001000000000000000000200000010000002000000000000000000000300000001000003000000000000000000000000000000005000
000000000066000000000000000020000100000000000000000000000000000010030000000000006600000000003036000000000000000000100000005000000000000003000001000000000600000000000300
000000000066000000000000020000000000010200000043403000000000000000000000100001006000003000000066000000000000000000000000000300000000000000000006414300000000000110000000
333333300033333333333333333333330033333333000000030003000000000030000033330030003330000303300033330000600000001000000000000000303333333303330000000000000031340303330033
