000000000000000000000000000000000000000000000300000000000300000000000000000000000000000000000000000001000000300000000000000000000100010010000000000000000000005000000000
000000000000000000000000000000000506000000010000000300000001100000000000000000000000000000000000500000000000000000000000000000000003000000000000000000300000000010100000
000000000000000000000000000003000300000003000000044400000000000000000030000000000000000510000006000000000300010300000001000000500500000000000100000004000300000000000000
000000000000000000000000000000020100030000000000000000003000000000200300000130000000010000000003000000300000000000000000000000000000000000000000000000000000300000033000
000000000000000000000000000030010000000000000000000100000600001000000000000300100000000000000000000000000000000000000000000000000000010000000000000004030000000000000000
111110000000000000000000000000000001111110100000000020000020022000030000000000000000000050000000105111100000000001150000313000000000000220020000000000205210220221101100
000000000000000000000000000003333330000000000000033330333033333330333300000000000000313033033331030000300000050000000000000000333333033533030000000333333303333300000000
000000000000000000000000000000000000000000000000000000000000000000000000030000000000000003000000010000000000000000000000000000000030000400000003010000040000030000000000
000000000000000000000000000000000000000000000000000000000000000000000000000003000000000000003000100000000000006300010000000000000000000000000000300000000000000100000000
444000000000005555000000000000000000555010000000000000005505000000000001000004440000041000030300000060000001010003000000000000444000004000000000301010000000000005555000
000000000020000000000000000000000000000000006000000000000000000000000000003001000000000000000000103000000000000000000000100000000000000020005002000000000000000000000000
000000000000000000000000000000000000000000000000300002000300000000005000000000000000000001000003010000000000000000010000000000000000000300050000000003000000001000000000
000205200000000000000002202200300000001000002300000000000000000111110000000000002652000200200220200000000000000000013000000006000001200000030000000000000000000000000000
333333333333333333333333333300103001333303303003300000003333333000000000000001033333333533330333330000000000000100000050005000333033333310333300003000005000000003033333
