000000000000000000000000000000000000000000000000006000000000000000003360000305000000000000000000400000000000030000000000010000000000000000006400000511000000000000000300
000000000000000000000000000000000000000000003000000000000000000001001000000000300000000000004000000050002000000000003000000000000000000000000000001000000000000001000000
000000000000000000000000000000000001000300000000010366000000000000000000000000000010000000000000000300000005000000300000000000000000000000000000000000003000000000000100
000000000000000000000000000000020000000000000003000036000000000000001000000000300000000000000020010000000001000000020000000000000000000000000000000000000000000060001000
000000000000000000000000000000000100000000030300000066000000000000000000000100000000000000000000000000000000000000300000000000000001000000000000000003000102000000000000
000000000000000000000000002000000010000020000000020065000000000001000000001030000000000000000000000034000000002000050000000000000010030000000000020000000000003000000000
000000000000055000000000000013303330060003131330300330035000000333300300000150333330333030333230000000010001100013033333330333500000000000000000000333335310000000000305
000000000000000000000500000000000000000001500000000000130000000000000600000000000000000000000000000000000000000000030000000000000000300000000000000000000000010000000000
000000000000000000000000000000000000000000000000000001000300000000000006000200000000000000000000000000000000000000000000100000000000000010000000000030000000100000000000
000660000000000000000000000000000000000000000000000000000000000000000003060000006010100000000000000010603000000000300000000000000660000000000000000000000000066006000000
000660000000000002000000000000000006000000005000000000000000010030010003100000000000000100000000000000105000000000000000002000000660000000000000000000200000066010000000
000660000000000000000000000000010000000005000000000000005000300000000000000000006600000000000000000006000000000000000000000000000660000005000000000100000000061000000000
000660000000000000000000000000001000000010000000000000000000020000010000000000006600000000000000000006000000000003000000000000010660000000000000000000000000066000000000
003333333333333333333333333350000000300005333333300000000000000100000013333000033303500000010000050000330303333000000010033003403333340000005000000333333330050030333003
