000000000000000000000000000000000000300000001000000001001000000000000000001000000000000000100000000003000000000000003000000000000000000000001003000000000000000000000000
000000000000000000000000000000000000000400000000030000000000600100000000000000000001000103000002000000000000000200000000000000010000000000000030103000000001000000000000
000000000000000000000000000000000001011100000010000000000000000010000000000001111000000000000030000000003000003000000000000060000000010100000000000000000011100002000000
000000000000000000000000000003100100000000000000000000000000000000000000000000000000000000100000000000000050061000000000000061000000020000000060000000000000000000000300
000000000000000000000000000000000000000001000000001000010000300000000000000100000003000030000500000000000000002000000000000000000000000010000000000003000100030100000300
000000000000000000000411110000033030000000000003000005000001300100010000000001000002000031041111000010000003000000300030100000200400006005021301100000000003000020003300
000000000000000000000000000033330003330000000000000000003033000000000000000103333333033300000000030000000000000000000000003000000000030331300000000000000033330333330010
000000000000000000000000000000000000000000000000000000000000030000000000000000001000000000000000000000000300000000000000030000030000000000003000000010000000000000000000
000000000000000200000000000002400000000000000000000000000000000020530031000000000300000000000000000100000020000000000000000030000000000000001000000020030000000000000043
111100000000006600001111110006000000300000111000000000000000030060000100003001111100011300001111000000031660000160000010000000000300000101000000000660000600000051011100
000000000000006600000000000006000000000000000000015000000003010600000000003001000000000000000000300300000060000060000001000000000000000000001010000660001000000000000000
000000000003006600000000000061003000000000000000000000000000310060000000300000000000000000000000000000500000000066000000006300000000100000000010000060000000000000000000
000000200033006600000000000060000000000006000000201001000030010600000040111000000006000300200000000000000630000066003003003300411110000000030000000060000000000000000000
333333333330003300333333330010053030000000310033300000000000000300103310630003000000303343333333000000000300033333003333033000013000033050000000000330030010000000333300
