000000000000000000000000000000000000000000000100003000000503000000000000000000003000000005000100000003000000500000000000000360000000000100000000300000000600000000000000
000000000000000000000000000000000000000300030000000000300033000030000000000000000100064000000000000033000300000013000100000000001000001000001000000000000000000000000000
000000000000000000000000000000350300000200000000000300003130003000300010000300000000000030000030003333003000000003000000005000000100000600000000040010003300104400000530
000000000000000000000000000003000000000000000000000000233333003000000300010000001001000000300000033303003010005000300000000000000000300000010000000000000000000030000000
000000000000000000000000000000000300000000000000000000330533003000003300300000300000000403000000003330003000000003000000000001000003304000000000033300003000000000300000
000000000000000000000000000000030200000030000000000003331333003000033000004002310030000030300000000333000030000050000000002020000023300000000000003000000023200000000000
000000000000000000000000000033601330000000030000030333333350003033130300001003300303330333300000003300003000000000000000030101303333000000030303333030600033333330000000
000000000000000000000000300000000000000000100003000000000010000000500000000000000000000000000000100000000000000003001000100006001005000104000100005000300000000030000000
000000000000000000000003300000630000100000000000001000000011000000000000000000010000000000000050000000000000000000500000000000003300000000000000000003403000000000000000
000044000050000000000333300333330000000000000000000000400000000000500000000001000060000044000000500505000100000000000000003440333300300000030000000333303360050000000010
000000000000000000003333300333330010000300001000000000000060023000300000000000300000000000000000000000000000000000000000000000031300300000033000000333300001000000000000
030000000000000000033333300333330033000000000000103000100000000003300000000000000000000000001500000000000000000000000000300000033300010000000000000333000300000000000000
232000000020200000333333300303331000000000000000023200000000030000000000010000000003202100003300005000020001000000000000020006033000300000000000000300300300000200000000
333333333333333333333330000330000003000000000000003333300000000333333300010010000000303333010500003333333300000030000003303033330000000000000000000330000323003030000000
