000000000000000000000000000000000100000013000000000300000000000000032000000110000000030000000000000000000101100000000000300011000000050100001011000000011100100000000001
000000000000000000000000000000060000000003000300000003000010000000300000000000000030010000000000000000106010004000000000010000000000001000000100001000000000000000000000
111111111111111100111111111111011051600000130111010001010000000001110100000004400000011101010000111100111101100011110112000000110011014510001410000100000001111111101101
000000000000000000000000000000000001300000000000000000000000000000000010000000000000000000000000300000000003000000000000000000010000000113000000000100000000000000030300
000000000000000000000000000000000006001000000000000000000000000000000060000000000000030000000000000000000000000000000006000000000000000000006000000610000030000000000000
000005055550000000000000000000550006000000000000000000000000000000005060000000000000000000000000000033000000000051050306000000000000000100030010000630000000001005555040
000000000000000000000000000000000003333633000000000000000331003000000035333303330333000000033433300000000333030300010003333333000000030333303030013333313300000300000000
000001111110000000000000000000030000000000111100000000000000000310000000000000200000000000010010000000000005001000000000040000000000000000000000030000000001000000100000
000000001100000000000000000010200000000000011000000000500000000116000000000000000000300000000000000300000001100000000000030000000100010000000000000000000000040100003030
100000014110000000011444000001111114045000101100020002011100111101001010111111131110144000011010111011001000030000000111111011340000011111010100101004060000000111000111
100000000000000000000000000000000000000000000000000060000000000000000000003000000000000000000000000000000130001002000000006100003000000003030000000000000000000000003031
600000000000000000000000000000000000000000100000030000000000010000000000100000010000000000000000000600000600000006000000000000001000100000000200000000000000000000000000
600000000000000000000000000000000500150000000000030001000000000000100000000005055000000000005050000000000150000000000000300000000000000000503000000000000001000000000000
333333333333333333333333333300000003030333033333303000335000000300333330000000006000033333300000000000000033333303330330000000303033000010000000000303330533330330000000
