000000000000000000000000000000001000000010000030300000000000300500006001000000000200003000030000000000003000000000000010000640000000010000000000000000000000003000000200
000000000000000000000000000051066005000000000001300100600001000000000000000000003600000000002066003000003000500000000030046600000000000400600000000000000000000030000600
000000000000000000000000000000006000300000000000300000000000000000000000660000006600006300000006000300003100000030000030000000000000000000000000000000000000003030006600
000000000000000000000000000000060010000000001000000000000000000000003000060000006600006600000033000000000000000010000030000600010000000000000000000000000000000061000600
000000000000000000000000000010066000000000000000000000000000000000000100660600006000000600601066000000000000000310000000006600000000000001000000000004010000300000066600
000000000000000000000000000000000030001000000000000000000000001000000000660060006600006006600066000000000000000000000000006610100000000000000000000000010030000000000000
000000000000000000000000000330033333030000030000300000003330300000000033333033033000333333303333301310000000300333300003333333000000000000030000000000000200300033333303
000020000000000000000000000303000000000000000000000000610100001001000001100000000000000001000000100003000000000000000000000000001300000001040000000000000000000000000060
000660000000000002000000000300020000000000000000000000000000500000000000300030000000000000000006000000000000000500020000000000010000030100000000000000000000000000002000
000660000000000066000000000300060000000000100000000000000000010500000000300130001006010000000001000000030000000000660100001030000000000500000000000000000000000000060000
000660000000000066000000000010660000600000000000000000100000030000000000000000000000000000000000000000000000300000660000000000000000500000000100000000000000000000006000
000660000000000066066000000000660060000000005000000005000000000000000060000600030000000000000000000030000000000000610666006000000000000030000000000000000000000000066363
000660000000000066066000000030660660000000010000000000030000000003100000000600010000000100000000000300000000300000360060000000000000000000000000000000020001000000006166
333333333333033333333333000333333330000000030000000000033000006000000013000030000000000000033003030000000000300033033330333303000000000000003003303003000306004600333033
