000000000000000000000000000000000000000203000000000000000000000005000000000000000000000000000030000200300000000000000000000000000003000020303000000000501000000000000000
000000000000000000000000000000000003033000000000000000000000000000000010000000000000000053000000000000000000300001000000300000000000000000000000000001000000060000000000
000000000000000000000000000000000000000000000000000003010010331000503000000000003003000000000000000000000000133100000310000000000000000000000300000000000000000000000331
000000000000000000000000000000000000000000000200030000000000000000000000001030000000000000002000000000000000000000030000200003000000000000000000000020000000000030000000
000000000000000000000550000000030000000304000000000000000003000000000000000300000000000000000001000000000000000000000000000000500000000000305000000003000000000000010000
000000000100000000003333000000000030003300002000000000003000000000000001001000000000000003302000002020300000000000001000200000333000022205000000000020030000000030000000
000000000000000000000000000000000000003300003030333310033031033000300000000000000000000000333330000300330033000333000351133300000000033330360000300033330000000003130003
000000000000000000000000000005000002001000000000060000000000000000000003000010000000000005000000000000100000000000000000000100000000000000000000000000000000000300000100
000000000000000000000000000000000000000000100000000000000000000000060000000000000000000000000000060000000000000000030000300000000300000000000000000000000000303000000030
000000000003310000000000000030000000000000001000000000301000006000003000001000003000020110000000000000000000000000034000000000000000010030000300000000000000000000000100
000000000000000200000000000000000000200000003000000000000000000300000000003000200000000300000000000100000000010000000000000600000000000000004000000000000000000000000000
000000000000000000000000000010000100000100000000000000000000000000000055000300000000300000055100000030000006000000000000000000000400300011005500000000000000000010000000
222000000000000200000000000000100000200000500000033000002203000000000030300000200000000100033303000000000000000000000000100000001100001100003300000222000000100000000000
333333333300333333300000330001000003031300000100000000006333033000350000000003333300000030000000003000000030000300033300000000000000300000300000001033331300000000000300
