000000000000000000000000000000000000000000000000000000000000000000000000000000601000000000000002000000030001011000000000000000000000004000000010003000000030000000000000
000400000000000000000000000000011060000000000300000500000060000000000000010000000000030000100000000001000000000000010000000000000000000140000000050100110000000000000000
000000000000000000000000000000000000000000100030033330100000000333300000000100000060000000033030600001000000000000001000000063000000000000000000000000000000000003333000
000000000000000000000000000003000000000000000000000000000000000000000000000000000000000001000000000000000403000033000000000030000000000000000001000330000000000000000000
000000000000000000000000000033500000000000001333000000000000010000030000000000000300000000000000000000000000030033000000000063000000000003003000100330000000000000000000
000444000000000000000000000003000000014340003330300000000000000000000000304400000030000000000010000000000003003033000600000066000000000004400000000030000000044400000000
000000000000000000000000000000313350000000013030003333333000000330103301000000000000000300033333330000000333330000033033303330100000000000003000000000500300001000033033
000000000000000000000000000000010060300000000001000030000000000000300000006000000000000000000000000000010000000000000000300000000000000000000000000000000000030000000000
000000000000000001100000000000000000000000000000300000000000000000000100000000000000000400000060000000000010110000100000030000000000000000000000000000000000000000000400
333300000000000000000000006610000000000666000100000000000000000300000000000000000066000030000000003060060000100003350000000000000006000000000000000000006600000000000005
000000000000003300000000006600000010000066000000000000000000000000000033000400006066000000000003000000066300000000000003000000000000000000000000000000000600000000000000
000000000033303300000000036600100040000360000000000003100000000000033033040000030366000000010010000000360300100000300101000000000000000030300060000000036630000000003030
000000000333303300000000036600000000000060000000000000000000000003353033000000000360000444000000000000366330000006000000000000000000000333000000000000006600000000033330
333333333333000003333333333300000003333333000000060000000001000333030000033333333333000000000000403333303000333331303330000000000000033333000030000300333300050001333300
