000000000000000000000000000000000030000030000000050000000030000000003300000000000100000000000000330000010000000100000000000000300000000000000000000000000001005000000000
000000000000000000000000000000000110000000010010100000000000000001003300000000000011300600000303300000000000001101100000000011000100031300000000000000000000000000000011
000000000000000000000000000010000000000000000100010000000000000300030300001101000001000001000033300000110000010300000000000003000000000000000000000000000000001100004000
000000000000000000000000000000000000000100000000000000000000000063333000000000100000100000000333130000000000000001000000000000000000300000000000000000000000000000000000
000000000000000000200000000000000000300200000000000000030000000033003330000000000000000300003301303001000000000000000000000000000000000000050300000006020000500000002000
000000000000000000000110000000000000050000000000100100000000000333303300000030000000000000003300330000510000000000000000000000100000000000001100003000001000000000000000
000000000000000000000000000300330330000000333033300000000013000033033333303360031333000000033303330303333013333200000000033033000000063033000300003000000033333330033333
000000000000000000000000003300000000000013000000000000000000300000030000000100000000000000301000000000000000000000000000000300000000000000000000033000000000300000000000
000001101000000000000000033300000000000303000000000002000000000010010000000000000000000010000000000010000000000000000000000101010036000000000030333006000003000010000600
100000000000000000110000333300000000033333100000000001101000000000000000000010400000000001000030030000000000100000000000000100000333300100000003030000000000000000500000
000000000000000000000003333300000000030303000000000001000300000060000000000000000000000000000000000060000000000000010000000000003330000000000033361000000000000030003000
000000000000000000000333333300000000333333000000000000000000000030000000002000000000000000000000000000600000000303003000000000335330300000000633310000000000000050300000
000000000000000000003333333300000003033333110000000010030000000300000000000001100000110000000000000000000000400100000003000003333313000000000333333000000300000000000000
003333333333333333333333333300000006033333030000330303130100000333301310003000500003000000301000003333333000000200000003333333333330300000303040333500000033303000000056
