000000000000000000000000000000003000300000000000000001000000000030000000000101030005000051000000000000000000100000000000000000000000100005500000300000055000011101000001
000000000000000000000000000000060000000004000000000000000000002000000000101014010601000000000101010000000103000000000000031000000000000000000300000300000000111010000000
000000000000000000000000000000000000000100000000000000600000000000000000000103000010000011030003000006100000000000000300000601000000000001100000000000611000000000000000
000000000000000000000000000005000003331300000020000006000100030000000000000000603000000000000000000000000000330033330000000000000000000000000033300000000000000305000000
000000000000000000000000000003000000000000000000000000000000000000100000000000000002060000000000000000000000000350000000000000000000300060000010000000000000000006000000
000000000000000000000000000000040000000000000000000000000000000000200000000000000000000000000000000000000000221000000000400000000222000000000100006000000000003010300000
000000000000000000000000000000000003003333000030000000000000002330033333000330000000003030333000330000000030000330033330000022330300333333333000303333303330133330000000
000000000005500000000000000000000100000050000000000003300500010000055000000000000000000000000000000000000000000001000000000000000000000000302000000000200000000000000300
000000000000000011101100000000000000000000100000000111010100000000000000000300000000000011000000000000000003000000000000010100000000000113100000000060000000000000000000
000000000011100000000000000000000000001060000010000000000000000000010000400006000005000000000000000100000000000000000000000000000000000000000000000002000000000000100000
333330000000000000000000000000000000000010001000000000000001000000000033333000000000333300100000000000000000300000000000000000000000000000000000100012000000300000000000
000000000000000000000000000000000000000000000000302000000000000000000000000000000000000000000000000000000000000000000000000100000000000000000000000000000003000000050000
000000000000000000000000222000303000000000000204000000000000000000000000000000000000000010500000000000000000000000000000000000100000300000000000001600000000020200040000
300333333333333333333333333300000003015303330303233330330000000333331330103330000300000003303303000000000000000000000004033030001300000063000000000000000033333330000000
