000000000000000000000000000000000030000000000000000000000000100010010000030000000530000300000000000000000000010000000000003000000000000000000000000000000300000000000000
000000000000000000000000000000000000000000003000003000000000005000000100300000000000003000306100000000000010000000000000003000000000000000000000000010000000000000000000
000000000000000000000000000000000000100000000000000010000030000000001000333000001000333300000000001032000000000000034003330003010000000000000000000000000000000000000400
000000000000000000000000000000660000000030000000000100000000000000000003031030050000333301301000100063000000000000000000333003003000300000000000000000001300000000000000
000000000000000000000000000000660200000000030000000000330010030000003333000030000000030320300000000066000000003000000003303200010000000600005000000000503300000000000000
000000000000000000000000000000000200300000100060000103430000000000033330330030000006033300301000006006060000000000000003303003000033300000000000000100030300000000110000
000000000000000000000000000033333330000000100000035333030000000333130332036030000000303000000000003033033000001030303333000003303303300010000030001033333000000003333030
000000000000000000000000300000000003000000000000300000000000000000000000000000000000000000003003010000000000000000000000000000000000000001000000000003300060030000000000
000000000000000000000003300000000030003000000001000000000000000000000000000000000300000000300000000003000000000000000000000000000000000000000000000003300000000000003000
000040000020000000000333300300004003333003000000000000300002000000040000000000100000000000000006006000000000040000020000000000000000000000000001010033300300000000002000
000000000660000000003333300300000005303003000300000000000066000000000000000000000000000000000000000000000000000100660000101000603000000000003003000030301300000000000000
000000000660000000033333300300000003303103000000000000000066000000000000000003000000000003300000600000000000000000660000000000000000000000000000001033300300000000066010
000000000660200000333333300310000003333003003500000000000006000000000000000030000000000033002000000400000304000000600200000000030000003000010000100003000305000000066320
333333333333333333333333000333330303000003000000000000000333333333330300000000000000303333300000000000000333023333333300000000000000000000000000000333000000000403302330
