000000000000000000000000000000000000000050000000000000000000000100000100000000030000000000000000000000000000000000000000030400030000000000000000000006600000000000000000
000000003000000000000000000003000000000000000000000000010000500000000100000000000000000000030163000000500030500000000000000000000000000001000000500000000000000000000000
000000000000000000000000000000000000601000000000030001000201000001000000000001000000000000011000000200100000000011000000200000000000000000000200000000000000000000000001
000000000000000000000000000000000000000000000000302003006000000000000000000100000000000000040000000310000000000000000000600005000000400003000001000000300000001000000000
000000000000000000000000000000100000000000000000000000026600000000000000000000003000000000000000006000000000600000000001600000030001040000000600000000000000000000000000
250000000000000000000000000000000000310000000000000000006600000000001003100000000000030000000000006600000000000000100006000000030000000300000600600030000000000000000300
000000000000000000000000000000000003303030000000000000133330000000030303300333330000333300333333033330000000000013313031300000300303003001003330000100000003000003002003
000000000000000000000000000000000000000000000001000000000000000100001000000000000000000000000000000000000000000000013000000000000010000000000000000000000000000000000000
000000000000000000000000050000000000000000030006010000000000000030000000000000000000030000100000000000000000000000000000000000030000000000000330000000030001000000003000
000000000000011100000020000011000000033000000000102001000000000001000000100000300000000000000000000000001000000000000000000000010000000000010000000000000010000000030000
000000000000000000000660000003300000000000000000366000000003001000100010000000000000000003000000000000000000001000000000100300030000000000100001000000100000000000000000
000000000000000000000660000000000000000001000000061000000050000000000000000000000050002000000000000000000000030000000000000300000000000000000003000000000000000000000000
031000000000000000000660000000000002003000000003061010002500060600000000000000000000000000025000000000000000000000010002500000001000000000004000000050000000000000310005
333303330000333333303333000003333000000000600003113000000000010000000000100330000000000000000000003000133001000000000000000000000030010000330000500000000033330003333033
