000002000000000000000000000010303131000000000001000000000003333330010000001000000000000000000000003000000000000000001030033333000000000003000000000000100000000200000030
000000000000000000000000000000000000000000000000000000000000000001000000000000000000000000300050000050000000000006000000000000001000000000000030000000000000000000000001
000066000000000000000000000000030000003004033000000000010003000000006000000303330000000000000000005000066000000033300000003000000000000000000000000001005060000000000000
000063000000000000000000000000001003000000000000000000000000000000001600000000010000000003000000003060066050000000000000000030000006000000500000003000000040006300003000
020066000000000000000000000033333000000000000000000030000300300005006600000000000000000000000034310000016000000000000000303300000303300100000003303000000002000601000200
333333330000000000000000000000001000000030300000330000000000001000006600000000000000100000033000010000060000000000000030000000300400000030303300000300000033303330000000
000000000000000000200000000000000000000200000000003000010010100003303300011000000000000000000000000033333004000000000100000000000000000000000000010000000000000000000000
000000000000000033333330000033000000100020001000003000000000000000002010300000000000003002000030000033330110001000000000000000330000000020200030000003503000000003300310
000000000000000000000000000000000000001000000000000000000000000000000000000000000000000000000020000000000000000000000000000010000010000000000000100000000000000000000000
333000000000000000000000006600000660000660000000000100002000660000000000000000050000000066000000300000000330002000020000000101000006600006503330000010000000000000000066
000000000000000000000000006600100603000630000000003000000000630006005000300000000000000060000000000000000000000000000006000000030006000006300000000300000400000050000066
000000000033333333300000006600000060200660000000300000000000060000000000033330000300000060030000003303000000000000000000000001000000602003600000000033300006000000000060
000000333000000000000000006600000663330300330000000000003333333000000023000030000000333300300000000000000030000300000003000001000046631303300060003000110000000000000000
000000000000000000000003333300103330000000000000000000012000003000000000000030000300000001000030010000000005000000002000000000000330300320000000101000030000002003033330
