000030000000000000000000000000000000000000000000000400000000000000000000000000000300000000300000000003000000000000000000000000000030300000000000003000000000000000000000
000000000000000000000000000003003030030000000000030000000000000000000000060000000000000510000100011013000000000310101000000500000100000000000000000000000311101010110010
000000000000000000000000000000050330000130001000000000000000000003330105000500002100003030000013000000000030003310600000000000000000000000000000000000003300001100000000
000000000000000000000000000000063330000000000000000000331000000033030000000000000000100000000300000000000100003030000000001001000000000000000100000000004330000000000300
000000000000000000000000000000011300000040000000010000000000001003300000100031000000000000000330000000000000033000000000000000000003000000000600000000033000000000300000
000003000000000000000000000000103100000000000000000000000000000003330000003000000030001000000333003000000000333033100300000300000003000010000000030003133000001000000303
000000000000000000000000000040333340030000000000000000003030000333033000500000000000000000030003033330000033330330333330000000000000001000000001000333353333333300000030
000000000000000000000000000000000000000000000020000003000000000003000003000010000001003030000000000001000000000000000060200000001000000300000006000030000003000000000500
000000000000031011100000000010300001011000000000600100000000000000000310111000000000000000000500000030000000000000300000000003000000001003000000000300000005000000000000
003330000000330000000000000200333100100003100000200000500022013000003000300300000002000000000000000000000000000200000020000033030000000333000000000000000000000000003300
033330000003333000000000006603030003000000000006600010031000000000033330000000010160000000000000000000000000003600000660000033000000000330000000000100000603000000430300
003300000003330000000000006600330000000000000006600000003000000000000010000340000066000050000300001000000000000600003010030303300003000301001000000000006000000000033000
003330000333333000000000006600333003000000000106600000300000000003333030000000000000000000000000000000100000006600000660000300000000000333100000000000006600000000200300
333333333333333333333333333333333030313003303330300000000000000013333333333333303333000000000000000000000030303330333333333303000000003033330000030030333000300000333333
