000000000000000000000000000000000003006000000000000000000006000010030405020330000000000000000020331000001000030000000000002033000000003001000000300000000000001010000000
000000000000000000000000000000000000002000000006000300000000000000000103000000000030000000000000030000000000100000000000000003000000030000000000000000000000000300000000
000000000000000000000000000000014100001100000000130000001000000000000000330030011100000030000330040000000000000000100001003003000000000000000100001000000300010100000000
000000000000000000000000000000000303000000000000003000200000603000000000030030000001000040033310030000000000020000000003333003000000000000000000000000000000000000000000
000000000000000000000000000000000000000066000030000060040000000000000040010030000006000000033330030100000400000000100003333013000000000100000000003000000003000000050000
000000000000000010100000000322000000000066001000000000000000000000000330300030000066000000330010031000100000000000000003110003000100500100000000000002200023000000010000
000000000000000000000000003300153330330303000000000000000000000006003303300301333033000003030300030000000010000000000000330033000100000011000000000033030330330330000000
000000000000000000000000203300100000000000000600000020030000600000000000000000000001000000030003000000000000000000013000000000000060042300000000030000000000000600000000
000000000000000002000000000300000000000000000000000000030000000000000000000000000000000000000020000000000000000000020000000000000100000000000210063000300000000630000000
000111000000000011100003300300000000010000000000000330030000000000000030411100000000000000000111000000000010111000011000000000000111000000000003003000000000111000000000
000000000000000000000333300300000050000000100060003030030010000000000000000000000000010000000000000000050010000000000000000000100100000000003330001000000000000000000003
000000000000000000066333300310010000000000000000033300130000006000000000000000000000300000000000060003500000000000000660000030030000000000003313001002000000000600000010
220000000220000000066333000300003030022000000000033300030000103003400022000000000000002200003000660000000220000000000160021000220000000500033336003000000000000660000003
333333333333333333333333003330000033330333000011030300310000000000130353330000000006333333313330330000000003130033033300333303333033000000300330030000000030330330300033
