000000000000000000000000000000000000000000000000000000000000000000000000000000000000000000000001000100000000000102030010000000000000000000000002000000010000000000300000
000000000000000000000000000000000000000000000000000000000000000000003000000000000000000000000000000000030000103000000300000000000010010003000060000000030000010000000000
000000000000000000000400000000000000100000400100011010030000100000000011111000000000100010000000000000030300111100000000000000111000040000000010100000003300101001100000
300000000000000000000000000101000000000000000000100000000000001010100000000001000000000000030000000000000000000030000000000000000000000300010000000003003300000000000000
300000000000000000000000000100030301001000000000100000000030001000023000000000003000000000030100000000000330000000000000000000000000006000110000000000000300030000000000
000000000000000000001411111100003330000000401101100000004111100000033000003000000000000000000006000000001530000010005000310000300000040111110000001000001000000000000000
000000000000000000000000000031333330100000000000030133030000000303332330033300000000333033300000000000000303300000000000000060333303300000000000000100000000000003000303
000000000000000000000000000000200000330000000000000030000050010000003030000000000000030000000000000000000000000000010000000000000000000001000000000000000000000000000000
000000000000000000050000000000000000000000000001000000010000000000000003000000000003000000000000000000000300000000000101011050100000000000000000600030000003000000000000
000000000000333301111111110003011110000000000000000000031301311000003000000030000030000000010000000000000000063000010000000111000103300000000003000330411140001000220000
000000000000333000000000000033005000000000000001000000333000000300300500003130000000400000010000000000001000000300000000000000000003300000003000100300000000100010000004
000303000000333300000000000000100000000000000010000000333000000303000000000330000000000000000030300000000000003300030005300000060003300000003000000310000000000010000000
000033000033333300000000000063000000000000000003000033333300000000030000003130000001000000000003304111011000330000003001300000000303300010010000000330000041111110500000
333333333000033333333333333303033300000000000003033000031303101500000003000030000000010360030333300000000030000333033333303300030300300003000000000333330300000003330303
