300000000000000000000000000000000000000005000000000000000000000000000033201000000000000100000000000000000301000000000000000000000030100000000000000000000000000000000000
000000000000000000000000000000500510000010000005100100000050055000000000000000000000000000000000000000510000030000010100000301000000000030000000000000000000000000030000
000000000000000000000000000010100000050005000044100000001000000300000000010003010010000000000000003330000000000000500500000000000000000000050000000000300033000000000000
000000000000000000000000000000000003000000000000000002000000000300030000000000000030000000000000000000000000000000000000000000050000000000030000200000000100000000000000
020000000000000000000000000000000000001000130000000600330000000000000012003000000010000000000000330000000020000000000000000000000000000000330000033000000005000000000000
100000000000000000111111000000000001000000000000000000000000000060000010030000000000000000000000000000000100000000031111100000000100000000000010000110030000000006000110
000000000000000000000000000033330340000006003000330000033330003030033300000000003000000030030000003333330000100000000000000000000003030001003000100000000030103030030000
000000000000000000000000000010000000100000030000300000000000000000000000000300030010000000000000000000000000000030000000000000000000000000003000000031000000000000000003
000000000000000000050005005500003000000000000000100001100000000001300000003506000000000005000000500000003000000000000000000000005005500003500300000000005505000500000000
333000000000000000441100000000000010010000333000000000000000000000001000004410003000100000500004410500000000040000000003300000100000000003410000000000000000004400000000
000000000002000000000000000000000000000500000000000003000000000000000000000003000200000000000000000000000000300020000000000000000000000000000001000000000000000000000000
000000000000333300000000000000000000000000000000000000010000000000000033100000000033000000033000000000000010100002000000000000001105033000000200000000000013000000006000
000000000000000000000000000001100000000000000303001000110003010111300060000000000000000000000000000110111011060010013000300000000000100000000000000000000030000000300000
333333330000000000033333333300000000003000033303360000000100000040000000001333000100303133300010300000000000000000000003303001330303310000030000000300303100000330000000
