000000000000000000000000000000000000010000000000000000000010000100000000000000000000000000000001000100000000100000000000000000000000000000100000001010000010000000000000
000000000000000000000000000000000000000000030000000000000000000000000050550000000010000100000100000002000000500000000100000030000000000000000000000000000050350000000000
000000000000000000000000000000000003300000010000000000000100030000000000000000130000000000003330003333000000000000000000000000030300000000000000000000000000000000033000
000000000000000000000000000000000000000300400000000000000001000000006000000000400000000000000000000000000000033000030000100600000000000000000060300000000000000000000000
000000000000000000000000000000000000002000000000000000000000000000000000000000010103000001100000300000000600000000000000003000000000300030000000000000000000000500000033
000000111000550000000000000003000000000000110105000001000000000110005500000000000303000000000003330000200000003000000000000001000033300000551100355000000040000000000303
000000000000000000000000000000000233000030000000000000003033333000000000000333000333000000033033333000010300003433333000000000300333300000000000000000000030000333300000
000000000000000000000000000000100000030300001030000000000000000000300300000000000000000000001000003001003000000000000050000000000000000000000001000003000000300000000000
000000000000005055000000000050500000100000000000000000000002000000030000300000000000010000060000001010000000000000300000030000005000000000000000000000013000000000600000
000000033330000000000033300000000000000000003305000000103303300000000000003000000000000000000000000000000000000000000001303000000000000000000000000333300000300002000000
000000000000000000000000000000000000000010000000000000000000000100000004000000000000000000000000000000000000000050100000000000000000003000000010000000000000000000000000
000000000000000000000000003300000000000000000001300000000000000000000010301000000300000000000030000000030000000000000000000000000000000000000000000000000010000010000300
000000000000000000000000033330000000000000000033300001010020000000000000000010000000000003001000310000000110005500500000000000000000010000000000000000000000000000000001
333333330000303000033330333330003333310333330300300000003030000000000000000000000000000000000030000333333000000000000003600030010000300010000000500300000003333300000000
