000000000000000000000000000000000000000030000000003130500000000001000000030000300000000000010000030300011000000000000003000000100000000000000000000000000000000000000000
003000000000000000000000000000000000030000030000000000000000000000000000330000000000000000000000000000400103000000000000000000000000000000000000005000000000300000030000
000000000000000000000000000001003000000000003303300000000000000003330000100000000000000003000000003000000000010002010000033330000000000000000100000000500000000000000000
000000000000000000000000000000000100000000030030000000000000000333330000000000000000000050000000000100000005000000000000333300000003001000002000000000000000000000000000
000000000000000000000000000000000000000000336033300000000000000303333300000060000000300000000000000000000000000000000003030330000000000000000000030005000000000000000000
000000000000000000000000000003000000000000333333000000000000030033333000000000300003000000300010000000000060000000000003203133000030000000010000000000000005000000000000
000000330000000000000000000005000000000103333330300000000000000330333000000030033333003333000000000000000000010033000003003333000000330000003000600000100000000010000000
000000000000000000000000000000000000000000000000000000000000010000000000000060000000000000000000000000000000000000000000000000030000000002030000100001000000000000010000
000000000000000000000000000000100400000000000000000000000000000000000010000000000300000000300000000000000004000000000000000030000000000000300000000300005000000000000000
020000000000000033333000000000010000000003000001000000000000003010000000000000000000000000000303430000000000003000000000000000100000000000040030330100010000000000000000
200000000000000333300000000000006000000000000000020000031000003200030000000000000000200030000303000000000001000000000000300000000000000000000030300000000000000000000003
000000000000003333333000300000000300000000000000000001000000000000100000002000003011000000030033300000000000300000000000003000001000000000003033333003001000000300003000
000000000000033333333000300000000030006000000300000005003000000000000000000000003000000000033330330300000100300600000000103000001000000000033333300000000300000000003000
330000000333333333333333333300333330000201333333303000000030600330110010000003030330335000100333333000000033333300000000033330030000000333003033333000333333000103333333
