000000000000000000000000000000020330000000000000000000000000000000000000000000000000000000001010000000000000000000500000001000000000000030000000100300300000010000000000
000000000000000000000000000000000000000000001000001003100000000000000000000000000000000100000000003000000000000005000000000000000000000000000000001000000000000000100010
000000000000000000000000000000000001100000000000066000003111100002000000000000000000020000000000100030000301100060000100000000011110000000003110100000000000000001111100
000000000000000000000000000000000000000000006000066000000000000000000003030000004000300000000000000000000000000003000000000002000000000300005000000000000000001030000000
000000000000000000000000000000000000000000000000016000000001003000000000000000000000000000000000000000000003000030000000000000010020000000000000000000000000000030000100
000000000000000000000414100000000000004600404100060000002000000000000000000000003000000000000000000000000230000000000000001600200000000000002000000410100005000000000000
000000000000000000000000000000033330103330000000003333003333330000000000000013003033301033000000000000000303333000000000005000050330030030333303333000100000100003300300
000000000000000000000000000000040000000000000000000000020000000000000010000000000000000000000000000000003000000000000000000000000010000000000000000000000001000000000000
000000000000000200000000000000020000000000005000000000003000000050000002000000000000000001000000000000000020000032004000000000300000000400000000002020000000000000000000
011110000000006600000111110000000001101100000000000000001111000000000066001000000000405000011011000100000060000066000000030000000110000300000000000060000000002000000000
000000000000006600000000000000003000000000000000000000000000000000000006000000000000000000000000000000000100000066000000000000000030000000000000000660000000000000000000
000000000000006600000000000000000000000100301000000000000000000000000006000000020000000000000000000000100600003066000000000000000600000000000000000660000030000100000000
200000000000006600000000000000003002000500000003100000010000000001003066000604141000000100100000004101000060010060100000000000001100001000000000000660000300300300000000
333333330033333333333333333000030003333033010000000001013033330000000030333330000000000000033333301000000330333333030530000000133333030000000003333303503300030000000000
