000000000000000000000000000001010000000030000000000000000010000000000000000100000010000000000000000000000000000000000000003060000500000000000000000000000010010000020000
000000000000000000000000000010010000000000000030000000000000500000000000000000000000000100000000030003560003000000000101000000000000000040000000000000000000000000000000
000000000000000000000000000003000000000010000000000300000010010060000100000000000000100000500000000000000060000300000000000000000000000000000660000000000001000000005000
000000000000000000000000000000000000000066000000000000000000000006000000000000000000000016310100000000000066000000000000000000000000000030600660001000003000000000003000
550000000000000000000000000000300000000066550000000000000000010366000055000000000000600006610000000000000006000000200000000000100000000303603660000000400001000000000000
000000000000000000000000000000000000000000000000000000000000000366000001000000000322000006000000600000000066010000500000000000000000000000663600000000000030000000000022
000000000000000000000000000030350303333333000000000000500000260303303300000003033333033313330300330003000333303300000000000000000000033060304033030000001000000000030303
000000000000000000000000000000000000000000000000000000400000300000000000000000050000000010000000000001000000000000000006000003000000000100000400000000400000000000000000
002000000000000000000000000000500003023000000000000000000003000000000000000003000000001000000000000300000000002000001000020000000000000000300001000300000000000000000000
066000000000020000000000000000000000660000000000000000000000000000001000006420001000010000000000000000000000000000000001060000000000000000003610000000000100000200100010
066000000000660000000000000003000000660000000000050030000000000000101000000060500300000000103003000000000000000000000000660000000300600000003000000000000200010000100000
366000000000660000000000000000000003630000200000000000000000000000000000000660000100000000000000000000000000000000000003060000000000035003000001366000000055000000000130
366000000000660000022000002000300203660000000010000040100030000300000000000660000000000000000000000000002000000000000150061000000002003000000030303002000060001000000000
333333333333333333333303003330013133333003000030021103000000000300003333033330300000000000100000000333333000100000100330033333303333300031003303333000003305010000000030
