000000000000000000000000000000100000000300000000000000300000000101000000003000000003000000000000000000001000000004300000000000300000000000000000000003000000000000000000
000000000000000000003000000000000000000000000400000000000000000000000000000000000000300010100060000000000100000000000000000000300000300001000000000000000000000000000000
000000000000000000000000000000000000300000000000000000030000000001000000000000000000000300060001030000000000000000000000000000000000000000001000003000600000000000000000
000000000000000000000000000000030000000000001030000000030000000000000000000000000000000003000000060000000040100000000060000000512000000006000000043000010000000030000000
000000000000000000000000000000000000000000000000400000330100000030000300000000000000000010000001030000002000001000000000000000000000000000000000033000000000000000000000
000000000000000000000000000000000000000000000503000000300000000000000600001600302020000000000000031000000000100000000000000000000000000220000000303002232000010000000000
000000000000000000000000000000000300033030000000033333330000000333303303333331333303000000523333303333333000000000000003303333000000033333300303333333233300000000000000
000000000000000000000000000000003040000000000000000000000000000000000000000000000000500000000000500600000000000000400000000000100000000000000003000500000005000000000000
000000000000000005000000000000000000000000000000300000000000000000060000000000002100000110000300030005000000000000000000000000030000000050000005000003000000000000000000
000000000000000000000000000300330000000000000000000000000000000000000000000031000300000010000000000300060003000200300030000000000000000000004000000000000000000030000000
000000000000000000000000000300000010000000000000000000030000000000000000200330010001000100000000030000000000000000103030000000000000000000000000000000000000000000000000
000000000000000000000000003300000000000000000060000001010000000000000000000331000600000000600000000000000000003000000330400000030010000100000000000000000000000000000000
000000000220200000000000033300220200000000100000000000000000500000000000003530000000000000000000000000010002202000003030000000060000000100100000000000000000000000000000
333333333333333333333333333333330030000000000000033303300000000000000030333330000000060000000003000333303320330333333032000000000003031330333333333000000000010000030333
