000000000000000000000000000000000000300200000000010030030000000000000000000000000000000000000000100000000000000000000000000000000010000302000000000000003000000000000000
000000000000000000000000000000000000030600000200000000000001000001660000000000006000000000000000000000010000000000000000000000005000060046030100000000001000001300050000
000000000000000000000000000000000000006000600600000000000016000003600000001000050065000000000060000000000000030000000000000300000000000066000000000000000000660000000006
000000000000000000000000000000000000030600006310001000000061000000660000000000000000000000000000100000000500000000000000000000000000100066000000000000000000000000000000
000000000000000000000000000000000000000600006600000100000166000000660040060000000000000000010000000000001000000000000000030000000000000060000000000000400003610000000000
000000000000000000000000000000000001006600006600000000100010000000160000003000000000000001100000000000000000000000000000020000000003000060000000000000000000660000000000
000000000000000000000000000010000000333303303330300000000303333303333000000000033021000000100000300000000353033000000013300333000000030331030000000000000033303330000130
000020000000000000000000000000130000001305300000005000000000000005000000300600000000000020000000000000000000000010000000000000000110000000000000000000600010000060000010
000660000000000002000000000000100000000000100000001000000010000000000000005000000000000001000000000002000000000010000000000000010300000000000000010000660060000310000000
000660000000000066000000000500000000100000000000100000050000000000000000000000000000000660000000050066000001000000000050000000006600000000000000000000660000000650000001
000660000000000066000000000010000000000000000000000000030000100000000000000000300000000600000000000066601000000000000000000000006000000003000020010000660000000000000000
000660000000000066000000000000000000000000000000000000001000000000000000000000000000000660000000000066000000000010000000000000006600000500000600000000000000000000000000
000660000200000066000000000000000000520006000000000030000000000002010000000000000000000060000000000066010000000030000000101000000010003000000020000000660000000100000000
333333333333333333333003333300000000336033500000000030330000000133333300000000000000303333300303533303030100000000033330000000330033300000001333333333333000333330000000
