000000000000000000000000000000000000000000010000000006000000100000000000000000100003000000000000003000000000000000000000000001000000000003000000000000000000000000003000
000000000000000000000000000000020000000000000010000000100010002000000000000000000000000000000000000000000000001000000000000000030000000100000000000000000000000000000000
000000000000000000000000000000000000000000000000000000000000000020000000000000000000033000000020000000000000000000001000000000005000300030000000000030050000000000000000
000000000000000000000000000000000000000000160000050000000000000060000000000000100000000000000600000000000004001060060000000000000000000000000003000000300006000000000000
000000000000000000000000000000300000030000660000000300000000000660000000000034000000000000300660000000000000101001660000020000003000000000000000003010000066001000000000
000000000000000000000000000000000000001000660000000300000000000660000020203330000000000000000600020000000000000001660220000000000000040000102001330000000066000000000000
000000000000000000000000000000000010001000003033030300330000000333330030333330001000000003003630030000600333100333033330000000000000000000003333033100000030333310000000
000000000000000000000000000000000000000000000000000000400000100060000000000035000000200000000000000010000000000000000000000000103000000000000000000000000100000000000000
000000000000000000000000000000601000000000000000000000000000100000000000000000000000001000000000000001000000000000000000000000000000000000000001000000000000000000000000
020000000020000000000000000001000000000000000000010500000000000030001000020000000600020000000000103000000000000000000000000000013000000000000000000000000000000000000000
660000000660000000000003000000660000000001000000000006030030030000000000600000003000660000000000000000000000000000000010000000003000006000000000000003000010660000000000
660000000660000000003003000000603000000003000030000000000000000000500000600300000000660000000300000000606001000001001030006000000000066000010000000003000000660000000000
660000000660222020333003000000060222020333300000010000000000000000050003600200000000630000000000002020333000000020203300000000013000066000001000010003000000010010000000
333333333333333333333333003331331333363333020000030000000300033030000003033300000300333333303500003333333000300033003130000000333003030000330000000033003303333330000060
