000000000000000000000000000000000100000000000033000000100000300000000010300003000300000000100003300012000000003000200000000330000001000000000030331100000000000000000000
303400000000000000000000000000000000000000000033000000000000000001000030031000000000000010000003330000001000103000000000000330000000000000030000330000000000000010100000
000000000000000000000000000000002000000000300333300000030000000000000000000000000033000003030033300300200003003300000003063030000303300000000003330000000000000000500000
000000000000000000000000000000006000000000003333010000000006600000000000300000030000000100000333300000200000000000000000033301000000000000003033010000300000000000000000
000000000000000000000000000000066000000001333030000000000106600000000000000000000000000000033303000016600000000000000003333330030000000300003330330040000000000000001030
000000000000000000000000000000006000000000230333000000050000600000000000000000000000000100033313300306600000000100000003003330000000000030003330030000000000000000050000
000000000000000000000000000063333330000000020030030303103330333000000000000003033013000100000033003333330003333030300300003306303333300000000003330000000000300330000000
000000000000000000000000033000000010000000000010000000000006000000000000003300000000000000000000000010000000030000000200000000003000000000300300000000000000300000000000
000000000000000000000000033000100003032000000005000000000000000100000000000010000000000000000060303034000000000000003060000000000000000300000000000000000000300000040100
000000000002000000033300333000000000000000000040000000000000000000000030033310000000000000000100000000000000000001010000001001000020000000000000000300003000000000006300
000000000066000000000003333000003000000000000000000000000000000000000002303200000000000000000000000000000000000060000005000100100360100005120006000001000000000600000000
000000000066000000000333333000000001000000100000100001000300000000000103333100000000000000300000000030000000600010000001300000000660000000000006600000000400000000000000
000000000066000000000333333001000000000000000000000000000300000300000003333300000000000000053005000000000000000000040300000000000660000000000000600000000000003000000000
333333333333333033333000333033333330000000000000000000000000000000000300033303330003000000000000000010000303333300000001000000333133300000000003333303333300000000003000
