000000000000000000000000000000000000060003000000000100000300000000000000000000000000000100000000200000000000000000000000030040000000000000000000000000000000000000000000
000000000000000000000000000000000053303300000000000000000000000000000000000000000000000000033333000000000000000000000000300000000000000000000000000000003000000000000000
000000000000000000000000000000000000000000000000000000000003300303000000000020000000000330000000020000000000000000000000000000000000200033000000000000000000360000000000
000000000000000000000000000000000003300000000200000000002300300000600000000200000000000330030300100000000000000000003030000000000002003030000000000000000000000002000330
000000000000000000000000000000000000000000000000000000101333300000000000106660000000303330011000001000000000000000003000000000000066603333000000002010010000000000000000
000003330000000000000000000000000000030005300000000000000100000000000300006660000000000000000000000000000000000000000000000000000066600013000000000000000000300130000300
050000000000000000000000000000000000003333000004000000000000303050000033330330000000000333300303330000013000000033333000000000333033300033030000000000010005030000333000
030000000000000000000000000000000000000000000000003000000000010000000310000000000000000000003000000000000000000000000000003000010000000000000000000000003000000000300000
000000000000003333310000000040050000010000100000000005300000000000000000000003330310000003000000030000000000000000001000000000000000033300101600000000010033333100000000
000330000000000000000000000200000000110000000000000003000000000000000000001000100000000000201000000000000000000100000005000000000130000000010000000000000200000603003300
030330000003333300000000002600000100000026000033000031100000100000000000003330300000000002100000000003000000003300000000000000030000036010000600000000602633000000303300
333330000003000000000000066600000000000666001030033330000000000000010000103000000000000000640010000000000000030000000000000000010000000000000000000000066000000050333300
000030000003000000000000066610003030000660000030000000100000000300000000003000010001000066600000300000000000030000000000100030300000000000003000000000066000100000000300
000333333333000033333333333305000003330330003310000003000000000035000033033000033333303333305000000001000033330000100000500000000030000331300000000333333300333330003033
