303300000000000000000000000000000000000000000000000000001000000300300010000000000000000000000000000000000000000300000600000010000000030310000100000000001000000003033000
000000000000000000000000000000005000000000000000000000030003000000000000000000001300003000000000000100000000000003001000010000000000100010030000000000000000000000000303
200000000000000000000000000000000001311100000000000000000000000200000002000000001000001106011104600000111100500000000000200000101100020000000011000300000000001012000000
000000000000000000000000000000300000000000600000000000000100000000000066000000010000000000000030000000000060000100000000000000000000000000000000000000000000000003000050
000000000000000000000000000000000000000000663000000100000000000000000066000000000000000000000000000010000660000000000000600000000030000000000000000000000000055000050003
000111114111100000000044100014110000000100660210201030000000000000010106022222000000202000000000000000000600300214011006602002000000000011165020000141131001000000001001
000000000000000000000000000000000000000330333333000000000030000000000033333333333030303303000003333333303033303000000003333313000033300103003313300000010033303330000000
000000000000000000000000000000000003030000030000000000000000000000000000000003000000000010030330000000000300010000000000000000030000100200000000000000003000300000000000
000000000000000000000000000000000000000000000000106000000000000000600000000000000001000015000000000000000000000000000000000000000000000000000000000000000000000000003000
000011111110000200000001100000100002000000000011100000010000000111000000100000000100000005000000005010100000000006000110011000000011300000000000000000000000110001200000
000000000000006600000000000000000100100000000000000000000000000003010000000300000000000000100000000000300000300000000006000000000000000000000000000000000000000000100000
000000000000006600000000000000000000000000000030000000000000000300000000000000000000000000000000003000000000000050000003000000000500000000000000000000000000000006001000
000000000000006602202202000020200030301111000000004000001411010100003004000000000000000100000111100410130004100000410002010000000000200000002030000004030000000006002202
333333300003333333333333333033303040000000033003300000000000000001033303000303333033000000000000000000000000000000000003033330333333300000000000000000000000003333303330
