000300000003000000030000000000403000000000000300001000000000003000005000000000000000001000000000000000000000000000040030000000000000000000000000000000000000000015000030
000000000000000000000000000000000010000000000003000400000000000000000000000001000110000050000000000000000000100000000110000000000000100001000000000000000000000000000000
000000000000000000000000000000000000100000000200000000000000300000000000000001000500000000000000000030500010030000000000000000010000010000000233000056000000000000000000
000000000000000000000000000000000000000001000000000000000000000000301000000000000000000000000000001600000000000066000000000000010000000000006600000000000000000000000000
000000000000000000000000000000000000000000000000000005001000000000100000000000000000006000010000016600000000000006300000000000000000000000006000300000000600000000010000
011000000000000000000000000004010002200000010100000000000000100020600000003002200000500000000010006600000200000066020000300000002020160000006600000002020003003000000000
000000000000000000000000000000000000333303100000000100000000000033333300050001333303000000003030333302000333333303300000000000336133300000000340000333333000000100000000
000000000000000000000000000003000100500000000000000000000000000003003000030000000000000000000000100003040000000000000000003000300000000003001000000000000000000000003000
000000000000000000000000000000000000000000000000000000100000001000000000000000000000031000000000000000000000000000000000000030000000000000000030000000000000600000000000
010000000005000200000000000000000000200030010000000000000100000000000100000000000000010000000000000000000000000000000000000000000050000000000000000000100000005000000000
000000000000006600000000000000000106650030000000000100116600000030000050000000000000010000000000000000000000000000000000300000000010000000000000000000000000000003300002
000000000000006600000000000031000006600000000000000000006600300000000000000003000000000000300000000000000000000000000030000000000000000000000100000000000000020000100000
002022022000006600000020000002000006630000002022100030006600100000000001000000000020002002000000000000000000000002000000110000200000000000000000000020000022000000110000
333333333333333330000033333300333300330000333300000000003330000030000000000003330330003033000100000000030000010001330300000000333033300000003000000003303033330000010000
