000030000000000000000030000000003000000000000000100000001000000000000000000000000101060000000100000000300000003003500000000000010000100300000000000000000000000000300000
000000000000000000000000000010000030000000000000000000000000000100100000005300000000000100000053300000000000000000000000000600000000300000000030000000300500110000000603
000000000000000000000000000000000000033000000000000000000030000000000000000000000000010000000000000000000100013000000000000000000000000300000013000003300030000000030000
000000000000000000000000000000000000033004000000000003300003004000303000300000030000000000000000000003000000000000000000000000000300300330040000000103300000420030000000
000000000000000000000000000000000003030003000000000000003000003000000000000000000000000000030000001000001000003000000005000050000060030003000000000303000300000000000000
000000000000000000000000000000000000033003010000000060030330003000000000000000300000000000000002000100001000000000000000000000000005000003031000000003000000000000000000
005550000000000000000000000000555103330000300000300010003033000030000333033330000000130000330403330005010000000003000000000000100003000000030103000331300310000000000000
000000000000000000000000000000030030000000030010000000000001000000000100003000330003000000000000000020000030000000000300000330000001000001000000000000000000000000000300
000000000005000000000000003000300000000500000000000001000000030000000000300000000010000000000000000001500001000000000300000031500000000000000000000010003000000000000000
000000000000000033000000000000000030000000003000400000000000010400010001000000000000003300000000000000000000000000000000000000000000002000000000000000000000000000105000
000000000000000033004000000000000000000000000000000000100000000050000000000000000000000301401000000000003000000000045000030000000010000000000000020000000500100000060001
000000000000003030003000000000000000000000000100000000030000000000000000002000010006300000100000300300003000000003003030000001300000000000000050000000101000000000000000
000000000000030033003000000000000000000003000000000010000000000000000031000000000000303000300000000000003003000000000000100000000000000000000100003000000000000000000030
330000333333333333003333333300000103331333000000033303033333300000000000555000000000333300300300303333333003000033533330055500330333330000033333333030331303020030005500
