000000000000000000000000000000035000000000000000000000000000000000100001000000100000000000000000000500001001000000000310000000000500100000000000000000000000000000030000
000000000030000000000000000000300000000000020040000000000000000420000000000000000000000000100000002210000000000000000000300300030000002030000000000000000000300003003000
000000000000000000000000000000006000000100603000111110000000600160010100000000000000000004000000006630001000000000000000000002111110063000000000000111100000000030050000
000000000000000000000000000000600004000500660000000000000000000660000000000000000030000000030030006600000000000000000100000000000000066000300100000300000000000000000000
000000000000000000000000000000003000000000600000000000000100000660000000000300000000030000000003006600013030030000300000000000100000036000000000000000000000030000000300
000000000000000000011111110000000111110100600000000000001010100660000000000110000000000000100260006610000300000000600110000000000000000100000110100000000000300110003000
000000000000000000000000000000010000050000033003000030005000000333303000000000130000010000033330333333300000000001060000000000003300003330300001000003300000100000010300
000000000000000000000000000003000000000000000000000010100000000000000010000000100000000000000010010100001000000000300000000000000000000000010000000000000000000000000000
000000000000000200000000000000030000000000010000000000000000000000300000300000000060003060000000030300000000000000000000000000000000000000000000000020500000005000000100
000000000000006600001111110000010200000000000000000000000000100000100011011000300000001000000000020110100000030000100000000000000000000000000000000660000100000000000000
000000000000006600000000000000000000000000000000000001000300000000001005000000003000000020000000000000000000000000000020000000000000000000000000000600400000003000000000
000000000002006600000000000000000000000000000020000000000001000010000000000000000000000020010000003000000000013010000040100000000020000000206040200660000000100000000000
000000000000306600000000000000300000300100000003000000000000000003000000000000000000103000000100000000000110110011010003000000000003000001001000030660100000000000000000
333333333300003333330003300000000000002000003100003333030003600015000000030003313003303000000000000030000000000100000033333030333010000000003030000333333003033330000000
