000000000000000000000000000000000000000010000000000000000000000000000000000000003030000004000000000000000000100000000000010000000000000000300000000000000000000003005000
000000000000000000000000000300000020000000010000000355000006003000000000300000000000000000500000000000000000000300000300000000000000000000030040000000010000050000000030
000000000000000000000000000000400000044000030000000011000000000003000000035000040000000000000000000030000000000000001000000000041100003000000000000300001000011005000000
000000000000000000000000000001030100000000000030000000000000100000000000000030000000040000000000000000000000000000000006000400301100000000000000310000000000000000000000
000000000000000000000000000000000001000003003000200000100000000000005000000030000000000000000000000000000000000000000000100000101100000000000030000000000000000000000000
000000000000011000000000000000000000000000000001160000021000000000000000000030000000000000001000010000000000050010600000100005000131000000000000000100010000000020000030
000000000000000000000000000000000003133303000000033303030000000333333303000003353333300030330000000330353000000000000103033033333300300030103331330000000003333330000000
000000000000000000000000000000000000000000000000000100000000000001300000000000000000000000000000020001000000000000000000100000000000010000030000000100000000000000000000
000550000000000000000000000000300000000000000000000300000000000000000000000000000500000000000000000000000000530000000000000300000003000000000000000000000000000000001003
000110000000000011000004400000030000000000001040000000001000000000100030000000400100000000000000000001000000110000011300000000000000000460100000000100100005400000000000
000000000000000011000000000000000000030000031100000000000000300001100000030000060000005000000100000001000000000000000003000000000000000030000100000001000060000000000002
000000000000000011000000000000000000000000001001000000000000000001100000000000000000000000000000000011000000000300000000000000000000000000000000000001103000000000101000
000000200000000001000000000000000101000503061000000000000000000010100000300010000000100000000000000001100000002200000020000001000006000000000000000030000000000000000000
333333333333333333333333333333330300000000333333300000000000000335333300000003333334050000060000003333033433313033033010010000000000033031330000000333333303113330000000
