000000000030000003030000300330030000000001000300300000300030000000000000000010000300000303000300002003000000000000003000000000000300000000600003030106000000000000010000
300000000030003003000000000000030000000010000000035030003003010000000000000003000010300300031000000503000300000000000001000000050300300000003003000000000000000003000400
000000000000000000000000000010000000000000030000000000000000001000033600000000000060000030000000000000100000000600000000000303000000000000000010000000233300000000000000
000000000000000000000000000000001000000000000000006000000006003000000000000030010610000001000000000000006000000000000000000000000000000000000000000003000000000000330000
000000000000000000000000000000000000000000100000630006040000000660010000002300000000000000000002301010000000000000100306600001000000000000000000000060000000000000000100
000000000000000000001111000000000000000000111000000000000000001060000000000000000000000000100000003000000000000000000000000000000300030010000000000060000000000000000000
000000000000000000000000000000000000000033000000000000000000000333310033300000060001000000003000103000000000060003000003633001000000000003330300001330000030300302000000
000000000000000000000000000003300000000000000000010000000000000000300300000000003000000030001000000000000040000314000000000004010006000000030303000000300300000000030000
000000000000000000000000000000000005030000000000005100000000300000000000000000003000000020300000000000030000010000300000010100300300001030000000000000000000000000000000
000000000000000000333000000000000010040300000033000000000000000100000000120000000000000000105020000000000000001300060000000000000000000000000000001000000000000000000010
000000000000000000000000000000100000000000000000000000000000000010000000000300000000000000000000000000000000000000000000003010000000000000000000000000031000000000000000
000000000002306600000000000000000006000130660000000000000000000000500000000001000001050000220000000000000663001003000000000000000000000000000003000300006000000000020230
000000000000006600000000000000000040300000660000000000101000000101000000000000000000010000000000000006000660000010000000000060000000101100000000000111010000000000010010
333303333300003333000000033330300133330300553300000000000000003003005031335300000000000000033130030030303330300000000606330033300000000000000300000001010000003333330000
