000000000000000000000000000000000001000000000000001000000060500000000000000000000000000000000100000003000000000000000000000000000000000010060160000000000000030000000000
000000000000000000000000000000000000000100000000000000000050000000000004005000011000000030000000000000000000100000000000006030000000000000000000000000000000000000000000
000000000000000000000000000000300000000000000003300000000010000000100000000000030003000000000056000100000000000500000000000000000000000100300000000000000000000000000000
000000000000000000000000000001000500300000003033300000000000000000000001100000000331000010002000000300000000010000000000000000000000002000000200000000000000000300000000
000000000000000000000000000000000006600000000333303000000000000000000000000000003333400000066000603050000000000000000000000000000000066000000603000000000002000000000001
000000000000000000000000000010020026100000003333000030000000030000000000100000000333000000066000000000030010000000000000000000000220016005616600000000000000000020000000
000000000000000000000000000003033333333300303333300300003303000000000000000001333333000000033333331000000000030000000000030000040333333030333310033005000033333330000000
000000000000000000000000000000000300000000000000000000000000000000000010000000000000000000000000000003000000000000000000000000000000000000003000000000000000000000000000
000000000000000000000000000000000001000000001001000010001000000000030000000000000000000030000000100000000000000000005000030000000003000000000000000000000000000000000000
000000000000000000033000000000000300000060000030000000000000003000000000000100000000000000000000000001003100001000030000100005030103300000000030000000000000003330000000
020000000000000000333000003000000330000000000000000000000000000000050000100000200000000000000004000003003003000000000000000000000033000000000000030000006000010035000000
660000000000000003333000003000000000002300000000000000000100000000003000000006600000000101000000300010333000000000060340000000000303300000060000030000000000033300005000
660000000022020033333000003000003300000000003000000000100000202000000000000006600000000000000000300333033000020200000300000100003003300000000000000000300005333310000000
333333333333333333333333333333330330000300000000000000003333333000030000000003336133000000033033333333330336335003333000000000033333300000000333033000000003353030000600
