000000000000000000000000000000000000000000040000010005100000000000000000000010000000000050000000150000000000000010003000000000000000000000000035300000000005003210000000
000000000000000000000000000000000000000000000000500000000000000000300000000000000000000300000000000006000000000000000001000000000000300000100103000000000300000000000000
000000000000000000000000000003303030000110001000000001000000000000310000000000500000000000000300001000000010000000000000000000000000000000000000000003000000003000000000
000000000000000000000000000040000000201000000000000000000000000033333000000000130000030033300000000000000000000000010000003030400005000000000330030006006340002000000000
000000000055550050000000550000000300000000000000000500000000000000330000000000005555000300000300000000000000305500000000000000011000501000000003300005001000000000001000
000000000003300000000000033300000010000000220200000000003000000000000000000000000310400000000000000002000500033010000000212000000000100000000000000000030000100000000000
000000000000000000000000000030033331330333333033030000500133330000000000000000000000000000300000003333333004003300000003303303303333300010000000003000030030330333303300
003330000000000000000000000000333000010000000030000000000000000000000000000000000000010000000000000000006000303000330000000000000000010000000000000000000100000000000000
000300000000000000000000000000030003000000000000000000000400000030000000000000000001000000000000000000000000006000030000000000000000000000000400000000000000000000000000
000000000000000000000000000000000400000000000000000300000000000000010000140400000003000001000600000003000000000000000030003000000203000000000000000200100000000100000000
033333040000000000000000000000333305000300030000000000004000601000002400110000000000000000040000000000000000000003303310050030000000000100003000000000000000000000000000
000330000000000000000000000010033300000000000555000030003000000000000000055000000000000100005130000005000000000000020000005500000555530010000005515000000030055000000000
000000000000000000000220200000000000000350000033000003330030000220200000003330100000000000000000000000333000000003000010000330500533003000000020330000000001003334202000
000000333333333333333333333300000000000000000000000000000030353330303300000000000000333033303623330000000000000000000030000000000000030333630000000004000000000003300333
