000000000000000000000000003000000014000000000000000000304000000000000100000000020000000000000100000000000000000000300000000030000010000000003000000000000001000000000000
000000000000000000000000000001000300000100000030000000000000000000000000000000001000000060000000200000000000000000000000030000000000000000000130001000000400000000100000
000000000000000000000000000000000000000033000000000130000000000000000000000000001300300300300000000100000000000200300030000010000000000600000000000000500000000000000005
000000000000000000000000000000000000000100003000000000000000000000020000000000000000050000000000000000004000000000006000000000000200000000000000000000000000000000000000
000000005555000000000555550000000000000003055500000000000015530000600003000000000000000000000000000000003000000003000005555500055510100000000000000000000000020500505500
330000033333000000000333333300000000010000103300000000006303000000000030000003300000300000000000100040000000003000013003303033333300000300000000060000000000050303303330
000000000000000000000000000000030000100010000000000030000000001000006003000030000000000000003030000000000310000000000000000000000300000000003000000000010000500010000000
000000000000000000000000000000000000000000003001000000000002000000000100000300000000000000000000000000000000003300000000000000100000000000000000330000030000000000000000
000000000000000000000000000000303000000000000300000000000000000000100000000000000020000000100000000000000000000600000000001000000000000000000000000000000000002000000000
000003330033330000000000000000000003303333000000000000003003333000300000000000000633000001300000000000000000000000000000000603000000031033330000000000000333033330000000
000000000000000000000000000000000000000000400000000300000000010000003053000030000000000000005000000000000001030100000000600000000000000011000000000000000000000000300000
000000000000000000000000000000000010000000030000155555000000000000000045555000000100000000005555000000000055550000000000000000000020000000015505503000100000100000300000
000000000000000000000000000033000000000000000000033303330000501000000033303500000000300010033303003300000303303033000000001300000000000000003333033000000000000003330000
000000000000000303333000000003060000000000360033300030000000000000000005010000000000000000000000000000000003003000000010003330100000000000100000003030333300000000000000
