000000000000000000000000000000000000000400000200000000000100000003300000000000050010000000000000000000030000000003000000000000000000000313300003331000020300000000000000
000000000000000000000000000000100000000000000000000500000003001003333000000000000000300000300000030000000100000000000000000000300000000333300303030000000000500000000000
000000000000000000000000000000000000000000000000000000600000000333330000300000000532000000000000000000000000000000000000000000000000033333003310330000000000000000000000
000000000000000000000000000003031000000000000000050000000030000333033000000030005001000000000000001000000000000300000300001000000000033333200033300000000001000000000000
000000000000000000000000000000300000003000000000010000300000000036030000000030000000000000000000000000000000003000000000000000001000030333301333030000000000000001000133
000000000000000000000000033000001000000000030033000003330000200331333000003300000000100000000000200000530000313000002000000000000000003303303330330000000010005000000333
000000000000000000000000333033333333331333000333033330333300003303330333330330000000000000010000000003330333333033333030000001000006333033333113303333333330303333330333
000000000000000000000003333000333000000000000100000000000000000000100000000100000000100001000333300600000000000400000010000000000000100000000000000000000000000000000001
000000000000000000000033333003233000000000100000000000000000010000000000030000000000000300003003300000000000000000000000000000000000003003000000003000060000005003000000
000000000000000000000333333033033300000000000000000000000000000000000000001000000000030000133303300000400000000000000000000000000000100000000000000000040030003000003000
000000000000000000003333333003330300000000000000000000000000000300000000020000000000000300033343130030000000000003400000000003000000500000000001000030010000000003000000
000000000000000000033333333033333336030001040000000000000100000000010000000000000000000000003330300001000000000000000000000003000300000010300006000000000000003000000000
000000000002000000333333333003333300000000001000000000000000000000000300003300000000000000033333300030200000010000120000000333000033000000000000033000000000003300300000
333333333333333333333333333333333330000010001000000000000000000333333000033300000000000000030331033303033333003340000003000033000333033333330001000000000000033300000000
