000000000000000000000000000000000000000000000000000000000000000000040000000000000000060000400000000000000000000000000000001000000000000000040000000000000000030000000000
000000000000000000000000000003100010000000000000000000000001000300000001000000001000000000000000000000000000000000000010100000000000000000000000000003000600000000000000
000000000000000000000000000000000000000010003133000000000033330000051000000000300000000000000000000033300200000000000000000020020000000303000030000000000006000000001000
000000000000000000000000000000000000000000030330000000000330300000000000003000012000000000000005010330000000000000030000000000660000303333000004000000000000030000000100
000000000000000000000000000000150000006000030333000000000330330001001000000000000000000010000000013033330000000000003000000000661000003330300000000000000000303000000030
000000000000000000000000000000000100010013003333300000000330103000000000000030000000000000000000003333333010000300303000000000660000033303000000010000000000030000000003
000000000000000000000000000000000300000000333310330000003333333000000000333030000000000000000000003333330003503333033030000006030304033333330000000000000033333330000000
000000000000000000000000000000000100000000000000000000000000001000000000000000000000500000000000000000000000000000010000000000010000000000000000000300100000000000001103
000000000000000000000000000000000000000000000000000000000000000000000000000000000000000003000000000000000000000000000000000000000000003000000000000000000000000000000001
020000020000000033330000000000000000200000200000000300000100000020000000001000000000000000002000000300000001000000001000000000200010000000000033330000000002030102100000
660000300000000333300000300000000306030000000000000000000000000660000000031100000000300000060000010000000000300000030003000000010000000000000133030000000026000000000001
660000000000003333330003330030000006600000000006000033010003002060005500033300000000003000060000000000000103330000000000000000000000000000003302331000500066000000000000
660000000000033333333003330000000000000000000000301030000100000000000000303000016000000000066000000000000033300050000000000000000000300600003330333000000066050000000000
333333000333333333333333333300003000333030003333003303330100000333333033333330000000000000030313000000000033333310000000000000001333000001000333000000000033333000033333
