000000000000000000000000000002000010100001000001000003100000000000001000002001000000000000000000010000000000000100000010000000000001000000305000000000000000000000000000
000000000000000000000000000001000055110000200005000030000110000001001500000004000000000000020000000101000501000020000000000000000000000030002000000003000051005000000005
000000000000000000000000000000003000010000000300000000000000000000000000010000000003300003000010000001000000000000000000000000000000000001000000010000000300000000400000
300000000000000000000000000000100000000600333300030000000000003006000630000000330000000000033333003060000020000030331000000000000010030001003333300300000000000000000030
300000000000000000000000000000000000000000003330030000000000000000000030000001133300005000000333063000000050000003333000004003103000001000000303000000000000003100600000
000001100000000000000000000000030000201000301331000000112002000000000100000110003300100001030033010001010200200000003000000000000000000300060003300000000022020000000000
000000000000000000000000000033030333331330302330300100003333330303303300000003003333000060030033330000000033330030003030000000001000000000003003333000000033333303000335
000000000000500000000000000003000000000000050005000000000000000000305030000000000000000000000001500030000000001000000500000000000000000000000000020506000000000000000050
200000000000000000005511000010000000000000000000000000000000010000000000000000000000000000000000000000000100003501000000000005501006500000000000000000000000003300310000
000000000011100000000000000000000000000000000111000010000000100000111000010003000000000000000001100000000000000000011130000000000000000000000000000000000000000000001100
333330000000000000000000000000000000000100000030000000030000000000000000000000001300000000000000000010000000300001003000000000000000030100000300000300000500000000000000
033330000000000000000000000010000000005000300000000000003000000000000000000000000000000000000000000000000010000030000050000000000010030000002000000300000000000000300000
000330000000000000000220200000000000200000000000100000030000000000000000000000005000000000000000030000000000000000000000000000620200000000100010000000001000000060000000
300333333333333333333333333000001000000000130333300000000000000300304300000000500000000000033330300000000333330303303033333330331333000000001000000000000000000003330333
