000000000000000000000000000000000000030010000000000030000000100000005000000000000000000000000000000001000000000000000000000000000000000000000060000000000000101000000000
000000000000000000000000000000000000200000010000060010000041000000053000041000000000000000000003000000000000000002000000000000000000000010000600000000300000000000000000
511111101110100000000000000000000006600010010000300002000030000000000000150105611110000020000000000000000000000066000101010200511101101110100000200000000000000000000000
000000000000000000000000000003020006600000000000000066000600003000000010000100000000000600000030030000003000000062000000006000000000003000000006600000000000000030000000
000000000000000000000000000000000006600000010000000306000000003000000000000000000003060660000103031000000000000006000000030600000003003000003030600000100001000000000000
000000000000000000000000000000000006601000000000003360200003000000001000000000000000033602100010000000000000000016000300333600003100000000000336020000610000000000100000
000000000000000000000000000000000003330333000000033330303000000000000300000000000000033003333300000001333000003033300333000333000000000000003330333000033333600000500000
000000000000000000000000000000110100000000000000000000000000000000000000000050000000000000000000000000000000006000100000000000000000000100000000002004000000000000000000
000000000000000000000020000000000000000000000000000000300001000000000000000100200000000100001010000306000030000000000000000000000000000000000000010000000000000050000000
000000000000000000200660001000003000000000500111101001100000210000000000000006600000510111166000100101010000000000000000000000001003000000000000004600001001110000101011
000000300000000006600660000003000030000000000000000003000006000000000000000006600000000000066300000000000010100004006000006010000000000031030000000620000000011000001000
000000300000000036600660000000005050005000000000000000000036600000000000000006600300100000066000000000010000500000000000001000010100000000030000000660100030000000000000
000000000000000336620660000000000000000000000000000002000336520030000000000006600000000000060010000000000000000000000000000000000000000000000000000060000000000000000000
333000000003333333333333333331300000000333000000000000100033303000000030000003333003000000003335330503000000000000000000000000000033033300100000000333333000000000000000
