000000000000000000000000000000000200000000303330010005100000050000000000000000000000000200000000000000000000050000006000000000303030030006000000000100000000000000000000
000000000000000000003000000000000000000000060300000000500000000000000000000000000000000000000000000000000000000000010030000000000301000000000060000002000000000000000300
000000000000000000000000000000006000000003010310000000000000000000000000000030000000000000000000000000000000000300110000000000000000002000000600000000000000001000000000
000000000000000000000000000000000000000000003333000000000002000000006000000000002000100100000000000000005000000100000000000006000303000000050000000000000000000000000000
000000000005550000000000055000005000000000000000000000020000000003055000000000000000000000300000001000000000000000020000006000000100000005500000300010000000005500003105
000000000000000000000000033300013330012000000400003000000000000000033300000000002001000000000050000100000000000000000000000000000000000003030000000010300000003000000000
005000000000000000000000000000000063300033300000300000100330333000000030033333003333001030300500003303333433330300000300334333300000300000000050000333003000000000000000
303330000000000000000000000000000000000000000000000000000000000000000000003003300100306330000000000000000000000300000100000000030000004504003033000000300000000000000000
000300000000000000000000000000000000000000000000000010040000000001000301000000003000000360100000000000003000000000000006000000000000000000010063000000000000000030000000
000000000000000000000000000300000000000000050000000000000000030000000000001000000000050000000060000000003000000000000030000000000000000000000006000000000000000000000003
003333040000000000000000000000000600000000006000000030600000000000000000000000033330003333000000010000001000000000003100000000400010000002000033300400030000000003100000
000000000000000000000000000000000550000001100000000300000040535003000003000000000000000000000001550000000000005000000000000000050000000005000000000000000000000000003000
000000000000000000000000200000000600000000000000100000000000000000000050000000000300000000000000000000000000003300010000000050100000000100100000000000050000000000002000
300000333333333333333333333300000003133503303133300501000000000011003000501003000003300000300000000030030000000530000030050000033003300000003000013333333300000003333003
