000000000000000000000000000000000060004000010000000000000000000000000000000003000000010005000000000010060000000000001001000000000000300000000001000000000000000000300000
000000000000000000000000000300300000000000000000300000030000000000000000000330000000000003300000000000003000000000000000000013003300000000000000010000000000000000000000
000000000000000000000000000003130000000010000003300100000001300000000000000330000000000003000000000100000000000003031030000000300000000000000000000500010000000300033306
000000000000000000000000000000230000000000000030300000000000000000000000003330000000000031603000000000000000000005030000000000030000000100000160000000000000000300623000
000000000000000000000000000000000000000000000030000000000000000000000000033333000000001006300000000000000000000100000000000000000000000000000000000000030000000000010000
000000000000005000000000000000020000333300003333302000000000000010000000333330330300003033350000000000003000120003000000000000300000000000000000000500000000000000000500
000000000000000000000000000000063033333330033300300001000000103603302330333330330333333330303001040000000100000000030031000000330003330000006000300000000000000000000000
000000000000000000000000000000006000000006400000000000000000000000000000000030000000100000000000000000000000000300000000000000000020000000100000000000000000000010000000
000000000000003000000000003360000010000000000000000000000000000000001000000100000003000100000000001000000300000000000100100000000000000000300000003003100000000301000000
300000000000003303303000003300000000100000000330001000100000003030031301000000000000000000030000003000100330300300000000000000000000000000330000000300000000000330003000
000000000000000023000000033300001000000030003031000000000001000002300000000031000000030000000000000500010002300000010000010000001000000003300000000000000000003330000300
000000000000000000000000333300000000030000000000000000000000000060000006000010000000001000000000000000000030000000000000000000000000000033330010000000100000033330000001
300000003333000000000003333300001003000100000600050000300000000000000050000010000000030331000000003000000600000030003000000000030300000333310000000030330000033303000000
333003333333300003303333333300000003300034000000000101000303000000330301000000000000033303000000003130033000333300000000000000333330133303330000300333033033333303330033
