000000000000000000000000000000000010000300000000000000600000000000030000000001000000000000050010010000300003000000000330000200000000000000000000000400033300000000000000
000000000000000000000000000000000010003000000000100001000000000000000000000500001050000100000000000001003000000000000030000300000000000000000000000000000300000000000015
000000000000000000000000000000000000000000000550310000000000000000000000000000000000000000100000000030003000000000300030003000000000000000030005003000000300000000000030
000000000000000000000000000000000000000000000000600000000000003001000600000000000000000000000000060303003000000003330330000000010000000000000000000060003300000000000100
000000000000000000000000000000000001000050000000000000000300000100000000000000000000000000000000000303033000000003533001000000010000003000000000000030333300000000000001
000000000000000001100000000000010003000000022000000011000000000022001000000020000100000000002006030003033000000003030330000000000003000000600000100000303300030000000002
000000000000000000000000003300000000000000333363000000000000000333333300333330000033000000033333033333033000003030333000000000333300300000000000000033333300000333333333
000000000000000000000000033300000030000000000033300000300100000000600000000330000000000000000000000000000000000000000000000000004000000000000000000000000000000000000000
000000000000000000000000000300000000000000000000000000000000000000000000300030000000000000000000000000000000000060000000060001000000000300105000000000000050000006030001
000000000000030000000003000300000000000000003000300000000000003000030020000000100000000001000000000000000050000000000000000013000003000000000000003000000000000000000000
000000000000060000000033303300000530000000003303300010000000106000103003310030000300000000000000000000000000000000000000000006000000000000000000000400000030000000000000
000000000000000000000030333301000000000030330333300100000000001000000003633310000000000000000000000600100000000000000000000000000030000000000100000030000000100000000000
000000002200000000002030333300000000030000030333300000020000000000130003030030300003000000200011100000000000000100311000220030000000000000120200000000000000000000000003
333333333333333333333333333330003333633333333331303303330300000030000033333331030333303033000000003330333000000000030013033333000000333303333030333000000000000003330330
