000200000000000000000000000000500000000000003335000000000020000000000001003000000000000510000000000040000000000000333000002303030000010000000006000000000100000000011030
000000000000000000000000000010000010000000000000030000000000000000300000000000006000000000300000000000000000000000000000000010000000000100000000000000000060000035000000
000066000000000000000000000030360000000000000240100000000000000000000001001000000000000000000000000000000000000000020000003060000000000000030200000000060000000000000630
000063000000000000000000000000001000000000000000000000020000002000000000000000000000000001000100000000000000000000000000000630000000000000000000000000000030000000000650
020066000000000000000000000000010013333033006000000000160200066001000003303330010000031033400002000000000000000000000000200600000000000000100000000010000003000300006060
333333330000000000000011110000003300010000000100000000600000066011110000003000000000000000000000000101100060000000000003303303111110030000003000000000000000000013333333
000000000000000055200000000060000000000000001130663333333603133100000000000000000000001000000000000000000005500000033030000000500010000000000000000005000000000000000000
000000000000000033350000000000000000002000000010030600000002000000000004000000003050000000000020000010313000000000300003000000000000000000000002000000000000003000033150
000000000000000000000000000003060000003000300000000000000000010000000000200000000000000000000000000000000000000000000000000000000000000000100000000000001000000000000300
333300000000000002400000000000000000010666000000000000000000660000000000030300300400000000000106600001100333010000000000000000603300000000000000002000000003001030002400
000000000000000000000000000200000000000610000000000000000000630000000000000000600030000000200006300000200000000000000000000012000000000000000003000000000200000000100000
000000003333330000000000006600000000200660000000000000030130060001000000000000001000000306000006000000006000000000303301000063000000000000000003000000006600000000000010
000033000000000000000000006601001003333330000000030000003333003000000000005300000303000000630023000000000000030000000000100066000030000000000101500000006600003020000000
000000000000000003333333333300006000000003030520000000010000000005500000000000003333333300301100000003333100000000000003333333000000000512000000000110336000000000063333
