000000000000000000000000000000000000000000000000000300000000000010000000000000000000000000000000000000000001000000000000000000000000000000000000000000000050000000001000
000000000000000000000000000001300000000000000000000000030300000505000000600050000000000000000000000000000000000000000005050000003013200000000005000000030000003500000000
500011111110111000301111111100000005000011000000010030010003000101313100000050000000300000011110111000001500010100000001110110000011110100131111021000000000003110000010
000000000000000000111000000100060000000000000000000000000000030001000000031130000000000003000003000000111000000000001010000000000000002000010000000000010000000000000000
000000000000000000111011111130000000000001030000300000003000000000003000001110000000300000500000000000101003000000000001100000000013000101110000000000000400000003000050
000000000000011000011111111100001000000330000000000000010000000002000010000130000000000000600000000003011000000000000000020000000000001111110000001030000600003020005000
000000000000000000000000000030330330000000030000300000003033303333340300000003300003033333300000000000000000000030000030333303330333300030000000000330000333303333030333
000000000000000000000000000000000000000400000000000000000030000001000000000000000000000004000030000030003000000063060500000000010000000000004100000000000050000000000500
000000000000000000152555000000040000000152050000060010000000002100000006001520000000000000000000000010052555010200000000000000000000000000000000001005000002000000000003
000000000000000000111111111100000010000111101110110111111110111500001000300011111010111011101010033000011111111011100001000300000600050301301011111010010150000111000303
000000000000000000000000000000001100000000000000000000000000001000000000000000000000000000100000000000000000000000000003000111000000060000000000001000000000300100000011
300000000000000000000000000000001110000000000000001011050111100100000000000000000000010161100006310000000060000000005000000111300000000000000101111000000000030000000111
000000000000000000002002000000000610000001002000011311105131111000000000000020000001101110400300000000002000000000030001000011000000000030011111101002000000200001000311
333333333000033333333333333304000003330330333033300030000000000000000030033130000000000000033000030333110333333000000000000000302333300000100000000333331300000320000000
