000000000000000000000000000000000100000000000000000040000300000000000000010000001000000000000000000000000000000000000000000000333000000000000000000000000010000000000000
000000000000000000000000000000000000000000001000000000000000000000001100000000000003000000000000000500000000003001000006000000333300000000100000000000000000000000000000
000000000000000000000000000000000000500000010000000030000000000000000000000010000000000000013001000040000000000000000003000000333300000000000040300000000000004000000030
000000000000000000000000000000002000100000000000000003000000000003000000000000310033030000010000000000000000031000300010000200330300030000000000000300020000000000300000
000000000000000000000000000000006003000001000000000000010000000005000000105003003330100000000000000000000000000000300000006600333300000000000000301000060100000000000000
000000000000000000000003300000066000000300000400000330000000000003300001010000000133003300000000000300100000050000000000016000330300000000000100001000660000000000000000
000000000000000000000023300033133300000000000000002330000000000000300000000003000333023300033333030000060000000003330330330330303033300000002000030330303030333330000000
000000000000000000000333300000000000300000000000003330000000001000000030030000060000000000000000000000000333300000000000000000000000000000000000000033030010000000000000
000000000000000000003333300000000100000003000001003030000000031000001033330000000000000000303000000000000330300001000030030000000000003000000000000530300000000000000003
000000000000000000033333300000010000003031000000001330000000000300000033330000000000000103000000000000000333300000000300030000000300000000000000500330300001000000000030
000020000000000000333333300000000000000330005000033030000000000000000133330000000000000030310002000001000303300000003030001000000000001000000000000300000000000000300333
000660000000000003333333300000000600003033000000033330010000000000000006330000006300000333300060005000000331300000033040000000000100000000030000000000330000000000000330
000660000000000033333333300003000300000333000000030030000000000000000033130041006600000000000006000000301333350000310300033030000000000000000033000333300000000000233333
333333333333333333333333333300000003333333333333330033033333333100000003103333333333303330530300330000000333330030033030030000000001000000000233000133033300000003363303
