000000000000000000000000000000000000060003003000000000100000000000000030300000000000000000000000000000000300000000000000000000000000000000000000001000000000000000000000
000000000000000000000000000000000300000000000000000000010000000000000000000000000030000000000000000000003050005000000000000000000000000050000005000000000000000003000000
000000000000000000000000000033000000000000000001200000003303000000055000000003000000330000000000100333000000053300003003333000000000000000010005002500000000000000000033
000000000000000000000000000033000000003000000006600000000000050000001000050000000000330000040000000000000000033000000000000000000050600003330100166000000110300000000300
000000000000000000000000000003010004000000030006000000000000000000103000000000000000130000000000000000000000300310000000000000000010060003330000060000000000010000003333
000000000000000111100411110000000000110000000006041111000000000000000041111030030001330000002111000000000033003300000000000000001000003303330300066000601041111300333034
000000000000000000000000000030000331000100303333000000003333303000300000000000000000300003300000003333333310330000000003033033000000003033300333333000000000000003333000
000000000000000000000000000000000500000000000000000000000000000000000000000000000000000000030000000000010000000000000000000000000000000000000300000000000000040300000000
000000000000000000000000000000101000000030000000000000060000000400060000000000000010000000000000000000040000100000000006000000303003000000000000000000000000200000000000
333300000000333300000100000200000333330000000000030000002000002000010003000000000030100000200000000000000000000000000003006000331000000000000130000030000000300003333003
000000000003333300000000006600003330000000000000000000000100060000000030000000000033000006600000010000000000001000000660000005300060000000000000000304000600100000000000
000000000033333300000000006600033300000000000000000000000000103000300033000000503331000000600000000000000610010000000063000000330000000000000000000030000000000000000000
000000003333333300000000006602010130000000000000001000000000060010110003000000330303001006600300000001000011110000000660111000330000051111000111100330000000000000000000
333333333333303000033333333331303300333030000000030000003333333000000030000333033330033333300000000000000000000030333030000000100003100000003000000300003300000003333333
