000000000030000000030000000000303000000000000330001000000000100003000000030000000000000300000000000100000000000000000000000000000003000000000000000000300000000000000030
000000000000000000000000000000000320100000000000000000000000000000000000000000000000000001200030300000100000000060100000000001000000000000020000300000000000000000000000
000000000000000000000000000011000000003000000000000000110000000000000000000013000000100000000000000300000000000000500000000000100000011001000000011001000000000000000000
000000000000000000000000000000000000000000000003000000000000100000000010000030000010000000000001001000000000001000000000000000010000000000000000310060300000100300000000
000000000000000000000000000000002000000030000000006000000000060000000060000020060000000000600000000000030130000000000300000500000000000030606611300000000005000000203000
000000000000000000001110000000000000000100000000036005000000000000000006050000000000000000000010000000030110000000000000000000000000100000006600000000000000000000300100
000000000000000000000000000000000303330030000003033030300333330030303033030300000000000003033303303303030000030033000103030333000000000000030033330000050033330330000000
000000000000000000000000000000010000000030001000000000000003000000000010000000003030000000000000100010001000300000030000300000000300000000000000030000001000000000000000
000000000000000000000000000230000000000030000000000000000000030000000000000000000000000000000000000003000000030000000100003000000300000000000000000000000000000000000001
000000000000000000011110000000000000000000000000000000003000000000000011000011000000000000000000000000011000000103000110000300000000060000000000010000000000000001000000
000000000000000000000000000000000000000010130000010000000000300010000000000000000000000010000000000000600000000000000000000000000000000000000000000000000000001000000000
000000000000306600000000000000000005000000000000000000000000000000000001000006000100000000000100106600000601000065003000030000000010000000000003000000003000000000000000
000000000000006600000000000010000000000001000000000000000000000100000030000000006001000100000000011000000000000066000000000000000600611000000000001000000000000000000000
333333333333303333330000003300000300000500300333301300000000000000000000000330000000000000000000003330310000000033353300000003300000200300000000000033333000000001000031
