000000000000000000000000003301006000000000000000000000000030100000003300000030000000000000010001000000000000003300300000000000000060100000000000000000000000001000000003
000000000000000000000000000000000000000000000000000000000000010010100030000000000000000000000300000000100000003000300200000000000000000000000000000000000011000000000000
000000000000000000000000000000000000000000003303000000000300000000000000303303000100000000000000000000000000000000333333000000000000000000000000000000000000000000000000
050000000000000000000000000000000000000000000000001300330000010200000000000100010000000010050000000005000000100000000030000000000000011033301030330000000000100000000030
030000000000000002000000000000000000000100000000000000000000000010000003000000012000100000000000000000000000001000000300000011000000000000000050030000010000001000300330
555000500000044002000000000003000000000004000000100000000000004000000000000003002000400200000003000000000000000000000000000010000010400000000000000010000040020001000004
300000000033300033330000000010000000003300003000000000000003330006000000300000033330000333500000000000000000000000300000000000000033000000003006000000000000333300003000
000000000000000000000000000000000000200033000000000000000000000000000000000000100600006000000000000000000000000000000000000000000000003000030000033000000000000000000300
000000000000000000000000000000300000000000000000500000002000006003000300005000000400000000000000000000000000000100400000000000000000000110000000000000000000000000000300
003333330000000000000000000030000000000000000000000000000000000000010000020000000001000000000313000000000000000000000000030000000060000000000000000000600000000000033313
000000000000000000000003333300000000600030000000305000000500000000000000133330000000303333100000000000000050000000000000300000050000000000000050000003004005000000030004
000000000000000000000000000000000000000000000200000000000300000000000000000000000010001000000000000000000330000010030000002000030300000000000000001000000000060400000000
000000000000000000000000000000000000200000400000015500055150005000000001000000000020000000000000050000004555000100000004002000555000500000000000000000000005500050000003
003000000000000000000000000000000300000000000330000000003000030000000000000001000000000000000300000030330300000010005030033130300100000000000000000001000003000000010000
