000000000000000000000000000000000000000000303330000000000000000000100600003015033006003330000000000000000000000030303060000003001030000000000000000000000000005000000000
000000000000000000003000000003515000000400000000000000001050500000000030000000000000010000000050000055500400000000000500105503000000000000000000000000000000050000300003
000000000000000000000000000000001010000030400003000000001000000000000000003031200000000000006000000000000000001000000000000000000000000000000003000000000003000000000000
000000000000000000000000000000000000030000000000300000000000000000000300000000000000000000000200000000000000000300000000000000000000000000000000010000010000200040013000
000000000000000000000000000000000000000300000000300000000010000030003300000000000000000000000000010000000000000300000001003000000000000000000030333000000000010000000000
000000000000000000000000000000022000000000000000000000300000200000000300000000000000000000000000000002200010503300300000001000000000000000000001303000000000000000001030
005500000000000000000000000031333333030333330003300000003333333333333300050003300033310003330303320300030303303033000003330000000000000000003333300000000035330330000000
303330000000000000000000000000000000030300000300001000000000001000000000000000000000000140000000030104000300000000000001010000000000000000003033300000000000000000000000
000000000555000005000000000003000000001000000000000000010015000000000300000000010000000000000000030001000000010000000000000000010000000050000000002000010000000300001300
000000000000000000000000000000300010000000000003001100000000000000000000000000000000000000000000000003000000000000000000000000000000000000000000000000000000000000500000
000000000000000020004000000365150030000000000000001000003030004000100000030000000060000000150100000000000000000000000030000000000000000000010100400160000000000000000000
000000000000000000000000003300000350000000000030100000000000000000010000000000000000000000000500000000000000000000000111000000003000000010000000000000000034000000000000
000000000022000000000000033300003010000020000000000010600000000000000010000000000000000000000000000000000000000000000130000000000005000000000000000000210000000000000000
330003333333333333333333333333300330000000005000000000003333333020000000000000000200000000000000000003000005500033300330000000005500033333033300031303303300050000010000
