003000000000000000030000000000000000000030000000000000000000000000000003000300000000000000000030000140100000000000000330000000003000000000000030000000000000320000000001
000000000000000000000000000000000010001000040000000000000000000030000000000000000006000000000000000000000000000000000000000000000000000000000000000000000000000000000000
000000000000000000000000000000000030000000000000010000100010000000000000030001060000100310000010330000000000000000000000030000000000010000000100000006000000010000130003
000000000000000000000000000006003330000000010000000000003000000000000000020000000000000000000023330000000002006000000003000000000000000000000000000000000000000000003333
000000000000000000000000000000000330000000000000010000001000000000000000000000000000000000003000120000000000000000040003000000300000000003000000000000000030000000000033
000000000000000000000000111000000330101000000101000300003000000000000000000000000000000000010000030000030300013030003003000050000000010003500000010000100000010001000033
000000000000000000000000000000000000000000000000000033330033333030000000000003303333333333300000000000000003303300000010030333000000033333010000000000100003330030000000
000000000000000000000000000000300000000003001000000060000010000000000000000000000000000000000300000000001000010010000000000030000000000000010000010000000000000000003000
000000000000000000000000000050000000010000000600100000000005000000000000000000000000000300000000000600000000000000003000000000030000000000000000000000000000010000000000
000000000000330000000100000060000000300030300000000000006000000000000000000300000000500000000000000000000000000003000300000002000100000000000000000000000000000000013000
000000000003333000000000000000000000000000000000002000000010000004000060003330000000000000001000000000000000000000303300000000000000000000001000000200000030000000000000
003333000000333000000000000000000000333330000000030000000030000000000000000006003330000103300010000000005000000060000030100000003336000000000000002000000030000000033330
003333000000333000000000000000000000033330000000030000000000000000111000000331103130001333000010004031110030000200000030001100000033000000000050010030100030000000033330
333300000000000033333333333301000013333000000000000033330000000000000000000003303000330300000000000000000003000000000000000000030301000300000000000000100000330330033000
