000000000000000000000000000000000000300000000003000000301000000000000000000000000000000000000000000004000000001000000000000001000000000000000030000000003010000000000060
000000000000000000000000000000000000000000000020000000300000000000000000000000000000000000000005000000000000000000000000000000000000000000000000110060000000000040000000
000000000000000000000000000030000001000440000000000000000000000000300000000000000000000000000006000000000000000040000000000000000000000010000400000000005000000000300000
000000000000000000000000000000000000000000000000000000000010000600000000000000000000000000000000030000000000000000000000000000060010000000000100000000000000000006600000
000000000000000000000000000000000000000000000000000000000000000000000000000000000000000000000000004000000000000000000033000000000000000000000000000000000060600006003000
000000000004000000000000000022000000006000300000000000000000000002000000000002000000230000000000100000000000600000220000000400200000100000000020000220000005000006620500
000000000000000000000000000033300333303333000000000006000000000333333000000003330030033003300000000000000004100000333030100300133303310000003303333033300300000003303330
000000000000000000000000000000000000000030000000100000000000000000000000001000000130000360000000000000000000000003000000000000000000000000000010000000010000010000000030
000000000000000000000000000000000000010000000300000000000000000000000000000000000000000000000000000000000001000030000000000060000000000000000000000300003000006000000200
440000000004400000000020000000040000000010440000000000030000500440000000000000000440000001000104400400000010000000000000200000000011100000400000000006000001000000000440
000000000000000000000660000000000000000000000000066000000001033000030000000030030001000000000000000001000000000000100006000000000043000000000000000000020003000000000000
000000000000000000000660000000000000000000000000046000000000000000000000000003000000000000000000000030000660000000000136600000000001000000000000000000000000000000000000
002200000000002200000662000000134000000000002200066000000000400002200000000000001000000030000000000022000002400000000001620000000003003000000000400300000300000000000000
333333333333333333333333333010000603100100313303333335300000000333033300300003300030000000013333300330330343333000000001133300000000033333030000000003000000010003333033
