000000000000000000000000000000020000000000000000330000000000000000000000000000000000000000000003030100000000000000000000601300000000000000000000000000004000000000000000
000000000000000000000000000000000000000030000001000000000000000000010100000000000100000000600005000000000000000005000000000100000000000000000000000030000000000000000000
000000000000000000000000000003000050006000000000000000300000000000000000000000000000030400000004000000001000006000000020000060000000000000030000000000000000010001000000
000000000000000000000000000000000000300000000000000300000003066000000000000000000100040000300020000000163000000300000660000000030200100000000001030000000000020000300006
000000000000000000000000000000030000000000006600000000005000066000000100000000000100000050030660000000001000000002010660000000006000000000000000000000000000663003000066
000000000000000000000000444400000000004110006600000000000000066000000000000010000000000000200660000004444000000020000660004444006300030000000000000000000000630000000006
000000000000000000000000000000000000000000333333300000003333133000000000000000000000033133303300330000000300000033033330000000303003300000000000000000000031330033000300
000000000000000000000000000000000000000000000000000000000300000000000000000003000000000000000000000300000000100000000000000000000001000000000000000000050000060000000000
000000000000000000000000000000000000000000000000000000000000000000000000050050000000000000000000000010000100000060100000000000000000000030000000000000000000000000000000
000400000000020000000001111100111110000000000000000045000000000000400000000300011113000000000000050000300000010103111300000000000400000000000014000001110100000000000001
000000000000660002000000000000000000000166000000010000000003050000000000020000000000000000000000660000000000000000000000000000000000000000103300000000000300003000000000
000000000000660066000000000000000000000066000000300000000000000000000000000000150040000000000000060000000000000300000000000000300000000000000000000000000000000000000000
000000200000660066000022000000200000000006000000000000000004444001000200660000020000100000004000660000000020000002200000000000000000200000000000102020000000044640000000
333333333333333333333333333333331333033303001000030343330000030333033333033033033333000000033303330000000303133333303330003000333033300010003333333333333300000000010000
