000000000000000000000000000000000000030000000000000000000000000000000000000000010000000000000000000300000100000000000000000000010000000000000000000000000000000000000100
000000000000000000000000000003000000305550100000000000000010000000005303000000000000000000000000000000000000001000000000000000000000003000000000000030000000050000005000
000000000000000000000000000000000000000000030033030000000000000000000000000000000001003303000000000000000000000001333300000000000000000000000000015000004003313300000000
000000000000000000000000000001000000300100030001030500000000000000000000000000000606330000000005000000000000000033010000000060000030000003033000000000000003000000600000
000000000000000000000000000000300000000000000000000000000000000000000000000000000000000300000010000000000000000000000001000006031001000300003000000100000060000000000010
000000000000455000000000333300031030000000000000300000050000000000000000000400000000000000300000000003333500000000000100200040000333300000005000000000004500000000000000
333000000000000000000000000000000003333030000000300010003330000333033000000000000333000030330310000000000060000000000030000010000000033330000000000000000000000033330330
000000000000000000000000000020000003000040000000005006000000000000401050000000000000000000000000000000000000000000000000000000000000000000000010004000005000000000000000
000000000055533300000000000005000000003000000000033000000000000330000000000000000000000055333000000000000000000000000000000000050555300000000000003000000010000003000000
000000000000000000000033333000000000300000000000000000000003000000000000000000330303000003000000000000000000040000000000030105000000300005003000005000000000300000000000
000000000000000000303330000000000003030000000000000030030000000000000300000010300000000000100000030000000303000000360000000002000000003300000000300000000000000000000303
000000000000000000000000000000130000300000000000000000000100000000000000000000130000330000000010301000000300000200100000000000000000000000000000000000000000030000000000
000000000000000000000000000300000000000000001000000000000000000030000000033330010000000000104000000000045000000000000000000001101000050000000000100000500000130361030000
000033333333303333000000000301000003330000000033333000000030000300200300000000000003333331033000000000110000033303300000000333333033000001000000333503000100000003330000
