000000000000000000000000033300000000000000003000000000020000000000000000003330000000030000000000000000000000005300000000300000000000000026010000000000300000000000030000
300000000001300000300000003030000000000000010014003000000030100000000000303000000000000000000000000000300000005000000000000303000300000000000000100100000000000000000000
000000000004000000055000000000000030000410000033000000330000400000030300000000000300000000030000000000055000033300000105000005001045000000330000400000000000000000000333
000000000000000000000000000000000000000000000000000000000000000000310010000000000000000003000000000000003000000000000000000000000000000000010000203000000000300000000000
000000000000000000000000000000000000000000000000005000000006020200000010000000000400000000000010000000000000000000000000000000000000000000000000000000000000000010000000
000000003300000000550530000000000000330000000000100003000300000000000053001000000000000000032210000000500000000000000000300550030000000005001330000000000000210040000000
000000000000000000000000000003000000000000010000030000000000000300000000000000000000000003300333600000000000000000003330000000000004000000000000000000003003333330000000
000000000000000000000000000000000333003000000000300600000000000000000000000010000002000033000000000000000000000000003330000000000000000000000010000100010000000303000200
000000000000000000000000000000010300001300000000000000000000300300010000010000000000001000005001110000000300000000100003000000000000000000303000000050003000000000500300
000000000003330000333000000005000000000000000000000010000010055000000000005002000000010003000004010001033000005000000000000000000003300010001000000010004000003231000555
000000000000000000000000000003000000000000200000000000000002000000000000101000000000000000001000000000000000000000000000000003000000000000000000500003000000000000000004
000000000000000000000000000000000000000000030000000000000010000003000030000000000000000000000000000010000005100000000000000000000000010000000000020000000003030000000000
322100000000000000000000000053000300000550020006000000000000600000000000000003201000530000003300000000000000000053000000000000000010032010300000000530000000000000000500
333333330000000000000000033300060010000000303333300003000000000000000400010303330330001000000000003004000000000000000010000000300000030333000000000000000030000000000000
