000000000000000000000000000000000000000000003000000000000000000000000000000000000001015000000005500000000000000000000000000000000055000000000000000000055000000000400000
000000000000000000000000000000000000000005000000000000000400000050000600000000000000010000001500000003000500000000000050500000000000000000005500000000000000000100030000
000000000000000000000000000000000003000000000000000050000100004000001000000000000000000000000111000006003000000000000000005060101111000000000000000101011000000000000000
000000000000000000000000000000000000360000000000000000010000000000000000000000000000000000000000000000000000000002130050310000000000003030010000100000000000000000000000
000000000000000000000000000030000000000001000000000000040000000000000000003020000100300000000006000010000003010000000000000000000000000000000000000000100000003000000000
341004414111000000000000000014111000000000000000034100000000300026000250111000210000141110000003000000000000000000000300200002000000006000001200000300000000000100000006
000000000000000000000000000000000000030330000000000000000333033330003300000003033301000030000033501333330303303303303003030333330310310000010333333333333300000000000006
000000000005500000000000000050000000100550141000000000000000553000000100100100000000000000000000030002000000000000000000000000000000000000000000000000000000000000030000
000000000000000000005550000030000000000001530000000000000000060060000030000060000000000000000000300000001000001000000000000000000000000000000000000000000000000050000000
010000410111100000000000000001000041000110030000001000300010310000000300000000000000000000000000000032403010000410000000100000010000000000000000030000000000000000300004
000000000000000200000000000000000000000000000000003000000000000000000000000000000000500000000000000000000000000110000000000003001300000000000000030001000002000000000000
000000000000000000000000000000330000000000000000000100000000000010000000000006000000060060000000000000000000000000000000000000000000001000000000000000003000000000010000
000000000000000000000020000200000000000000020000203000000000000000000030100040000000300000054300440000000000000034110041410000000000000005001401000041000400000000000000
333333333333333333330333333330333333303033303303000000003303333010060000000000000000001000000000100030000330330300001000030000303003000000000000001000000033033000033000
