000000000000000000000000000000000030000000005000000030000000000000000000100000000003006000003000000030000030000000000000000000000000010000000000000000000000000060000000
000000000000000000000000000000000000000000000000000000000000000300001000000000406000000000000003300000000000000000000310000010000033001000000000000000000000001000000600
000000000000000000000000000001000100000000000002000000000000000000000000000020200113001000030000000000010050030000060000000000000011301000100000000000000000030000000000
000000000000000000000000000066000000000000000000000000000000001000000000000000600500004000000000000000000000000100000010300000001300006000000030000030003000000000000000
000000000000000000000000000066000400050000000000000000000000000010000000000006600000000000000000003000000000000030030060000000000000066000000000400000000000000000003000
000000000000000000000000000066200000100000000000400000001102000000000010000006650000220000000000002003000300000000000006100000000000066200000000000220100000030005000000
000000000000000000000000000033031000000000000000000000000000000000000000003003333000033333300000001333333000000000000003333303000000033330000005000030333300000001300300
000000000000000000000000000000100003000000000000000000000000000000001010000001000000010003000100000040000000000000000000000000000030000000300000000000000000000000000000
000000000000000000000000000000000000000000005000000000000000000106000000000001000000300000100000000003000300000000000000000003000000000001006000010003000000000000000000
400000000000000000000020011000000000000000400000040001000010010001000040000000003000000010041000000003000000000300000030000000000000040000000000000000001000002004000000
000000000000000000000660000020000000000004000000000005000060000000006000030000000000660000010000010010000000000300000000000000000000300000060000000660000100000000000000
000000000000000000000660000000010000020000000000010000601000000000000000000000000000660000000003000000000000000000000000000000000000000000100000000000000002000000000000
000022020000002200000662000020000002210000001000000001202000000220000000002200001001662000100000200000000000000000000000010000220000000002200000000662000000000000000200
333333333333333333333333330030303333333300000300033130333333333035333033303000000000333330133333330000000000000010000000100000033333010333300510000303030103000003330000
