000000000000000000000000000000000000000300000000000000000003000000001000000000000000000000000000003000000000000000000000000000003000030000000100000000000000000000000000
000000000000000000030000000300000000000110000300000302001000000060020006000300000000010000300000000000000000000030060030000000000020000000000000000000000000000300000003
000000000000000000000000000013001000000000110000001060000000000000663000000000000000006600000000060000000000003000000000100000000600003100000000000010000000000000000000
000000000000000000000000000000000000001000001100000066000101000003000000000000000000006600000100030000000000000000000000010020000060000000030001000000000000000001000000
000000000000000000000000000010004000000000000110000060000101000000660003000000000000106000000010000000000000000000000000001000000600000000000000000000000000000500500000
000000000000111000000000000010000000000000000001000166000300000000660010100000001000006600300000110050000000000000000000000000000660000000000000011000000010000000000000
000000000000000000000000000000000000000000033000330133133330033333030000000000330333300033300001003000333000000000000003330031313330333333030000000000000100000000000000
000000000000000000000000000000000000000000000000000000010000000000000000100000000000003100030000000000000000000000000000000000000000000001000000000000000001100100002000
000000000002000000000000000000000000004000000000000000000005000000030300000000000000000003000000000000300000000310000000000030300000000030000040000600000000000300000200
000000000066001100000006600000000001000000000000000600000000000000000000000000066500000006000060000100600000000003001000000000006300000060001400000006600000000000001600
000000000066000011020006600000600030000000000000000660000000000000010300000403066000000000000066000041120000000000010000000000016600060000000015000000600000500000001300
000000000066000001000006600000000000000000000000000660000000100400000000100000006000000000020066030001000000000000000000300000000600000000200001000406600000000000000000
000000000066000000000006600001000000000011000000001663000000000000003010000110466000100000000060000000000101000000000001000002006000000000110000000006000000010000006600
333333333333333330033303333333333330000013000000030233330300000000000000000013030330000000033333333330031100000000000000000000003330305000002330033000333030033033333350
