000000000000000000000000000000000000100000000000100000000000000000000000003100000000000000000000000000006010000010000000000300000000010000000000600000000000000000300030
000000000000000000000000000000000001000000050001000000000010000000003100000000001010000000003000000001030001000000000000000003000000000000000600000000000000000300000001
111111111000140000000101000010000000000000000040000000000000000000004010130001101111100010000000000000440101000000000100000000110000400000003000000011111110100000000000
000000000000000000000000000000301000002000000000001000000000000000100000000000001000000100000020000000000000040000001000000000000000000001006001000003000000600000000000
000000000000000000000000000000000000006000000000000000000000000000000000000000000000000050000060000000001000000000300000030000000000003000004000000000000000000000000000
000000000000000000000000000000000010066000000320000000000000000000020000000000000000000000000660000000200300000000300000000200005000000000006000000000300000510000000030
000000000000000000000000000000000003303333033303330033360000000303333300000003000030033333333303333333333000000000000000303030000000533313300330333001010000000000000000
000000000000000000000000000000000050000000000000000000000004000000000000000000001010000000000005000010000000000100000003000600000000000000030000300000000000000000000000
000000000000000000000000000000110000003000000000410000000401000000000000000000000000000000000000000000030000000000000000001100030000000000002000001000000000000000000000
300000000000000000000000044000000030150101110301030000000000000010001400100300002003000000300300143000004110301100000000000000101000011011100000000000000050004401100004
600000000000000002000000000000000500000000000000340000000004000000000100100306000000000000000000006030000003000060003001000000000000000300000000000000000000000000001000
600000000000000066000000000030000001000000000000000000000006000000000000000006000030000000000010006000000000000000000500066000000000000000000100000000006006000000000000
600000000000000066000000020000000000100000001000061000000006000000005000000301000000000000000000066000000000001060000000006000110000100000000000010000600040002000000110
333333333333333333333333333300000100000000000000030330333033330005000033333033303330630000001000603033033000000033333333333303000000004010003333333103333033333300000000
