000000000000000000000000000006000000000000000000100000000000000001000000000100000000003000000000010000020000000101000000000100030000000060000000300000000000330000000000
000000000000000000000000000000000010000030000056000000110003100000000000000000000050000000000000000000000000000100000000000063000000000000000000000003000630300010200000
000000000000000000000000000000000013000000000030300100200000060000000000000000000000000000000000200000000010000000000015000020000000000000000001000000100000330000000000
000000000000000000000000000000000000000000000000000000300000000000000000000000000003000000000000000040000000020000000000000000000140000060000000000000000003303300000000
000000000000000000000000000000000100000000000030000000000000110000001000000000000000000000000100200000000000300050000000000020030000300000000000000000000000333000000000
000000000011100000000000111100000012003000000022010000000001011000010000100000000000000000000000000001131001030000000000000000000111120000000000020100000000003000100000
000000000000000000000000000000000003033303033333333333330000000010333000100000000000353133303330330000000000000050000003333331000001003331300334333333003330333500300000
003300000000000000000000000000000000000000000013000330100030000000000000000000000000003000000000000100000000000000000000000000000300000000000000000001000003000000000000
203300000000030000000000000000010000000050000000010330000000003000000020330001000000003300000000100000300001000000000000000000200300000000000000300000000300000000000003
000300000000200000000000000000000000000000000000030033000000020000000000030000000000005300000300000003001000003100000010000000000300000001000000000000010000000003000020
033330000000000000000000000000000310003000060000013033000000000000000005100000006000013350000000000000000100000100000000000000033330000000000000000000000000050000001000
033330000000200000000000000000000000000000000010003305000000020000001003333000000000033300000400010000000000000000000000000000033000000030000000000000000000100000000000
003330000000000000220200000000011010001110000000000336000000030200000000333000100100003020300012005001010300000000000103001110000030000002103060000000511000011110000000
303333333333330333333333333300000000000000000001030033033330333335030330003300000066303330300033050000100000000000100000000000305303303033330000000000000000000001031333
