000000000000000000000000000000300000000000000010000000000000000000000000031000000000000000000000000000000006000000300000000600000000100000000000001030000000000000000000
000000000000000000000000000000000000000000050010000000000000000530000000000001000000000000030000000000000000000000000000000000000000103000000000030000000000000000000000
000000000000000000000000000002000000000000440060004000300000005040100000010004400000040000000000104400000000040400000000000000000000000000010403000000000000034540000500
000000000000000000000000000034000000020030000000000100000000006000000000000000000000000000000000000001000100000000201000000400000000100000000100000000000000000000000000
000000000000000000000000000066000003100000001000000000300000000000000000000010000200500000001000010000000010000000003000030300000000010000000000000000000020000300000400
000000000000000000000000000060000000000000000222000000000000000020300001010000002220020000000000000000200000030000000000000000010000000000000200000301000020000000000000
000000000000000000000000000033303300000000333033310000310000000333033300000001130333000203300000003030033333333300000000000000003000010000003330303010000033303330000003
000000000000000000000000000000000000006000000000000000000003001000001000000000000000000500000000050001000000000000003000000000000001000000000000000000000000030000000030
000000000000000000000000000000000103000000010000000000030000000000003000000000000000000000000000000000000400000000000000000000300000000000000000010000000000000000000000
440000000004040400000020000000004040000000000000000300000000000020200000004040000000000011000000000200010000000344000000400001000040012000000000000320000002000004000000
000000000000000000000660000000000000000000000003000000000000000660000000000000000000003000000000006600300000000005003000030000000000066010000000100060000001000000000000
000000000000000000000660000000000000000000000000000000000000000660000000000000000000003000000000036600600000000000000000300000000000000000000000001660000000000000300000
000222020000000200000660000020310000000000000000000600001000000660000310000000000300000003000300010600000000000000022510200000206000066000000000010060000000010000002200
333333333333333333333333333013330330000000000000000000000000003333300033633330003000000000000000003333330300000030333333333510303333033333300000000333331000000003336303
