000000000000000000000000003300000000300000500000000000001000000000000000000000000010000000000010000000033000000000000000000000000003000100000000000000010000000000000003
000000000000000000000000000000000000000300000000000000300000000300433000000000000000020000100000000000000000000000300000010000000000003006030220100000000030000000003000
000000000000000000000000000040000000010000000610300000030300000000030000000000000030300000000000000000000000000000000003300000000000000000013330000000000000003000000000
000000000000000000000000000000000000000000000000000000003300300000300010000000000000335030300033000000000000000000002003300303001000000000003000313000010000010000000000
000000000000000000000000000000000000000000000000010050020100000003300000003005000000330000000300010000000000000000100004000000006000031100003301004006000000333000030000
000000000000000000000000000000000100000000003000000000000300000033130000000006010300330000000303000001000003000000000003000030000000000000003300000001000003030000000000
000000333300000000000000000030000000000000000033000030033300033333333000030033001300330000333033300000000060000304300003300033000000000000030300003000000003333000000003
000000000000000000000000000000000000010001600000000000000003033000000030300000000000000000000000000000005000000001000000000100000000000000000000000000003000130000000000
000000000000000000030020000002000000000000000000006000000010000000000001000000000000000300000000000000000000000000060000000000000000000000100000000000000000000000000000
000000000000000000300330000003000000000000000000000000000000000030000000000000000000000000000000005000000000000000000000000000000030000000000000000000000000000003003000
020000000000000003300330030330041030003300000000002001300400000000000000000040000000000000000000020000000020000000100000001000000030002003100000000000000002000000000000
000000000000000033300330000030000000033010000000000000000000000000000000000000000000000001040000000000000000100000000100003000303330000000000000000040000000100000100000
200000000000000333300330000003000000130300000000020030000001000000000000000000000000000000000000300000000200050000300000000000033330020000000000000000003020060000000000
330330000033333333330330003333000300333310330000033033000000005330010300000030000000303000003000000003033330330000033300330300330103003033000003333000030333030003330000
