000000000000000000000000000000000000001600000000000200000000060000003000000000100000000000300000000000000000000000000000006000100000000000000000000000000000000010030000
000000000000000000000000000001000000000000000000000000130000006000000033000000000000000000000003000000100000010000000000000000000000000000030000000000011000300000000000
000000000000000000000000000000000030030000000033300110000000000000010033330000010004333360000000000000000000000000000000300003000000000010000000000000000000034000000000
000000000000000000000000000000000000000030000030000000000332000000030030000000000000016000003000010000000000000000000000000000000000000000000000000000000300005000000000
000000000500555000000000000000300000000205000000000000005030000000000000000000000000000000050000000010000000005500000001005010005000000000000000000005000000000000000000
000000001110000000000000000000000000111000000130000000000000000000000000000000000000000000020004000022020311100001020000000000011100000030000022020010030000000000300030
000000000000000000000000300000033303000010300330000000001000100001000050000333010333000303306000000333033000060023333333333333100000000001003033303000000000000000600000
000000000000000000000000000000000000000030000000006000000000000100000000030000000000000000000040000300000000000001000000000000660000000030000000000000000000000000000000
000000000000000000000000000000000000000000000001000000000000000000000100000000000000000000000300000000004003000000000000000000000000000000003000000000000000000000000001
000003333330000000000000000330030000006000000030000000010000000000000000000330000000000000000000030000003000000000000000030000000003303330601333000010003300100130000000
000033000000000000000000000000000000005000000000000000000300005000000130003300000000000000000000000000000050000000000000000000010000000000000000003000033000001506000000
000000000000000000000000000000000000000003010300350010000000000005005500000000000000000000000000000000000000000000000000000000001000030000000000003000000000000000000000
000000000000000022020000000000050001052320000010500000000002023011000000000000000000100100000000000300000000000000000000000000003000000000100000000000000003000000010000
303330000000333333333333333310000030330303000300000000003313103000000030333006000000000030030303003333313000100000030030000000303300000000330000000303330033333030000000
