000000000000000000000000000000100010000000000040000000210100000000030000000000000000000000300000000000000000000000100000000000000003000000000000000000000000000000000000
000000000000000000000000000001000000000000000003000000000000000000001100000001000000000000000000001000000000000000002000000000030000010000000000000000000000000010000000
000000000000000000000000000000020000000000000000000000000030000010000050000000000000001060000000000001000000020000016000000000300010000300000001100000000000420000000300
000000000000000000000000000000663000000000000200050000000000000000000000020000000060000660000000030001000000000100066000000000000001000100000066000000002000660000000300
000000000000000000000000000000660001000000005000000000300030000000000000630005001000000660000100000066000000000000060000000000000000000000000066000000000000661000000000
001110000000000000000000000000660002000000006300000000430001000000000000010000000010000060150000000066030001000000060000000005100000000110006006000000000000660000000000
000000000000000000000000005533333330000000030330500000001000000000000013030030000055333330000000001303031050000003033030000000003000000000003330333000000033303030100000
000000000000000000000000000000000000000001000000000000000100000000000000000000000030000000000000000001000000030000000001000000000000000000000033000000010000100000000500
000020000000000000000000000000000000000000000020000000000010200000000000000000000000000003000303000000000000000600000030000000000001000005000000000000000000002010000001
000660000000000002000000200013000000000000000661000400000010000000200000020000000000000000000030000032005000102000000000000000010203000000000000030030000000066000000000
000660000020000066000006600000603001003000000660000300000000600006660003060000000000100000000600000066000000000000000000001000006004000600000001000000000000066000002000
000660000660000066000006600000660000000000000660000000000000600000600060600000000000010000000000000006000300000310000000006000006600001630000004000000000000006000066000
000660000660000066000006600000300300600000000660000011000000600006300006660000000000000000000600000066003100100100010000066000006600000600000011100001000000006000066000
333333333333333333333333333333333031000055333331300100003333000300333303333130000000000005633331300330333000000000000553330133330333303313330000001000005030333333000333
