000000000000000000000000000000000000000000000100000000000010000020000000010000000000000000000000030000000000005000000000000000000000000000000000000000000000010000000005
000000000000000000000000000000000000000000100000000000000000000010000000000000000001000000000000000000000000000303000000000000001000000000000000000300002003000010000000
000000000000000000000000000060000010000000100110000000000000100000000066000010110000000000000300000020000601030000000001111010010000000000006030000000010101100006000001
000000000000000000000000000066000001000000000100000060000000000001000160000000300040000000000000000120000000000000005000000002000000000500001000000005003000000306600003
000000000000000000000000000066000000000550000000000000000110000000050066000000000000001000000000000100000000000000000000000000300000000000000000000000000000000000001000
000000000001111100000011111166002220001000200000000001010111101000001166000200000000011111111100060000110000000000060002000000000000001111115000111110000010000006100202
000000000000000000000000000030333300303333033331000000000000000000000030103313300000000000000000000000000000000000000003333330003001000000000010300000003033000003033333
000000000000000000000000000006000000000101000001301000000000000300000001000600000000034000300000000300001000300000310000000000000000000000000000000000000000000000000000
000000000000000000000000000005030000600060000000300000003000000000000000000000000000000000000000060000000000000000000000000000000000030003001000000000000000000040000030
000100001100006600001111110000000000000000000100001000000001000000600000060001411003040003100000001111100001000360600010000000001000000010000011001111100300000000000000
000000000000006600000000000000000000100000030010001006000000000000000100000000000001630000000000000000000000004060000000000001000000300011000003003000000000000000000000
000050000000006600000000000000000000000001000000000035000000500001000100003000000000600030030005000000000000000066000050000000600100000005000030000000000000000000310000
000100000000006600222200000011000000001011003000000000000000000110000010000002000000600020000010002000000000000066102220000110010000030010000001600200000000000000101110
333333333000003333333333333000005000003000200000003000003333333000000000000013333300033630333333333330030000000503330330000300000000021033530333333333300000000000000100
