000000000003000300030000000303000300000013000000000061000000000000000000010000130003000000000000000000000030000000000001000100000000000030000000000000000000000030000300
000000000030300033000000000000330000000000500000000000000000610000000003000000000000000050000000000000000103300000000000000001000000000000000000000000000010000000105030
000000000000000000000000000000060000000000000000100000000000000000000000003000000000000440100100000000000000000000044410000000000000000000000000000000044100000000000003
000000000000000000000000000000100000000000000000000000000000000000000000000000000000000001000000000000041000000000000000000000010000000000003000000100000000000000000000
000000000000000000000000000000000000000000000000003003000000000000033360000000000010300000000000010000033000000003000000000001010000000000000350000330000000000000000000
000000000000000000111111000000001111000000000000000000000000000000000000000001110000000000000000000100000030011100000000000000300003000000000000000100600010000000000000
000000000000000000000000000001300000000000033303300000003330333303000000033330000000000000000033333000000000000043000000103030000000133303330003333600000000000100000060
000000000000000000000000000010003000100000000000000003000000300030203000030000000000100000000000000000003000030300300000000030000000063060300300030000000000000000000000
000000000000000000000000000030030000000000000030000000000003030053300000000030000000000000003000000410000000003000030301010000000000000060600003000000000000300603000006
300000000000000004441000000000000010003000000000140044010000000000000000000400000000040000000000000000006000000003003000000000000500000300000001000300000300000000000000
000000000000000000000000000010300000000000000000000000000000001000000000000006000000000010000060000000000000000000000000000030000000000000000000000000000000100000000000
000000000003333300000000000000000000000060000030530000000000000003000033100000010000000000000300000000000000000000000300000003000003300000000000000000000000000000000033
000000000000000000000000000000000010000000000003000000000000000000011100000000000000010000003000001013000000000000000000010000001000100001110300011050000030000000000000
333333330000000000000000333310010000003333300500000000000000100010040000000000003011000000000003130000000000000000000000000600000100000000000000000330333303000003000000
