000000000000000000000000000000000000010000000030000000000000000000000000000000000000000000001000000006010000000000000000300000000000000000000000000001500000000000500001
300000000000000000000000000300001003000000000000001002000000003000000000000000040000500100011000000000000000000300000000000053000000030032000000000300000000000000000000
000000000000000000000000000000000000010000000000000066000000000000000100000000000000000000000000000010000050400001000310010000300001010000000020030300300000000000000000
000000000000000000000000000000030000000000000010000060001000000000000000000000001200000003000300000000000003000000000003003000000200000066000000000001000000000000000000
000000000000000000000000000000000000000000000000000066000000010000000000000000000000006600000000000001000000000000000000000000406000000006000060000000000000000000000000
000000000000000000000000000030001000030000000000000066000050300000000010000000022222000600000000006000000000000000000033030000016000000060000060000000003000100003002222
000000000000000000000000000000000000000000100000000303330000000000000000000003333303331133300000005000000000000030000004300000301133333330303030303000000000003001303100
000000000000000000000000000000004000000000000000000000000000000000000300000000000000000000030600300000000011000000000000000000000000000000000000000000300000000000000030
000000000002000000000000000001000000030000000000002000003000000030021000000000000000000000030002003000000000000000000000000000000000130000000000200000000000000000000003
000000000066000000000000000000000000000000000000000000003000310000663001600000100000000000000065000000000000000000010000010003000000000300000006000030000000000000000000
000020000066000002000000000000000000002000000000000030000100000430660000030000002000000020001066000000000100005000000000000010000000000000000006600000010000000000000000
000000000066000066000000000000000000063000001003000000001500000000660000000000066000300000000066000000063000303300000000000000000000000000110005100000000000000300000000
000222200066000066000000000000022220026100003000000000000000000010066000000000066000001222500066000300000000000000030000012602000000020000000006000000000010000000000000
333333333333333333333333333330333333033333333303300000030000000000333333333033133333433333333333303103336100000100010000033333330333000000000333030050000000000003303333
