000000000000000000000000000000000030000000000000000000003000000010000000000000000000001000000000000000000000001000000000436000000000000000000000000000000000000000000000
000000000000000000000000000000000000000000000000000000000000020020000000100000000000000050002000300000000000055000505000230050000001000000000000103020000000000000000000
000000000000000000000000000000000000000000000000003001000010501660001000000010200000010000066000100000000020000000000006600010000000000000001200000600003300000001000000
000000000000000000000000000000000020000003001100000000000000100600000000000056301000331000066000000000000000000000000000600400000000000000000301000060000010000000000000
000000000000000000000000000003000000000000000000000006000000000600000000000000000000000000061000000000000000100000001006010000200000000000000000010660000000000300000000
000000000000000000000000000003060000000100000000003300000000300000000500000000000000000000016000000000310000003000000006600000000000000000000000000663000000000000000000
000000333300000000000000000000000030300000000033010000000000015333333300000033330300003330030313030000330000000310000033033333000003000000003331300030303300003300003000
000000000000000000000000000000000000000000000000030000000000000000000000000000000000010000000000050000000000060000000000000000000000100000030300000000053000000000000000
000000000000000000000020000000300000000000001000002000000000306000000003000000000000003000000000000000000000200100000000000000000000000300030040000000230000000000000000
020000000000000000200660001000001000000210020000030000100010000000003000002000000000000000000300300000000000020000000000200100000000000002000000000000022000000530000000
030000000000000006600660000000100000006600330000066000000000000000000000061000000000000000000304300040000000400000000000300000000000000066000000060000660000001060000010
000000000000000006600660000000000500000000000000066300000000000010000030060000000000000000000000000000000000600000000000000000000000000066000000000300660000000000000000
000000000000000336600660000001000000036600000000065000000000000100000003066000100000000000000000000000000030060230000000000000000000003066000010000033060000000000000000
333330000003333333330333333300000003000300333300033033350100500000000033300003030000000000300001103330000300333030301003333000000000030300300030000333333000000000000110
