000300000000000000000000000000003000000010003000000030001000000000000000000000010000000000000000000000000000010000000000000000000000010000000000000000300000000000000000
000000000000000000000000000000001000000000000010000320000000000000000000000000020031004000000000000000000000003010030000001000000000000000000000000000000000000000100000
000000000000000000000000000000030000300000000000000000000000000000060000010000100110000000000010000000000000000000000000000000000000000000000002000000000000000000000000
000000000000000000000000000000000000010000000000000000010010002000000000000000660030000030200000000000000000000500000000000000000000000000000000000000000000000000000000
000000000000000000000000000000000000005000000000000000000100366000000000003300600000000000630000000000000000000000000001000000000003000000000300000000000300000000200000
000000000000000000000000000000100100000000000000000003000010066000000100000303600001000006601000000000000000000001000000000000001033060000000000010000000504030000000000
000000000000000000000000000000006000000000000000000000203333033000001330003333000033300330300000000100000000000000000000000000333133300000000000000010003000000000300000
000000000000000000000000000001300000000000000000000101000010000000000300000000003000000000000000000000000000000000030000030000000000000000000000000000000000000000000010
002000000000000000000000000000000001020000000000000000000001000000000000000000000000000000000001000000000000600000000000300000000000000000001000000000000000000000020000
066000000000000000000000000000000000060000000010000000000000000000000100000000000000000000000000000610000003000100000650000000066000000000000000000000000000000000650100
066000000000020000000000000000000000660013000000500000000000000000000000000000000000000000000000000660000000000300000000000001060000000010000000000003000000000305663005
366000000000660000330000000000000013660040000006600003300000000000104000000000000000000000000003003600003001000000000100000000363000000000060000330010000600050003660000
366000000000660000330000000000000003560000000000000003300000000000030000010300000000000053010003303660000010000000000000000030366000100000060000030000006000000003660000
333303333333333333333000003300000303330000336333003333330000000000000000000000006000036000033033333333033006000300000300010000031063303333313003333333330300000333330033
