003000000000000000030000000010000000030000000000000100500000050000000000300000003006133000000300000005030000005010200000130000000010001000501000000000001000600000000030
000000000000000000000000000010000000000030000000000010033000000000000000300000000000000010000006000000000000000000000000000000000000000000000000000000000000050000000000
000000000000000000000000000000000000000000000000000044013004400000000000000000001000000000000030310000000000440000000000000000000000000004000000000000000000000000000000
000000000000000000000000000000000001000000000000000002000300000000500010000000000000000000200003000000000000030036000000400000600000300000000000000000000000000030000003
000000000000000000000000000000000000000000000001000001000000000000000000030000006000333323001000000000000000006000000060000000330000300401000000000000000033000031000000
000000000000300000000000111100000000200000003003000000000000000000001000001100000000033000000011010000004000000000000000000000330000300001000000530000030030120030000000
000000000000000555000000000033303000000000003000033033363333333000200000000003303333303000000000000350000033035000303003333133040000330333030000000033303300000000050000
333000000000000000050000000000000000000000000003030300000000030333313000000000000100001000000000000000000000000033300000000030000100000000003000050000030000300003040100
000000000000000000000000000030000100000000000000000000300000300000000000000300000000000000000000000000003000000300000000000000010000010100000000000000040000000000000000
000000000000000004400000000000000000000000000000000601000030000000000000000000000100003000000001000000100000000100000100000000000000000000000002330000000000000000600000
000000000000030000000000000000000030000000110000000000000000000000000103000130000000000000000000000000000000000300005000001000000100000100004030000000005000000060000000
333333333000030000000000000010000030000000000000033333330000000333033333000030000001000000000400000000000330000333033330100000000010000000000000005000000000001300330333
333000030000030000000000000000000030001111000000033300000060000300300030000000000030003000000000001000030350000333300000000065001003001011010000000300111100030003030010
303000000000033333333333333300000036300000000500030000000505001303000000000010000000303133310000000000000010000330300000016003000000000000003333504000000000000000430000
