000000000000000000000000000000000000000020000006000000000000010000000000000600000005100000000003000000000000000000003300000000000600000000000000000060010000000060000000
000000000000000000000000000000500000000100000000001000060000000000000000000005000000000000000000000050000000000000000000000000000300000000001000052000100000300000000000
000000505330300000301111111100003010300005000001000000000530030000000503003011101110000000100000000003000000500100000033000000000000011011110001011000000005330300115111
000000000000000100111011110100001130000003011200100000000015000000000001001110000000000000000000000000000000001100100000200100002030001111010001000000030000000000111000
000000000000001101111111111101010310000000111111100000000000000000000000011110000000100000000000000010000100111100000000000000000000000030100001000000000000000001011101
000000000000111111111111111111213100000003311111110100000000311000000011100610000000000003000000100000000101013100003300000000000000010110000000002000000001001101100111
000000000000000000000000000004050000000000000100033310300000100000000005503003333330330330000000003433333000000033133003000003000000000000003330303030000000000001003000
000000000000000000000000000000000000000006000001000100000000000005000050000000000000000000000000000000000000000000130000000000000000000000000010001000000000000100300000
000000000000000000052505000050000005000000010000200000010003002000000003000000000000060000000000000000350000000050000000000003030000000000520000000000000000006000000000
000000000000000001111111111041110100000003001011136330000001111111111100000006000000000000010111110006011110111011010100033030000000100010110000301001000130111100300000
000000000000000001000000000000000001000000000130000003000001100011030300000000000003000000001131050003000006000000000000000000011000100010000001001000000001100000000000
000000000000000001000000000000000000000000000000320000000011000110011000000003000300000000111011000001000001000000000001000000110011100000001101110000000000000000000000
000000000000000000002000000000000000003000000000300000100000002011111100000000000000633000011116130000302000000000000000000011111111000000021110010000000300060000000006
333333333000033333333333333033333303300003333303300100003033033300000003333333300003000000000000003333033333033103333300000001000000030333000000000333333303303300030000
