000000000000000000000000000000000000510000010000000105000200000000000000000000000000003000300300000000030000000000000000000000010000000000000000100000000031000000000010
000000000000000000000000000000000000000000000000000050000000000400001000000000000100000000000000000000000000001600003010000000000000000000000100000300100000000000000000
000000000000111111111111111110110031111111010000111111110110000000100000020000061511110111100000001011111111005000000000000011001000111111113111011000000000000011111011
000000000000011111111111110010131011100101000000103100110000001000000000000000101100111110100000001101000111011300000000000001300000111111010111100000000000000000013100
000000000000011111111111111110101101111110000003100000110000030000000001000001010101101111000000001011111001110000000000000001003053111111111111111000000001000310001111
000000000000111111111111111111011001011111000000100001110000031000000330000001111110111111000603100210111110111003001000000011020001011011111011101000000000000010000100
000000011000000000000000000033030000000000300000033100033000050403403300000000300000000000300010000000000330030000000001000000330000000000000000000000100033000003100030
000000001000000000000000000000000003000033000000000000000000300300000000000000000010000000001000000000000000000000000100000000000000000000000000000006000000060005003000
000000000000000000000000000000000100000000100003005000003000030000000000000000000000000000000000000000000000003000000000001010000000305000030030200000000006000000000000
000110001100011111111111100010101110000000000001100011003000011111010011113111101111111101101100310000100100001000030001101111111011101110000000001111110011111110001100
000000000000010011111111111111110001000000000000100000000000003111111100110000010111000111600000010000000000001100100000111101001130101111110000001011110011111010000000
000000000000310001111111111010101110000000000000100000005005610111111000011010101111000111000000310000000000000100000301111111300101000010100000000111101011111110000000
000000000000310000111111111011113110001000103003100000000000010101111011011011001011500101100300300000000500001100000001110141000011111101100000010010100000111110060000
033333333000003300003333330000006000000000110000003333300110000033031000003003300000300000333000000303030110001003030330000000330000003031001100000333333000000100333333
