000000000000000000000000303010000000000000100000000003000500000000000330103000030000000000000004000000000000103000003000000000000103310001000000000000000000000003000003
000000000000000000000000003000004000000020000310000000000000010003330300000100000100000000000000003000020000000000400000000000030003000000231033000000001005010000000000
000002000000000005555000000000050553333000300000300000000005000300000000000003000033100003300000003033000100000000000200000033000000030030003000000300155000000203000303
000066000000000000333000000000003030000000000000000000000001333000000011000000000000001000000010000000000000000000006600000000000300000000000000000000033300000005000000
000066000500000000000000333000030000000002000300306005000000001000000000000000003500000365000500300000003000003010000600003000000333000060000000000000003000506600003000
333333333333000000000000000001000000000000000010030001000000000000000000000000000000500100033333001000000000500133303300001000000000030000100000000000003033313300000000
000000000000000000000000000000100000001003000000000003330000000000000000003030000000000000000000000000000010000000000000030000000000000300030000000000000000000000001000
000000000000000000000000030000000000003030000000000300300100000000000000000005003030000031000000000000000000000000000000000000000003000003000000010000303000003003000000
000002000000000033333000000000333300010030000000000000000060020000000000000000000033000000000000000033000000000010101000000000006030300010003000020000003000000000000000
333300030000333000000000000033030030100000500002000000003030000010000000000200510000000003000000203000000000555500000000005155300000005000003343303005000100300000000000
000000000000000000000000000000000000000000000066000000000000000000030000000603000300000000600006600000000001003000000000000333100000603000000000000030000000000000003003
000000000030000000000000000000001000003300000066000500000000000005002000006600003300000000000006000000003000000010030015000000000500000000000000001000333030000000050000
000000000000000000000000000000003305003000003300333033000000000313330033303030000000000000003333000000000000600033333000000000000000001000000000000000003000000003333300
000000000000000000000000033300000001000000000000000000000000000000000030026000000000000033350000000000000000000000010100000100000000000003330000000100000000000300100000
