000000000000000000000030000001000000000000050000000000000000000000030000000000000000000000040000000300000004000000005000300000000003000001000300000000030000300000000600
000000000000000000000000000000000000500000000000000000000000000000000030000000000000000000000000000000000055000000000000000000000000000000000000000000300100100000000000
000000000000000000000500000000600000110000003010000000000000000000000000050001000000000000000000003000000011000000100040000100000001010000035000000040000000001000003000
000000000000000000000000000000001000000000000000000000000060000000000000100000003000000030000000300000001000030000000000000000000000000030010000003000000030000100000000
000000000000000000000000000000000000500000000000000000000010030000000000000000000000000001010000005000000000000001000000000000000000000000000000000000030330000000100000
011000044410000000000000000000000033300000002200040400003002000000031000000004441000441100000100000000001000303000200040010000000000000000000000000100000044410000000100
000000000000000000000000000000000003003333033330300000000333333333103300000000000000000001000000100000000001300333333301000000333330300000000000000330300300000000000000
000000000000000000000000000050000000000000030000000000000000110030000000000000000000000000000000000000000000000000000000000010030000000300000000000003000000000000000010
055000000000000000000000000000503001000000000010000000000550000000000000000000000000000000000010000000000000000300000000000000000000005000001000000000000100000000050000
011000004000000000000000000010000000004000503000000100100100000500000000003000400000000000304000100100000000000000000000000000510000001100300000000010000020000100010030
000000000000000000000000000000110000006130300000000010000000000003000000000300000100000000000000060000000000006000000000000000300030000000000000000000000000000000000000
000000000000000000000000000000000000000000000006000000000000100000000000000000300500000000000003001000000000000001001000001000000000000000000000000010000000003030000000
000000000000000022000000000000000000000000000000001130000000000000000001100000001000002000000000000000000000000044010000000000000000000300000110000200001000220000000000
333333333333333333333333333333330330001330000000000000003333303100000000000003313333333303003033333333300000030001000003303333000300030333030004000330333303333300333030
