300000000000000000000000000000000000031200000030000000000000000000000001000500000000000000000000001000010000000000000002000000000001000000003000000000000000100000000000
000000000000000000000000000000000000000100000000100000003000000030000000000000000000000000000000000100000000000000006000000000000000000000100000033000000001030000000000
000000000000000000000000000000000010000000000000001011400000001000000000030000000000010000011111010000000000000000000000000400000000000010000020000000000000000000000000
000000000000000000000000000000000020000000000000000030500100030000000000100030000000000000000000005000000003000000000060000000000010000000000100000310103010000100003000
000000000000000000000000000030003660001000000000100000500000000000000000000000000000000000101000100000000000004000010601000000006010000050060000000000000000000000000000
000000000000000000000001144400050061000000000000000210000000000005144400000004000310060000000200000010030303000000005660000000003140000000000001000000000000000600015400
000000000000000000000000000033333033000000002030533304300330300000000000000000300000000000030330330000000000000030003533000000000000000010000000010000000000000000000000
000000000000000000000000000030000000000100000005051000003000000000000000000000003000000000000000000000000000000006310000000000000000100000000100000000000000000001000001
000000000000000000000000000000030000000000003000000000000000000000000000000000000000000000000000100000000000000005000030000010000100001000000000100000000000000000000060
000000000000020000001111111100000000000001003000000000020000001000000201010100000000000000000001200000001000000200000311011111000000000000000111011000030000000000000001
000000200000660000000000000000000000050000000000000000600000000000006600000000001012000000000000000000001000006600000003000000100000000400000500000000000210000160000000
000006600000660000000000000000001110000000000000010100660000000000006000000000000066000006600006010000000000606000001000000000000006600000000000000300100600000600030050
000006600000660000000002000000000000000000501144400000660000000000003600200000000065000001600104040010000000000600000000020000000006600030000020000000006600000060040000
333333333000333333333333333310000003330333000003033001300000000030013033333303330333333033300000003303333330003303303030330333330330300003003333333033330003000033333330
