300000000000000000000000000010000003000000000000000000000000000000001060000000000000000000300010001000000300003000000000000000000000000000000000000000000000000000000000
000000000000000000000000000000000000000000000000003000000000030000300060000003000000000000200000000000000000000000000000000000000000000000000000000030306000000000000000
000000000000000000000000000000000000000000500000011000000600100000000000000100000010000000000000050000000000030130033004440000000000010006000000000000000040400001500000
000000000000000000000000000000000300100000000000000000330010000000031030000010000020000000001020000000000000000000000000000000000000101000200005000000000000000020240030
000000000000000000000000000000000000000001000000000000300000000000003000000200050000000060000000000000000000000000000000000003000000000030300000000000000500000000000030
550000044444004400000000000000000005100030000000002000000400000404040055003000000000000010000001034044300050000044444000030000100000002000014434000000100100000020200000
000000000000000033300000000001030000000000333333030033300033000000003001000103333230003333000000000000000000000000000000000333303000033333030000000333303000003013003030
000000000000000000000000000000000000000000000000000000000301000000000000000040000000000000000000000000000000000030000100000000000000000000000000000000003033000000000000
000000000000000000000000000000000000000000000000000000003000031000000030000010000000000000600000000000300000000000000000000000000000100400000000000000000000000000000000
000000044400001000000000000000000004040000001000131000004040000113000000000001000030000000000000000440000000000000000000000500400003000001000001040020000000000000000030
000000000000000000030000002000001200000000300000110000000000100000003000000000000000000000000310300000000011003001000000000020000000000000030000000030000000000000000000
000000000000000000030000000000030000000101300000100000010000000000003000001010000030000000030000300000000060000030000000000000000000000000000100001006000000000000100000
000000000000000200000000000001000000000000440000044444060000000000000000000000000000440000002003000030000000000055000000000000040500000000000000000000000050603004400100
333333000003333333333333333333303020000001003330000000001000330303333333333331000000003330033333330030330030003000030003303303100330000333300333031010000000000000030300
