000000000000000000000000000000000060000000000000300000000000000000001030000010000000001000000001000030000000000000000300001000000001000000000000030000010000000600000600
000000000000000000000000003300000000011033000000000000000000000000000030000000000000100000000000330000000000300200000000000000000000000000330000003000100000100000000000
000000000000000000000000000030001000100000000000000000000000000000000000000000000030000000010300006003000000000200000000000100000000000000000000000002000000000000000000
000000000000000000000000000050000500300000100000000000000000000000000000000000000000000000000000000000000000006000000000300000400000000003000000000000000200000000000000
000000000000000000000000000000000060000000000000000003300000000060000060013300030000001033000000000000000000000600003000000000000000000000000000000030000600000000300000
000000000000000000000000000000000000000000300000000210300000000000000000200300003003002000000000100000000000006600000000000000000000000000000000000030016600000000010000
000000000000000000000000000000000000000000000000030303333333300000000033303330030000333063000000000000000303333000000000000005003333300000000000000633333000000000330030
000000000000000000000000000050000000000000000000000000003000000000000050003000000030000000000000000300000000003000600000000000100000000600000000000000000000000100000000
000000000000020000000000000000000005050301000013200000000000000000000000000300000000000010000000050300000030000000000000100000000003101000000600010000000000000010000300
002000000000020000000000000000010000020000000000200000000000000003000000000000010002002030000001000011000000030000201000000000001000200000000000010000300200000000010000
033000200000660000000000000000000000030002000006600000300000000030000200000000000466000000000100000330002000000000310020000000000006100000000020000000006600000000060000
033006600000660000000000033000000000333066100006000006000000000030206600040000000066000000000000000330060000000003303660000000000000600003300000000000006601010000000330
033006602000660000000002000000000010330006020006000030000000000033006050000000200066000000000000000000010000000003300660000000020006603200000000000020000610000000000000
333333333333333333333333033333030303306333333303310000600050000333330000020003333333343330300000003031133000000003033130000020033333300333330000000333303000000003330303
