000000000000000000000000000000600000000000000040000000006020000000000010003030000000002060600000000000010033000000000100000300000003300000000000000300000030000030000410
000000000000000000000000000000000000010000000030050100010000000000000000003330030000100000000000000000000000000000560000000000003303000000005000000000000000030540000005
000000000000000000000000000000000000000300000000000000000000030000000000033330000000000000100000000010000000030000000060000000003306300000000005000000000000303330000000
000000000000000000000000000010001000000000000000000000000000100000000003303300000000035000000030000000000100010000000000000000032033300000000000000000000003333330000000
000000000000000000000000000000000000000000001000000000000600000000002033003030000000000000000000000000000000000300000000000000330330300003000000000010000003333330000000
000000000000000000000000000000300000000000000000000000000000000001400003333310000000100100010003001003000000000000000000000300303313300100000030003000000000033332300000
000000000000000000000000003301000003313333000000000033330000000300333303630630000003000300300000630000000330333333033330300002333333300000060033333000000031030330303300
000000000000000000000000033300000000000000000000000003330000000000000000000000050000000033000000000000000000000000000000000000000003000000000000000000000003000000001000
000000000000555000000000333300000555000000300100333033330000000000000300000500000000000303300001550000000030000000000000000000000000300000000000000000000000000000003010
000000000000000000000003333300000005000060000003000233330000000000000300005000000000000031600000000000000000000000001000000003000000000006040000001000100000000000530000
000000000000000000000033333300000000000000000000003306000000000000000000010000000000033330300000000000000000000000000000000000000000000000000000033000600300000000000000
000000000000000000000333333300000000000000004000033300030000000000100000000000000000333333300000000000001000000000000000000000000005000000000010000020000000000000040000
000000000000000000003333333301000000000000000000003533330000003000000000000050006000033333330000000000000000000000001001000000000000000000030000000000000005000000050000
330333333333000033333333333333530000000033030000033333030010333000000033320000000000030033333333000030005000000000000000000000330330000300100000000001000033013330000030
