000000000000000000000000000000000000000400000000000000000000000000100003000000000000000000000000600000000100000005000003000000003000000030010000000001000100000003000000
000000000000000000000000000300300000000000000000004000010000000000000050003000000000000030000000000000000000040000000000000003000000000001400000000000030000000000000003
000000000000000000000000000020000000000000010000000000000000000033005000000000000000000000000000000000031033000000030000000000000001000000000000000000331000000030000000
000000000000000000000000000000000000000010000000000100000000002033000000303130300000100000200000000000000030000100000000000001000000000300000000302003330000000000030000
000000000000000000000000000000000100000000004000000500006000101333050003033300000000100000000000000003010333300000004000000000010000000030300000000033333030000000000200
000000000000000000000000000000303330000000000000000000000000000030000413333000000300600003000000003030003303300000000000000000000060013333006000350333000100300030000063
000000000000000000000000000003033330000110000006010000003033300033333303031000000000333030300000000033303333333000000000000000000300033103003300303303030000010000331133
000000000000000000000000000000000000000000600000000000000000000000000000006000000000000000000000000300000000000000000000000000300000000000001000000006000001000000000000
000000000000000000000000030001000000000000000000000003000001001000000000000000000000000001000005030600000030000000000000010000300600000000000000000000000001060000000000
000000020000000330000000330000000060000000033000000003000000000201005000000000000000000000000000000000000000330000300000000010230005100000000000000000000000000000330000
100000200000000330000003330000000000000002033060003303000000000000000000000000000000001050000000000000000003630003300010000000000000010000020000000000000000000000330000
600000000000003333000033333000000006000600300300003303301000000000000000000000001000000000000005000000000030330131330000000100000000060010000000000000000000003001330000
600000000000033333000333330000000006000000033300033333000000030000000300000000000000000000000000600000000303000033330000000000000000100500000000000000000000000003333000
333333303333333333333333330030000003333330113000030330000300000030003300000300100003000000300000000000100330030000330300000000003333033303330000000000000000000003330303
