000000000000000000000000000000000000000000005000000001000600000000000000000000000003010010000000000001000000000000000000000000000000300000000000000000360600110030000000
000000000000000000000000000000000000000000100000000600000000000000001000100000000000000000000000000000000001000000003610000000000300005000001001000000000010000000600000
111111131340000000000000000000000110000000300000000000000000011000000000030000030000000030000000001111010000000000000110000000330300001000111110000000000030340000000030
000000000000000000000000000000100003300002000000000000000030000000000000000040000000000000003301002000000000000300300000000000000010000005000001000000000030000000000000
000000000000000000000000000000000003330000010000000000100000000000100000000001000300300000030000400000000100000330000000000003000000000000000000010600000000000010300000
000000000050000000000000000030301013336033000000000000003030000001000032000030100020003000033300030000010320000330300000000050000531010000000000000000000000000000000000
000000000000000000010000000033000333333030000000000300003300033000000030333300300000330003331033330000000010303330000330300010004000030033030000000000000000000000000010
000000000000000000000000000000306000050000000000000000000000000000000100000000000000000000000000000000000100000000000000000002000000000000000000000001000010000200000030
000000000100000000000055000000503000000000001000000000000003000055000000000000300000030000013500000000000000000000000000000000300000000000000000000031001000000000550000
000000000000000000011110001011000001111026000000001340001011010000001000000000134000000000013000003134000000030002000000000000030010001310112000000000000003000100100010
330000200000000030000000000000000000000000063000000000000000000000060033030110000000000000000000000000003000000000000003300602000000000000003300002000000000000000000000
333000000000003000000000000000000000000000000000000000000100000000000033300000000304000000000005000000000500000001040003330000030000000000000030000000100000000000000000
333000332000033030000000000000000000003000320030300001000000000000000033330030000000300000000000000005300000000032000033330003000000000000053130003310100300000030000000
333333333333333300033333333332333330000031030330100004030000030333030323333330000000000001033300030000000010000001333303331333000000000000000330330333031300000033033030
