300000000000000000000000000300000000000005000000000000000000000000300000001000000030000000000000030000000000001030000000000000000000000000000000000000000000060000000503
000000000000000000000000000000000000000105000000000030000300030000000500000000000000000000000000000000000000000000000000056000000000000000000000000000000000000000010000
300000000000000000000000000000000000000100300000000050000100000000000000000000000000000000000000000001000000000030000000000000000000000010000000000000010000000000100000
000000000000000000000000000000000000000000000100000001300001000000300000000000000010000010000100003600000000000000000000000300000000000000310000000030000000030000000000
000000000000000000000000000000000330003000000000000000000000000000003000000000000000000000000300000000000000001000000000300000000010000000000300000000000000000000001000
000000000000000000000000000000000000000000000000000130000000300000100000000000000030000000230000000000000000000503000100000000000010200000000000004000000200001000000300
000000000000000000000000000033001333330330300010000000010330030333333300000000100000303033350000003030333000100000000000000010333063333033333303503003330000006000333331
000000000000000000000000000000500003000000302300300000005000003000000000000000000000000000000030103000010000000000000000000200030100000000030000000300301000000000000003
000000000000000000000000000000000000000000000000000000000000000030000000000000000010010000000300300003000000000000000000000000000000010000000000000000000030000000000000
000000000000000000000000000000000000000000000000000000000000000000000103000006000000060003060000000000000000000000000000003010030000000000600000600300000000000000000000
000000000000000000000000000030000000030000000000000000000000501500001000360000200000000000000000000001030000000000000003000000003000000000000050000000000000001000000000
000000000000000000030000000000001200000000000000000000000000000000000000000000000000000003000003000000000000000300000300000000000100000000000000000000000000000000000000
000000000000020000000000000000000020000000004010000000600000000050000000000000500100010000030000030000000000000000000000000000000000030000000000000000000000000000000000
333333033333333333333333333330300333000003012000000103000000300333333300000003333033333333333334300000000000000033333030000000330330000000003333330000061301000000000000
