000000000000000000000000000000000030000000000000000000000000010000000000000000000000000000000000000000000000001000000000000000000000000000100000001000000000001100000000
000000000000000000000000000005500000200000000000000000000030000000000050000030050305000000000000000000000000000000000000000000000000000000000000000005000000000000400000
500000035030000000000000000001000100000000030000035030003000001000100000000001100011000000100020003003000300000100000030300000350350030000010000000500000030000013600000
000000000000000000000000000000001000003000030000000001006000000000000000000300000000003010000000000000000300100000000033300000003006000004000000000000400030000000000030
000000000000000000000000000003000030100106600000000000003000001001000000000030000000100000040000000000010310000000000333330300000000330000000000000000000030000010000000
000000000000000000000000000000030003000000330000300000000000000000000000000000000000000000000000000050000300000003000333330003000000000040000000000000000000000000000030
000000000000000000110000000033303000000100333003300000003300033001011000000000330303000000000000000000000333303003303333030000000000033333030000010001000033333310100000
000000000000000000010000000000310000000100000003000000000000000000000000000000000000000000000000000033000000000000010000000000100000000300000000000000000000000000000000
000000000000000000000055000500000000000000000000001000040000000000000000060000000000000000000000000500005000000000600000000000000000000500050000000000000600500000100000
030000000000033000001110001034000015000000000000300000005000000000000323000003503000030000000000031100000000000001000000000000500000010000000000001000003310000100000000
330000000000333000000000000030000000000000040003000000000000000000203333100000000000330000000300330000000000002300000001000000000000000400000310000000003300000000000000
333000000000333000000000000030000000000000000050100010000000030000003333311000000000030410000000331000000000300000600000000000000000000000000030000010003300000000000000
333000333003333000000000000030000000000000330033310000000000000330030030000030000000033000333003330000000000003000000000000010000000003000003330003330030303053000000000
333003333333333333333333333333303030001000300333300000000000000333311031301330000000331003133303330333333001011000000000050100000000033333003330030331033300333330000000
