000000000000000000000000000000000000000000000000060000500000000100000000003000000000000000000000600100000100000000020000000000000000000000000010000000000000000000000000
000000000000000000000000000000000000130000000000000600005000000000000000000000000000000000050000040002003000000000000000000001500000000000030000000000000000002100000030
000000000000000000000000000000300000000000000001313111000000000000000000500000000010000000000000100000001000000000000000000000030030031103100000000111101000000000100010
000000000000000000000000000000000000001000000000000600000000000100003000000000303300000000000000000000000000000000000001000001000000001000000000000000030000010000000000
000000000000000000030000000006000000000000000000000000000000000000000000030000600000000300000000000000000000000000000000000010000100300000000000030000000000000000000000
010001111111000000000000000001000113110000200000000000000000003011130000000002000000000000020003020111200010010101000110000000420500000000030000030000000001001000000000
000000000000000000000000000000100010000040330030330030033333033000000003303330333333100006033033310003005000000010000000030000000333133330030001000330333300000003303333
000000000000500000000000000000000001000000000003000000000003000000000000000500000000003000000000500000130000000000000010000100000000300003001000000000001000000000000000
000000000000000000000500000000000300000000000000050003000000000000000000000000000000000000020030000000010000000000000000000001000000000300230003000016000000000005000000
000001411111100000000000000000000051000100000000000000100000000000000016111103000000000000410211000000000300000000000001000000000001400000000300014000000000000000000000
000000000000000000000000000000000000000000000000000000060000000000000000000000300000003000000050300100000100000000000000000000000000300000000000000000000000001000040000
000000000000000000000000000000000000000000000000000000000010000000003000010000000030030300310000000000100000000000000300001000000000000000000400100006006000000000000100
200000000000000000000220000200001000000000000000020000020000000000001100000000000000200000000000000000000000000000000000001000201000011011002000000010001100000002200002
333333333333333333333333333300000006000000303333363333330000600000000000033330000600330333000333333033033000000000000003333363333330001000003330331000000000000003313336
