000000000000000000000000000000000000000030000300000001000000000000000000000000000000001001300000000000000060000010000000000000000000003000002000000000100000000300000000
000000000000000000000000000000000000300000000003000000000500001300000000001000000000000000500000000000000500505000000005100001000003000000000000000000000000040000001000
000000000000000000000000000000021603440000000000000000000000000444000000000000400000000000000000000000000100001144400000000003000003000100000000000100000044000000002100
000000000000000000000000000000000000000060000000000000000003000000000000000000000000000000030000001000000000000010000000000003000030600000000600000000000000000000066000
000000000000000000000000000030660000000000000050100001000000000030000010000000000000000000000000000000030001000000000000000300005000000060030000000000000000000000060000
000000000000000000000110000000666000000000000000001000000000000000001000000001000006000400011000000000000000000000000000000000000000000010000000000000050000000000066000
000000000000000000000000000033333300303033000000000000000000060033303305000000000000000000000000000000000333033333333030000000003300000000000000000330300330033333303333
000000000000000000000000000000000040010000000300330000000000000000000000000600000000000010400000000300000040000003000010030000000000000000000000100000000000100000300000
000505000000000000000000000000001000000000000000001000550005050000000000003000000000000000000000000000030300000000000000000050000000000000000000000000000000050000001000
100001110000000002110444000000060001060000100000010000001000001000000000000000002110444000000000000000000000203000000001000311100000010021100000000000300010000010000000
100000000000000066000000000000000000200000000000010010001010000006000000000000066000000000000000003000010006600010000300000000000000000660030000000000010000001000000000
000000000000000066000000000000000000000000000000000000000000000000000000030000066000000000000000000000000000600000000020000000000000000600060000000000000000000000000000
000000000000000066000000000000000001100000000006000000000000000000000300000000066000000000000000600000000006000011301000000010000000000660001000000000100000000001100000
333333333333333333333333333300000000000000333030033030330030333033333000000003331133133330030333303000000033333303000013103033353330333333300220000000000063331300000000
