000000000000000000000000000000000000000000000000000000000000000030000000000000000000000000000001000000000000000300000000100030000000000000000000000000000600000000000000
000000000000000000000000000000000000000000000100000000000000000000010000000000000000000000003000000000000000000000000000000000000000100000000000000000000010000000001000
000000000000000000000000000000044400000003000000000000000000000000444600000300000000000000000000000004340000010030000000000301003000000001000000000000000000000001000000
000000000000000000000000000001100000000001000000000010020000002000000000020000000000000200060000000030000000000000000000002001000000005000120000000000000000000000000000
000500000000000000000000000000000000000000000000000030600000006000000000660000005000036600000000000000000000016000300000066000043000000003600000000000000001000600006000
000000000000000000000000000000202010030003000000000020000000066002020000660200010000006602000003000000200000206600000000006020000000000020660000000300000030020660056020
000000000000000000000000005533331330000033000003030030033330333333003333333030000000333333300000103333333003333100000553303330000030033300100100033000200033033313303103
000000000000000000000000000001000000003000000000000060000003000000000000001000001000000000000000000003000000000000000000000003000000000000030000000000003000000000000000
000000000000000000000000000000000000000000000000000000000000000000003000000000000000060000000000000001000000000030000000000300030000000000000000000000000000000000000000
000444000000000000000000000300300000000000000000310000000000002000000300000000000000000000000000130010030010000000000000004400000030000100000004000000100000000000000000
000000000000020002000000000000000000002005000000000004003300000000000000000000003000000004000055000000000000000000130000000000003010000010000000000300000000000000000000
000000000000660066000000000000000000006000000000005001000000000000000610001000000000000000020000000005000000000000000000020000000500000000000200000000300000000000000005
002020000020660066020003000000000000006020000000040010000000000003300000000000000000000000310000000000000000010000000000120200000050000300000021100000000003050000000000
333333333333333333333000003300000003330333000000510000300003000000003300000000000055000005500000331000000000001000000003033333000000000030303353333000100100000550000000
