000000000000000000000000000000000000000000000000000100000000000000000030000200000000000000000000000000000000000000000000000000000000000000030053000000020000000000000000
000000000000000000000000000000000000000000004100000000000000000000000300050000000000000000000102000010000000000000000000000200010000000000003000000000000000000000000003
000000000000000000000000000000020030000000000000000000040600100000000000000000006630000000000060000000000000000000000000006600000040000000040000300000000001003040002000
000000000000000000000000000000000000000100000000400000000000000000003010001100006600040000000066000000000000100000000000006603000000000000000000000000000000040000061000
000000000000000000000000000000560000000000000000010000000000000000000000000000006000000000000060000000000000000000000000006600500000002000000000000000001000000000066100
000000001110000000000000000000660000111000000000000050000000030000005001000100003606006000000000050062000000000000000000000010300000000000000111000000000000000000066000
000000000000000000000000000033333130000000000030003030000000010000000005000003033330000000030300203333301003010000000000333033000000033333330000001005006503333333333300
000000000000000000000000000000000000013000000000000000000000000000000000000000000300000000000010000010000000000000000000000000000000000000300303000000005000000000000000
000020000000000000000000000030000001000000000000000000000000000000000060010000000000000000000600000000000000000000100000000100000000000000000000000600000010000060003200
000660000000000002000000000400000000000000000000000000000002010000000400000000000000000000000000001000044000000000300100002000000000000000000000000000000000000030006600
000660000000000066000000000000003000000600000000000000100000000000000000000000000000000010000000000000000000600000000000100000000000000100006000000000000000000000006600
000660000000000066000000000000050000006600000000000000030006000300000000000000600000600000000000000100000006600000000000060000000000000105000000000000000000000000006600
000660000220000066000000000000020000006620000030050000303066000000000001610000022000000000101110000000100006400001100032061010000000000020000000000000200000000000016600
333333333333333333333333333300000003003303000000030133333333333305003000000033333300630000000000203303313333033300000033333033000000030333230000000033033300000010303033
