000000000000000000000000000001000000000001000003000000000000000000000000000000000600004000000000000000000000000000300003000000000000000000100000000030000000000000000000
000000000000003000000000000000000000000000030000000000000001000050000010000000000000000000006000000000000001001000000000000000000000000000300030000000000000000001000000
000000000000000000000000000003200000000000000000000000000000000000000000001000010000000210000000000000000003000000024000000000003000000000000030000000000000000003002000
000000000000000000000000000000000001000000003001000000000300200100100061000003030000006600000000001000000303000000660000030000303000000000000000000000000050006000006000
200000000000000000000000000000000000030000200000000100000030000000000000000003330000006603000000000000003330001600650033000003333300000000003300000000300320003000030000
111100000000000000000000000000022100000000111100000000005302000000000000300003000000006601000030000000030302000003001000000030303000000000000030000000000511330000000000
000000000000000000000000000012330330000000000000000000003330330000000000000013303333330333000030003333330330333333633333333331333030300003000033336303333300000003333033
000000000000000000000000000000000000000000000000000000000000000000000000000001030000000300000000000000000300000000000000003000000000010000000000000000000000000000000000
000000000000000000000000000000000003000001000000000000000500000000000000000000000060005000000000000000000300000000003000000000000000000000500000000000000000000000000000
000000000020000000000003000000020000000000000000000000000000000000000000020003000060000000000000000000000000200043000000000000001330000000001000000000010000030000000000
000020000660000000000303000000630010000000303000000300000000000000000000660103000000000000000000000000200000000000000000030000000020000000000000000000000001000000000200
000000000660000000003333000000660010000000333000000000002000000000000300600000000000000000000100001000000000000020000000000000000000000000000000010000000000000000000000
000220000660000000033303000000660030000000303000000300331010000000003300660000000000000000011513000000000000000011110000003000001020030000000001000060000000100000000200
333333333333333333333333333333333330000003333333103300331000010333333330003300000000000000000000003333313000000000100000000041335314303000000000000000000000000003333313
