300000000000000000000000000000000000030000000001000000000000000000000000000005000000000000000300003030000000000000000030000000000001000000000000000000000000000000000000
300000000000000000000000000000000000000000300000000300000000000000000000000000000000000000200000003000400000003000000050000000001003100000000000000000000031000000000000
000000000000000000000000000060000000000000333333300000000000000000000000000300000330033300300000000050000000000000003330000010301000000000000000303363333300000000000004
000000000000000000000000000000000000000000300000000300000000000000010100000000000000000000100000300000000000000000000003400000013000000600100000000000000600300000000000
000000005550000000000555550000000005055003000000005500000555500000000015555000000000000000055015100000000000300000002000555002000005055005000000000003000301000005550300
300000003333000000003333333300000033333303000000001333000333300000000003133103333000000210033033303000000000000033000000330300500000030313333333000000000030000003330363
000000000000000000000000000000000000500000000000000000000000000000000000000000000000000000000000000000000000000000000000300010000000006040000100000000000010000000100000
000000000000000000000000000000000010000300000000100030000000000000000000000000000000201000001000000000003000000000000001000000000000030300000000000000000000030013000003
000000000000000000000000000000060000000000000100000040103000100006000000010000000000000000000000000000000000000003000000000000000001030000000000000000000000000000000060
000033333333333000000000000000003330000006300000000000030000000033334300000000000000300000000000000000000000033000000003030333300000000000000000020300000005000000001000
000000000000000000000000000000000000050000000000000006130000000000010030030006000001000000000000300000000030010000001000000000000000000000100000003300000000000000000000
000000000000000000000000000000100000000000000000000000010000000000000000000000000000002000005550000000000000000001000000000000001000001001000555000000000000000000000300
333300000000000000000000000033330000001300000000030000003000000000161000030033000000000000013160000000003333300000000030000001000003030000000303300000000031000030000003
000000000000000003300000000000000000030000000130000100006000000500010010100000030300000030032000000000000000000000000000000000000330000000030000300000330000000000100000
