000000000000000000000000000000000000660000100003000000003000600030000000000000000003000003000000000000000000000006600000000000100000000000000030003166000000000000000060
300000000000000000000000000050300000060050000000000000000000000000000000000003000001000000530000000000000000000006600500100000000000000000000000033066005000000200000000
000000000000000000000000000001011600001100000100000000000010000010010063000000000030001000000000000000000000000003401000000500000000000600100000030033110600000000000000
000000000000000000000000000000000100000030000000600000000000300000001030000000000100000020000000010000000500000003000000003000000000300000000301033010000300000000000000
000000000000000000000000000001010000000000000000000000000003600000010000000000000000000060000000000000000000000000006003000000000003001000001030033000000000000000000000
000000000000000000000110000000000003000000030000600000001000000000000000000000000000000660000000031000103000310000000000000000000030000000000001003006000111000000000000
002000000000000000000000000033333303330300000000006000003303303333103300003000000000003103300400000000000000000033333530000000000000003333303030303333303001000000020000
066000000000000000000000000301000030000000000000000020000000300066000000000010000000020020306600300001000010000000000000003003300000300000000000000000000030000000000000
066005000000000000000000003301000330000000000000000000000030033066005000000000000000000003006600500000000000301000003000000000000003030000000000000000000001000001000000
033110000000000101110000003300000000000000000000000000300000033000100000000000001000000003303311300101100000000000000001000000300033300000000000000010110000000000000000
000000000002000000010000003301000330005000000010000000000000033000000000000000000000000003300010000001010100500000000000000200000003304000000600000000001000030000000000
000000000066000100000000003300000330030060000660010000000001033000030000000011000000000003300000000100010000000000000000000600000003000030000006606010500000000100000003
000000000066000000000000003300000031100100000660000000000000030000010000000101100000500003300305000000000001000011000000036600000003000100000006600000000000000000003000
333333333333333333333303330330333000000300333331300200003033300330330016000000000000303330303333333333030012000000000013333330303130300200004333333363333304000000030300
