000000000000000000000000000000000000000000000000000300000000000000000110000000000500000300000000000000000000000000000030000000000000000000000000000000000000000000000000
000400000000000000000000000000000000000000000003010040003001000000003000100003004002000000000000000004000010000600000000030000001000000000000000000000000000040000000000
000000000000000000000000000030000000000010004000000000100000000100000000000030100006000001000000000060000000000001010000000010000300000000000300000000000000000000100000
000000000000000000000000000000000030005000060010000200000030000000000010000000000000000030030000000000000000000001000000000000000000000000000000000003000000000000000000
000000000033000000000000000000000000000000000000000010000000000000330000000000000600003000000000000000000000300000000000000000000000000000500300000000300000000000001000
000000000000000000000000000001000000000010002220000000000003102000010002002000000000022000000000023000010030000000000003000002000000002222003020003000000000000000202300
000000000000000000000000000000010000000000333333300003003333333000000030331300030000133033533300330000000000000000000003330330000000033030333003303000030000030001333003
000000000000000000000000000000000000000300000030000000000000000300000000300000000050000003010000000001000030000000000000000000000000400000000000001030000000003000000000
000000000000000000000000000000000000300000000000000000000000600000000000000003000000000000000000000000000000000000040000050000000000000001000000100000000000030000000500
000004000000000000000000000000300000000030000000300000330000000100130000001100000000001000000000000000000030000000000500000000000004000000000010600000000000000400000000
000000000000000000000000000000000000000003000000000000000000000000000000000000000100000020000000000000000050000100000000000000000060000000000000003300000000000030000500
000000000000000000000000000000003000000000000000000010000000100000006000000000000000030000000000000001000013000010000000001300000000605010000600000000500000010000000000
000000020000020222200022000000000000000000002000020000020000000000000002200000000000000000000000000220000000000000000000000000001000002200030000000200000000000300000100
333330333333333333333333333300100003003303003533303030333330333000001003033030100000000001000000503333330350300301000003010000333320303333300000000303333333303000001000
