000000000000000000000000000000100000000000111000000000002000011004000000020000000000006001011300000000004000000000000010000000001000000000000000000110000000000000000000
000000000000000000000000000000000000000000111000000000001000010100000010000000000000000000011000300000000500000000000000010000050000001100000000000113000000000000100000
111111110040150000111111000011100001111111001100310040151000000100401011110110000001100001500110001111161000001000000110004015101000104000000000011301100030040250000011
100000000000000000000000000000000000030300000000000001003000000000000010200046000400000000000000001000300000600000000000000000000000000000000000000000000000010000000010
000000000000000000000000000000000000005000000000000600006400000000000000000000030000000000000000001000000300000000000000001000000000001000000000000000030000000000000000
000005055500000000000000000000000000000050300000305500006000000015000000300500000000555000000002100000051000300600000005000000000005000000000000100000000055500000000000
000000000000000000000000000010030000000000333313330000000333331000000000000000000000000000033303330000400333330300000000100002030000033333333000000300330330010005333033
000001111100000000000000000000000110000000030000000103000000000001000000000000000000000000000000010000004000030000000101110000010400000000000000000000600000000010100000
100001011100000000000000000010000100060000010002050000000000000010000001000000000000100000110030100005000640000010000101114000000000000000500000110010000010000100000000
100000000110000000011440000010000000000151440000000000010100011001030011100004400010000011120300001010000040000010020000010000110031100000100100116040030010000001000000
300000000000000000000000000001000100000001010500000000000000000000000000000000000030000000001000000000000000000330010100000000100000000000000000000000000030003000000000
600000000000000000000000000000000000000000000000000000000000400000000000000000000000003000010000000000000000000163000003000000000000000310000001005000000030030000030000
600000000000000000000000000060000000000000000000000000000600000000000000000000000000000000060301000000000000000060000000000030010005350000000130050000003060000000100000
333333333333333333333333333330033300005030303303333333330330333303330300000003333330000000033333300000000333333300033133333333000000033333330000000330033330333330000010
