000000000000000000000000000000000010000000000000000000000000000300000000000000000030000000000001000000000300000100000030000000000000000000000000100003000000000000000005
000000000000000000000000000000000051000000000000000000000000000000030006000000000000000030000000006000000001000100000000000001000000000003000000000000000300000600002000
000000000000000000000000000000000000300000000000300000000000000100001000000003300000000010000000010000110000000300003330000003000001000000000030100000030300000000000005
000000000000000000000000000000000003330000000000300000100000000000000000000003330000000000000000000003000020003300033330000033000001000000100000003000333300303003400000
000000000000000000000000000003000100330000010003300000000000000000000000100003430100000000000000000020000000003000330330000003300000000000000000000000000006000113130000
000000000000000000010000000000000000300002022333300000000000000300000000004003330006000000000000000110000002303300333330023000000000000000103000000003333300000003330002
000000000000000000000000000000000001330330333333300000000003000333330300000003335333000003000000003033333333330333603500033003333033000133003303333303333000000000333333
000000000000000000000000000000000000000000100000001300010000000000001000001000000000400000000000600000000000000000000000000000000000000000040300010000000000010000000000
000000000100000000000000000300000000000003000000000000005000000000050000100030010000000001000000000000000000000300000005000000000030000000010000000000100000000000300013
330000000000030000110000033300000000000333000000000030100000000000033000000031000000002000003000100000000000030300000003300150300300000000000000000300000300000000001000
333000000000330000000000333310000000003003000040600000000060000000333303000330030000000000033300000000000000303300000003033000000000000000000000000030000000000000005000
333000000000333000000003333301000000033033000000030000000000000003333300000330000000000000036303010000063000330000100000330000000001000000004000000000003300000000000000
333000202233333000000033333300000000333333000001030000000000000033035302233330300000000000033360020000000033333300010003330002000000000000200000030022003333000100000005
333333333333333333333333333300100003300330030000033303000000000303333333333330000000000000003330310300000333330300003003303333303000000030000000000303333300000300000000
