000000000000000000000000000000000000000000000000500000000000000000000000000001000000010030000000000030001400000000000000000300001000000000000000000000000000000000001000
000000000000000000000000000000300000002000000000000000000000100000001000000000400000600000000000000000000000000000000010000000100000103000000001000010000000000000000000
000000000000000000000000000000000040010110200000000001000011100000010300000000000000030000006000300000000000000000000000010010000000000000000001110000060000004000010000
000000000000000000000000000000050000000100000000000000000000000000001000000000000030000000030000000000000000000000000000000000000000000000000100000100000000000000100100
000000000000000000000000000000200000001000000000000000000000000000000000000000000030000000030000000300000000003000000010000021000000030030000000000000000000000000030001
000011000000000010000000000000025030000000000000000001100500100020000050030000000000000000000100000000110000000001100000000030000000000000610200610003000000000000000000
000000000000000000000000005533103333303330000001000000003333333333333300000000003055333033300050000000000000105504000000000050103330300000006330333333333330300330000000
000000000000000000000000000000000000000030000001000003000000000000030000010100000000000000600000000000000010200000001003000000000000000000000000000004000003000000000000
000000000000000002000000000000000000000000300300000000000000000100000100000000000000030200000000010000000000000000000000602000000000100000000000000000200010000000000000
000110000000000011100000000000000000000000000000000010000003000000011000000000000000001100000100000000000000110000101030011000000000200000000000000001101000000030000000
000000000000000000000000000000300000001000000000000040000300000006000000000030003000000000000000000000000000000300000000060000000300000000000000000000001000000000000000
000000000000000000000000000000000000000001000000100000000000000050003000000000000000303000000050000000000000000000000000000000000000000000000000000000001000003000000000
020000000000000000000000200300005000010000000000002000000001100000200300000000000100000100000000000000003000000102000000000050000011000030030010000003000000000000000110
333333333333333333333333333300001000000010333330333003330000001333330300000003333303333333300000003330333333333333333003003033000000033333300000000030033300030551000000
