000000000000000000000000000000000000000000000000000000000000000000000000000000400000000000000000000000000000303000000000000001000000000030000000000000000000000000000300
000000000000000000000000000030303333300000000000000010003100000000000300000000000000000000033001000300000000001003000000000000003333000001000050000000003000000000000100
000000000000000005500000000000050000000000000000000303000000040200003002530030000500000000000000060133100000500000000000030000000000000000200030300000000000000000000600
000000000000000000000002000000300103330335000000000000001000000000030000000300000000000000033300001500000000000000000000300000000000000200001000001000000000000000000000
000000555500000500003333330000000000000000535000000000003303300555000000000500500003000000500300000000000000000355500000003001340000030303000100000000000555000000030000
000000333300003000000000000000012100000000033100000000000000000331005000000003000000000000300000000000000000010030300000000000000000000000001000000000000033000600000500
000000000000000000000000000000003001000033000300030000000000000000000030000030000000000000010300333000100000000000000003303330000000003000003000000000000000000003000303
000000000000000000000000000000000000000000000100000000000000000000000000000000000000000000000000000000000000006000000010000000000000000000100000000030000000000000006000
330000000000000033333000000000030000000000000000000000003300300000000000330030000000003033300030500000000000101033000000000000300003000000000000003003000030000000023033
000000000333000000000000000000060000000000000100000350001000000000000000000000000000000000010340000010000030003000000000000000003330030005000000000000550000000000000000
333333000000000000000000000001000000000000000000000000003033030010000000000000000000000000010000000000000000000030303300100000000000000000000000000000000033301000000000
000000000000000000000000000033031000001005000000005000030060000000000500000000001000060000003333000000100555100000000000000005000000005000033303300050000300301000000000
000000000000000000000000020000000000000003000030030000000000000000000300000000000200001100600000000001200333100000006310000003000000000002000000000302000000000000000000
100003330000000000300333333300000000000000333303001000001000031000000000003303033033000030000000003303303000010010000330000500301000001000000000000000006330000030010300
