003000000003000000030000000000000000000000050003033030003033000001003000010300000030000000000000100030000000000000000303003006000000000000000000000333300004000300000000
000000000000000000000000000000003010000000000003100000000000000000000000000010000000000000050003000000030000000031000100000000000000000000000000000000005003000000000000
000000000000000000000000000010001000010003300000000040000000400000000010000000000000000100000000001000000000000005000500054100000003000000000000000000000000000000000003
000000000000000000000000000000000600000030000000000000000000000005000200000000000000300000000000000100010000000000000000000001010000000003000000000000000000003000000000
000002000000000000000000000000000000300010033330000000000033000000000003333000030000000000050000030010120000003030000000000000000001000000200000000000303000000000000000
333000000033300000011111111100033300033030000000000000000000000000001000000000000000111100100033003330000000000000000010000020301300030000000000330000000300000000003310
000000000000000550000000000000000000000300000000000333330333303055000000000003303033000000030002000001000300000305500000330333000030003010000000000033333305500000000000
000000000000303333000000000000000000000000003000000000000000000000000002000000000300133310000020300000030000000000000300003003000001001000000000030003000001000004033000
000000000000000000000000000000000004010000000000300300000030030000000000000030000000000000000000000010000000000000000000000000300000000000300000000000300000000000000000
000003330000000004400000000000001000000010000030000200000000033001000000300000000000001443030000000000010000003330000000000000000000000000003200400000000000000000000000
000000000000000000000000000003000000000000000000000000000000000000000100500000001000000000000000000000000000000000600000000000000000000000000001000510000000000000000000
000000003333000000000000000000000000000000000002010000000010600000003000000006000300000000003333000130600300000003330000000000000000000000000333300030000000000300000000
003333000000000000000000000000006000000011330000011110210033330111111133300010010000000000000000010000011003330000000001101111000330300000000000000011110100000003333000
000030000000000333333330303300030330530000000000001000000000310000000000001000000000003331300000065050000000000000100000001000000000033000330000000000500103030330000000
