000000000000000000000000000000000000310000200000000000003316000000001000000000010000000000301000000000000500006000000000000000330020000000003330000000000000100003100300
000000000000000000000000000001030000000000001000000000003000000300000000003000100000000053600104000000000000000000000000000000330000000000000300000000000300000000000000
000000000000000000000000000000000000100600000001000000000301000000000000000030200000030030100000000003000000000000000000303001031000000000000000300000000000010000000000
000000000000000000000000000000000200500000500000000000000300000600000000000006610000003330000030011000000000030000000000000000030003000000030300000040000010000000000060
000000000000000000000000000000000000000000000000000000000300000000000000000006600000033336300000000000000102000000000200000000030000000000003300000000000000020000000000
000000000000000000000330000031000003310000000000000000003103000000000000010006002001333333300000003300000000000000000003300001330000100000003300000300300003000000000000
000000000000000000000330000013000000330303000000000000003330043000100000000003333303033033300000003000000000006300000003200000330333300030330303303330000030000300003033
000000000000000000033330000000000000000500300003300001000000000000003330000000000000030003000000000000000000000000000000000000000000010500330000000000003300610030000000
000000000000000000333330000000000000000500000033300000000000000000030300000130000000330050001000000000000300000000000000030000000000000000031000000000033001005000000000
020000000000000000333030000000500000200000001033300000000000000000033300000000000000000000300100003200000020000000000000000010000000000003330001010000033302100000300000
660000000000000033333030000000101006000000000333300000000000000000330000000000000000030000300000003600005000000000000206600000000000000316330003100013303366000000000005
660000000000000333333030000000500006600100033303300000000000200033300300000000000000030000000000006000000000000000000006600000000000013330330000000033030366000000000000
660200000000003333333330000000000006100300303030000000000000000303133330000000000010330000000000000002000010000000005000000000000000003300030000600333330360020000000000
333333300333333333333333333300333303130333303333300000000000100333333303000000033130331333300333633333330006000000030003303333000000033333330000000303330033330330000003
