000000000030000000000000000000030001000000040000000000000000001100000000000000000000000010140103000000000000300000000000003000000001000010000000000000000000030000000000
300000003000300000300000000000110300000000030000030000000000000000030000003000010000001003000000000000300030003000000000000030000000001000001000300300000003000300000000
000000003000000000000000000003000000000000300000000010000000500000000100000000000000300000110000050000000030100160000000305111000001000000003000000000011003000000600000
000000000000000000000000000000000000000000330030000000030000001600100000000000010610300003300000000000000000000003000000000000000000000001000000000000000003000000000000
000000000000000000000000000052000000000000305000063100000000000000000000000000000000310003000000000000000000030100000000000000000000000000000000000000000000000000030000
000000000000000000000000000000000000000000301003000100000000000000000000000000000000300000040000000000050000000000000000030000300000000500000001000000000000000000000010
000000000000000000000000000000000000300300300030033130333333333330000000100000010000301010000000000000000000000003303330000000003000033300000000000000000001000000000000
000000000000000000000000000000000000000000000000000000060000000000000000000000003000030000000000000000000000000000000000001000050000000000000000000000000010030000000000
000000000000000000000000000000000030000005300000010003010000000001000000020000300030000000230000000000000000300030000000000000000400005000005000000000000000000000000000
000000000005001100000300000033000000000000001000000000000000000300001010000000300001010060000000000000500000010000000000000000000000060005001000400000050600000000300010
000000000000000000000330333300506010000000000000600003000000000330330300000000001000000030000104000000000000100000000030300333000001003000000000000000000030030300000000
000000200000000000000300000000000300030002000000000000000001000300000010011000000300000000000000400000000000000200000001000000005000000000010000000000000030003000000000
000000000000000000000300000000000000000001000000000100001000000000000000000000000000000000000000030000000000000000000003000000003001003000003000000000600030000000000001
333333333333333300300300000000000003033333004000000000000000000000500033333300000000300030000000004330330333335000000003000000000000033333363300000333333030030003363300
