000000000000000000000000000050000000003011000000000000000030000000000000001010000001000000000600003000000000000000050000000000400000000003000300000000000000000000000000
300000000000000000000000000010400000005000000000100000000000000000000000030000000000000000200100000000000000000050000000000000600000000000000000000000000000000000000000
000000000000000000000000000000000101111000000000000000000300000000000601100000300000100006000000000000000010143000000000000000100106033000000000000100306600000100000000
000000000000000000000000000000000000000000000000000000030000000000030010500000000000000030000003000003000000000000000000000000000006300000000300000000006600000000000300
020000200000000000000000000000035000000000030000200000003300100000003000100000000000000006010000003003030000000005010000000002000206633400000200100000336000020000000000
000001000000000000000411000000000000000500000001041103033300000411000000000000000000100536600600100000030000000350100000000000010006030000000000010000003000500000130001
000001100000000000000000000000005006333304000001103000000000333000000033333030000000033333300000000333300333300000000000000000033003000033330000001030033000000010500000
000000000000000000000000000000000000000000000300000000300000000100000300500100002000000030000000000000001000000000000010000000000000000000060200001000000000001000001000
000000000000000000000000000200000000000000000300200000000000000300000000000620040000000000000000100000000300000000000000000000000000600000100000000000000000000000000000
111100000000003300000100006633000000000000000000600000003300000000003010000610000002300000000305000300000000000000000000000000000000011100005000000330000001000000000000
000000000000003000000000006630005000103000000000601000000000000010000000011660000000300000300010300000000003000000101030500000003000000000000000000303000000010000000000
000000000033333300000000006603100000000012000003600030330030030020000030000630003333530000300000000000000020000200013300200102000000000000000003330330000000100000000000
000000000000303300000000006633000003000000005006600000300300000000000000010660000000330000000000044110100000000000000300000000000000000000000000030333000000100000000000
333333333333000003333333333300033330000003331303333333000000000000000131113233033300000333300000000001001001301103333000000010000000033310331133300000303333303600041000
