000000000000000000000000000010000000000000300000030600000066003000000000000000000050000000000000000000030006600300000000066003006000000000000061003000000004000000000000
000000000000000000000000000000000000000000000000600063000066000000030010000000000000000000000000000004000006600000000000066000000000000000000061000000000000000000000050
000000000000000000000000000000001100000000000040000000000000000000000000001020000000000000300000000000002000000000000300000000000000200101000000000000001000000000310500
000000000000000000000000000000000000000000001000000600000300000030000000001660010000001030000000000000066000000000000000010000000016600000003000000000000000100000000000
000500000000000000000000000000000300005000000000000000000000003001530001000660000000000000000050000000003000000000000000000000003006600000000000000000010000600000000000
000000000000000001100000200000005000310003020000200000600000010000003000200060001100301000000020000020060300000000000000000000005006600030300000030060110000020000000000
000000000000000000000006600333330331000000333303300333000033333000300010313330000200000000000060003303333003333000030000050303033030033333000003133000000000600033333331
000000000000000000000006600300000000000000001000000001000000200000000000000000000000100000000030000000600000300000000000000000000000000030000100030600000000000000000000
000000000000000000000006600000000000000000000000000000000000000000000000000000000010000001001000000000000000001000010020000000003300102100000010000000000300000000000000
000440000000020010100000000000000000000100000000000300000000100000000023101000010300001000000040000000000000000000044000000000000000000000000000000000000000000020004403
000000000000660000000000000000000060000000000050000000000000003000000000000000000000100000000000000000000606030000000000000000000000000000000000000000000000000000000000
000000000000660000000000000000000660000000030000000000006001000000000100000000000000000300600000000000000000002100000000000000001500000000000005000000000303000060400000
020000200200660000000000000000200660001100000200000000000102000000020030000000200012000000002000020001000000200002000020001110000000001000300035000000000000200660000000
333333333333333333333003333330363330000040006600530000000066013000000033030330333033310333313330330000100006003333033330001000000000010060030000000001000033043333333303
