000000000000000000000000000000000000500000600000500000000000050520005000000003000000000000010000000100000000000000000000000000000005000000000000050000060000006000000000
000000000000000000000000000000000000000006000000000000000050000000050100000000100000000000002000003000000000000000000300000016003000000010100000000000000000003001410000
000000000000000000000000000000000000010001000000000000000000011000000000000000000003000101100000001000000000000005000010000110100010000003001000000000000000000000000000
000000000000000000000000000000000000610000000000000000000000000000000000000000030000001000000000000000000000000000000300000000000000000300000000000001000001000000000000
000000000000000000000000000000000030000000000000000000030000000003500030000030000000000300001000000010000000000300000100000000030000000000030000000000000001000100000000
000011111111000000000000000000111060000001000000030001000002002001000000022000000000000210000001101111000030220601001110001000003000006002060030000010001101001111001100
000000000000000000000000000000400000000000000000010000003033333033333330333310000100103333300000030000100130330000000000000000033313333303330033330000000000000000000000
000000000000500000000000000000005001000000000045000000000000000000000000000000000000000000000000000000000000000000000000000000000000000000000000000301000050100400000000
005000000000000000000000000010000100350000000000010000000000420000000000000000000000000400003000000000000056000000000000000000000000000055000000000000000000501000000000
000001110000000000000000000000000000000011100000030000000000100000030000000000601000030000000000001000005000000000010000000010000000000000000000000500000000000110000040
000000000000000000000000000000000000000000000000000000000000000003000000030001100000000000000000000000000001000001500400000000000000030000000000001000000000000000000100
000000000000000000000000000300000000000000000000000030010000000010000000000000000000000000050000000000000000200050000060000000000000000000000000000000000300000000004000
000200200000000000000000220600050100002002000060000020060000000111100000011010000000000000300100000000010000000000000000002002000010011011000000000000220600020006003000
333333303333333333333333333333333033333033003330031313300000000000400000000000333030000000000060000033353033330300300003050033303033300000100130330033333003330030000100
