300000000000000000000000000000000000000036040000000000005000000000000000000000003000000000030000100000000000310000000003000000000000000000000000000010100000030010000000
000000000000300000000000003000000000000000500003000000330000005000003003000000000000000000000000000000030300000000000000000000000000000000003000100000001100000000000030
000000000000340000000000001000004000000030000001000000340000400000001000000000000030000011000000001000034000001000000000000000000010000000100000000000000000000000000100
000000000000000000000000000000300000000000000000000000000000000000100000000000000000003000000000000000100000000000000000000000000510000000000001000000000000000000011000
000000000000000000000000000000000000000000000000000000000000000300000000030000000000000000000000000010000031000000000030000000000000000000000000000000000000000000000000
000000000000000000000000000050300000000000000000400103000000010000000000000600000000000100000000000000000030000000000300000001000010000000000000051000000300000000500000
000000000000000000000000000030300330000000000000000000003330303000000050000000330133313330000000000000000000000000000000300000003330301000003303333000000053030330300000
000000000000000000000000000000003000000000000000000000000003000000000000000000000000000000000300000000000000000000300000000000000000000000000000000300000300000000000000
000000000000000000000000000000000000000000000603000000000000000000030000500001100000010003001000030100000000000000000000000000300000000000000000000001000000000000000000
000000000000000000000000041010001100000001000000000000000000000000000000000000000034000001000000000000000030000000000340000000000000000000000000030010000000000000000010
000000000000000000000000000000000000000300000000000000000000000000000000000000000000000003000000010000000000000000100000000130000300000120000000000000040300000000000000
000000000000000000000000000000000300000000000000003000001000000000000010000000000001000000000000000000010000000300000300005320020000000100000000000000000000000000000000
000000000000000000000000000000000000000000000000100000000000000000000000000000000000000000300000001000010000000000000000000060000030000000010301500000000000000000001000
333333330333300300033333333330333500000000030000333360030300000333333630033300001002000030030330303333033032333301000003033030010003333330300000000300000000030003330303
