003030000000000000000000000000000001000000003000000060000030000001000000000000000000060000000000000000030110030000000000300030005000000000010000100000000100003000030303
000000000000000000000000000000000000102000000000060600000002000000000000000000000000000000000100000000000000200000000000000500000000000001000000000000000000000002000030
000000000000000000000000000001011300066000300000000000003066000000001000000000001110000000000003000010000000600010000000001000061005030660000000000000100001000000050000
000000000000000000000000000000000000160000000000000000000066000000000000000000000400000402000000003000000006600300000000000000000000000660056000010010000000000000000000
000000000000000000000000000000000000006000000000060000600060010000030006005000011000000000000000000000000000600000000000350000000000000660000000000000000100000000000000
000111110011111110000000000000000000030000000110110011110066060000200200000000200003006000001000020010000006600000021021110000000216000660003002032011000000000030000011
000000000000000000000000000033003303333033000000000050003603331333333300000000530333010000033033300001010331003333000330000000360330033333303303303000000000000000000000
000000000000000000000000000000000000000000000000100000000000000000000300000000030300000500000000000030300000000000000000030303000000000000000050000000000000100000000000
000000000000000000000000200000000000000000000000410000000000000000000000000000010000100006300000040000000000000000300050000011000000030000001002000030000000000000000000
000111000000000000000006600000000000000000000000000000404010000000000000000100000000000111000000000001000000000000000000000000001111000000000066000000010000000000000000
000000000000000000000006600000100000000000000000000000000000000000000001000000003000000000000000050000000000000000000000000003000000000000010066000300000000000000000100
000000000000000000000006600000000000000200000000000000000000060030300000000000001000000100000000000000000000000100200000000100000000000010000061000000000000000300000300
020000000020000002002006600011000000000000000200060000000000000110011111100000031011020000010010110001101000200313011110000101100000000000000066000020030010011100002000
333333330033003333333333333300001003103300033330301000003003300000000003000000000000313033300000000000000300330000000000000001330330300000003333333363333300000000003000
