000000000000000000000000000000010000000010000000000001000000000000000000000000000000000000000000000000000000000000000000000500000000001000000000000300035000005000000000
000000000000000000000000000010000000000000103000000000000000000002000030000500001000000000000300000010000100000000000000200000000001000000001000400000000000000000000000
000000000000000000000000000000005000100000050000000130001000001000000004000000003300000003000000000100160000000000000000000100300030000000000000002004000000111001003000
000000000000000000000000000000003000000010000000030333003000000000000000000003303300000000000000000000000000000000000000000000003030000100060000000300000000000000333360
000000000000000000000000000000000000000100000010030333001000000000060000000003430306000000000000010000003000000000000000000000000000300010000000000030000065000003033300
000000410111100000000000000040111100000111120000000033000060000000000010111100003100000010101000051031110220000000000060000000000000000000042200000000000000000000003000
000000000000000000000000000000000000000000333003030031333333003300000000000003000000000000000100000000000033033301000003330330000000003050003330333000000030330331033333
000000000005000000000000000000010000001000010000000000000000000300000300000000000000000012040000005000000010000000000000100000000000000000010000000006000000000000000000
000000002000000000000100000004000000000100040000000000001003000020003000300000000000000003100000000200000000000000050000000000000000010000001000000000000000000000000600
000330001111000000000000000001111005000000000102000000000000000030110000005000301000000000401000000111000000330000053060000020000003050000000030001000000010010000001001
333330000000003000000000000000005000000000000000030000100000000000000000000500000000000000030300000000000030330213333050030000000010000010003000000000300053000100000000
333330000000000000000000000000000010000000000000000000000000000000000000000000000000000010000100000000000333330033333000000000000000000000000300060000030000000000000000
000330000000000000000220000000000000000000000000400000000050000000000000000000000004000020000000000000000000330000003000000000001313101000040000000111151000000003000104
303333333333333333333333333330033331000000000000033333330333333333031301000300000000000000033133300303333003333330330333303130130000013333333333333000010000000300001000
