000000000000000000000000000000000060000100000000000100000003000000000000000000000000010000000000030500000000100003000000000000000000000000000020001000000000000000000003
000000000000000000000000000000000000011000000000000000000100000000000000000000000000300000000000000000000000000000000040000001000050000000000000000010000000130000100000
000000000000000000000000000000000000000000000000000000000000000000000103300003020000303330000000000000000000000000000000020000000003000101000000000002000600000000000000
000000000000000000000000000030000000000000000000000000000000001050000030300000610003333300000000040000000000000105000000110003000000000000000000000060000300000050000051
000000000000000000000000000000001000000000000300000000600000003000001033330000600003303330100001000000000000000000300000660006030300000000000000000066000000100000000000
000000000000000000000000000000000000000000000000000000000000000000000533333030600000033330310000000000000000000300000000064000000300006000000000300060003000000000000000
000055000000000000000000000000010003330033333333000005500020550300313033030333330003333310200010003303310303333300000000310003033003333303333303333330000000000000000000
000000000000000000000000000000000000000200000000001000000300000000000000000000000000000030003000000000031000000000000000000000000000000000030000000000000000000000000000
000000000000000000000000000000500100000000000000000000000000030000000000000030000000010000000000030000000000000000003000000000000000000010300000000000000000000300000000
002000000000003333300000000000003000015000330030005030000000000000000300000000000000000000100000030003000012000001000030000000330031000000003303000000000000000000000000
066000300000003333300000000000000010600000333030300000000000000000000000000050000000000000000010000000000066000300000000000000103330000000003330300000000000000000000000
066000300000003333300000300000000000660060330030000000100003000000000040000000000100000000000000000030003066000000000000000000003300030000003033030000000000030000050000
066000000000033333303000300000000001600000330365300001000003000001000100000000000000000000000000000010000006000000000030006000033300300000001303003000000000030000000000
333000333333333333033333333300000000330003333300100000003333313000000000050000300000000015000000000030000333000360005000000000300303300000000303033000000003303030000500
