000000300000000000000000000000000000000000003000000000000001000000000000000000300000000000000000000000000000000000200000000000000000000100030000000000000000000000000000
000000000000000000000000000000000000000000550000000000000000000000000000000010000000000000000400000000000000000000000000000000550000000000000000000110000000000005103100
000000000000000000000000000000000000000000011000000000000000000000000040000000000000000000004000003001000600000004300000000000001000000000003400000000000003000100110000
000000000000000000000000000003000100000000000000000000000000000000010000000000000000000000000000000030000000000500000000000000000000200000000000000030000000000000000000
000000000000000000000000000000000010000000000000001000000000000030000000000000000000003000000000000060010000000000000000000000000000000100000000000400000301000100020000
000000040000000000000000000000000000200020000000060000000000000000000000000004000300000000000000000000030000000000000030030000000000000000020000000030000000000003000003
000000000000000000000000000000000003130003030130300300003363001000060303333330000000000100033330330000000010000010000003303333303333000000003333336000130000000003033333
000000000000000000000000000000000033000000000000000000000000300000600000010000000000000003010000030000000000000010000000000000010000000000000000000300000000000000000000
555000000000000000000000000000000000000000300000000000200000000000001000000001550010550000000000000000000003000000000000000000003000000000100000000000050000000010000000
011000044000000000000000000000000000000000440000000061000020000000003000300000110010011000000000001000000000000000000000004000000000044000000300000000000000000020000000
000000000000000000000000000000000000000000000000000000000000040060000000000000000000000000003100000000301000000000100000000000300000000000000000000000010000500000010000
000000000000000000000000000000500060000000300000000000000000000060000000000000000100000000000000000030000000102000030000000000000000000030000000000000000000000003036050
000000000000000200020000000000000100000000000000030000000230020000000000000000000000000000000031000200020100000000000000200020400002000000000000000020002040000000000050
333333333333333333333333333300000003033333103333300000003333333000000000000000333033333333300030000135300333330300000103333330030000030333333033013003330300000000000000
