000000000000000000000000000000000000000000000000000000000100000000000000000000000010000000300000000300010003000000000000000000000000000000000000000000000010000000000000
400000000000300000000000000000055500000000000600000000000003000000000000000000000500000000000000000000550000000000000300000000403100000000000000000000000000001000000000
000000000000000000000000000000050000000000010010100000000000000010110001003000000000000030000000330000000000000000000000000000630000000000100000303000000100003000000200
000000000000000000000000000000000001000000301001000000000050000000000300000000000000000000100000000000000300001000000000000000050000300000000000000000000000100600000066
000000000000333300000000000000000010000033000000000000000301000000000000000000000000000000000000000000000000100000003330000000000000100000030000001000000000000001000003
000000000000000000000000044303100000000000001000001000002000000000000000000000000000000000000000000000000000000000000000000043011000000030000001000000000001004000000000
333330000000000000000000000030000130000000000000033330330000000000030033330033000033333303333333303000030500030000000000600000333030030330033300333000000000000030000000
000000000000000000000000000000000000000000000000000100000000003000000000000000000000000000000002000000000000000100010000000000000000000000000000000000000000000001000000
000000000055500000000000000000000500000000140100000000000000000100003000000000000000400000000000000030000000003000000000003000000001003055500100300000500040010010001000
000000000000000000000000033305000000000033000000000000000000333000000000001000000000010000000010000000003000001000000000000333000000000000000005000000000013000000000000
000000000000000000000000000000600010300000000000000000000000000050000000000000000000000000000000000000000010000000000000000000000000010010000300000000010000000300006000
000000000000000000000000000033000300000300000300300000000000100000313300300000000003000000000000000300000001001300000000000000330300000000003003000000000000000003300000
000000000000000000000000000000000000001300000000000004430000000000000000000430000050200010000004030000000000031000000300000000000000000001000000000000000000000000000000
000000030000333333033333333300050603333333335312000000003310330100000001000000000000333331000000000000000010001000000003333333000000000000333333030300003333310000001300
