000000000000000000000000000000000000200000000000000000000330000000000000100000000000000001000001000000010300030003000000003000000200100000000500000000000000000000000300
300000000000000000000000000000000000010600000000000000000000000000000000000000006000001000103010000000000000060000000030000000500000000000000003000000000000000010000000
000000000000000000000000000000011001110000011003000000000000106003000000000030000000000005000000001111000000003011110000010500000000000011000000000000000000000000000000
000000000000000000000000000000000000000011001000000000060100000200303001000000000000203200000010000000000003000000300000010000000000000000002002000000000100300000003000
000000000000000000000000000000030000300000000000006000000000000000000000001000000000000001000000000050000030300003000000003000000000000000000000000000000000000000000010
000000000000000011100000000005001030100000000031000000000010003000000200000000001000000000000111000000000000000000000000011100000010000000001000000000000000003000011000
000000001000000000000000000000303333333103313033001000003333333330300301000005000000333300300000003303333010000003333333110000000000030063333033010010003000000000000000
000000000000000000000000000000000000000000000030000400000000004003000000000000001000010001000003000000000000000000000000000001000000060000000000600000000000000000000000
000000000000000000000000000000000000000000000000010000500000001000050000000030000000001000200000010000000300000000001000000001330000000000000000000000000130000050000000
000110011110001110000000000000000000001000000000000000000000000400000011100001111060000013000000001100000000000350300000110001000000000000003011000111000000000000010100
000000000000000000011200200000000002002000000000000100000000000300000000000010000000000003000000300000011000000000000000010010601000020020000000000000001101000033000000
000000000000000300000000000000000000000000000000300000000000000000100000000000000000000000000000000300000000000000000300300000000000000003000000000034000000000000010000
000000000000003100000000000200000004000002001100000000000000000000100000040000000000000000000040000000030000000000000003300000000000000000010030000010000010030000000001
333333333333333333333333300301000003333000001000001000100000000000000033000303333133030330301000003333330000001001000003330333000000033030033133333033333500000103330333
