000000000000000000000000000000000000000001000000100000000000000000001003000000040000000000000000000000000300000010000000000000000000003000001000000005000000000000000000
000010000000000000003000000003033000000003000003000001000003330000002000001033000000000000000000500313030000002000000030000000005000303011300000020001006000030000300000
000000000000000000000000000010000000000000333000000000000030000310303000000000200000000001000303000000000010103000000003000010000000300000000303030000000000500000000003
000000000000000000000000000000000000000000300010000000000000000300000000000010000000000000000000331000001000000000000000000000000000000000003001005000000000500000000400
000000000000000000000000000000000100000000010000000000500000000050200100000000000101100000100000000000000000000300000000000000100000000000000001000100400400000000000000
550550500000555000000000033000003005000000000000355055030010000001003300200000000000500000000000000030100000003300000030000055000001000000003000033000005500000000400000
000000000300000000000000000000000000000000300010300000000000000000000300000010000313030000500000010000000000000300000000030004000000000001000000303003000000000000003304
000000000000000000000000000000000000000000000000000300000000500000000000000000000000000000000000010000001000000000030000000000000000000000000000000000000000000001000000
030333000000533300000000002000000000000003035000000000000000100000000000000000000003001000000001303300100003000000000000000100330000000000200300030000000330100530000100
000000000000000000003330303000000000000000000200300100000000015000000000000000000000000100010000000000003000030000000000000000000000333030000000000000000000000000000000
000000000000000000003300000000000000000000000000305000000003000000001000000000001000000100000000010000033000000000000000100000003000000000000000000000000000000030000000
000000000000000000000000000000000010000000000000000000100100000000000400000000000000000000000000000100000000000000000000000000000000010000000000000000000000000000000000
000000000000000000000000003300000550000000000010000003301505055000333000000550000000030033005005050000000030005500001305505000000000000000030000000500000000000005005100
000000000000000003303000000300303000000000030030000000000000000000005000300000000000003001000000000030003003000000000000020000000330300000030000000000000000000000000000
