000000000000000000000000000000000000600300000000000000000000000000000000000000000000000300000000001000000000000103000000000030000000000000300000000000000000000000000001
100000000000000000000000000000000001006003400000000000000000000000000000000030000000000000010000000100000000000100000000300000000001300000000100100000000000000000000000
000000000000000000000000000003000040000300300000000023300100000000000000000000000300000000000000000000000000030000020000000330000000000000000300000000000000000000000000
000000000000000000000000000000000100000001301000010033010300000000000030030000300200060000000000000060000000330000000000003350000000020002000300000000300000010300001000
000000000000000000200000000000000000000000000000060133000300000000000000000001001060300000000000000000000000330300000000003000000003300062500300000000000000001000000010
000000000000000000000030050000000000003000000000003333000000130332000003005000006600030050120000000000000233330000000000033300200200000066000000000000003003005000300030
000000000000000000000000030000000000000000000000130303300333033000000000003000030133000030003333300000001333333000000003303130003031330000330300033000000000003000000000
000000000000000000000000000000000000000000000000100000000000000000000000000000000000003000000000000000000000000010000000000000000000000000000000000000000000001000000000
000000000000000000000000000000000000000000000000000001000000000600000000000001000000100000010000000000000000000100000000000000000000001000001000000000000000100000000000
000000000000000000330030000003000000000006010500000000000000000003030000000000000000000000000030000000000000000003000000000001000000000000000000001400033000000000001000
000000000002000003330030000003000000003001000000030000000000000000333000000000000000000000000000003040000000021003403000000000000000000000000000010000303000053000000000
000000000066000033300030000063000030006000000000000000000011000003330000003100100000000060003000000000200000060003000000000200000030000000000000000003310000066006001200
200200000066000333300030000003000000106000200000003015001000010033330320020000000000000000003000000000100000660033000000000000030150000000002000000330030000066030300000
333333330333333333330033303303330303030333033331300013000000000333033033333330010000060000003330300000000303303003300300000000003030000000005333330333313030333330000000
