300000000000000000000000000000000000000000000000030000000000061100000000000010300000011000300000003000000000001003003000010000000000000000000000001300000000000000000000
100000000000000000000000000000300000103000000011010000000000010000000000100000000100001000005000101000000000000010000020110000000011100000003000100100010000000000000100
110000000000000000000000000000000000000000000000410040000300000110100000000000000000000000303000301100000000000005200060000000030040100000000305000110000000000000000000
000000000000000000000000000000001005000000330050000050003303000000000000002000000060000000033000000000000000000100000660000000330000000000000300000000000030030000001000
020000000000000200000000000000000000200000040000062000000300000020300000000050200002000003001000000000000020000000000610000033050000000000000300003020000030000100200000
100000050000000000000000000000000000000000030000010000000000000100000030030300000000330300003000001030010000000000200660103030010000050003000300600100000030000000001000
000000000000000000000000000000000000010000033303300000003033033000300033333330000000130133330332331000000000000003003000330333333303000000003303030100000000033340000000
000000000100000000000000000000000000000000001000000000000000103000000000000000000000000000000000010003000000000000100000000000000000000000000100000000000000000000010000
000011000100000000000000000200000020000000001000030000000030000000001000000020030000000000000000004000000000000000030000000001103000000500000000000000000200030000030000
030000000000030000000000006600000600000000000030300000060005000000000000000160000033000000000010661000100000000001001000000500010000000000000000053000000600000000000003
330000000002033000000000006600000600101000000020333000000000030000000000000600000000000010000000600000000300000000000200001000003000000000000000000000006600000030000203
030000000000333000000000006600001660000000000003330300000000003300001000000060000000000000000003600000000000000000000100200000020000030030000000000300006000600000000030
030000033030303000000002006600600660000000330300030000005000100100000000200060300000000300000200605000000303003000060000000040100000030000000100000002006650000343003000
333303333333330003333333333333133330000000333131310030330000000000413333333030000000000000033001330000000000333300000003000000000000000000301000030333303303000003030033
