003000000000030000000000000000000000010000003003000000000030000000000000000000000001000000000000030000000000000000000305000000000000000000000030000000400000030000000000
300000000000000000000000000000000000400000600000002000005000000000000000000000000001100000000000000000000000300000000000000000000010000000000003000000000000000000000000
000000000000000000000000000003133330000000000003000010000100000000003000000000030010000000000000000000000003600003033303330000000000100000001000000013000001000003330000
050000000000300000000000000000000000000000050410000003000500000000003000000000000001000001000000300000030000000000000000000000000000000000003500400000000000000000000000
000000000000033002000000000000000000000030000000000000000000010000201330000000040200300000000000030000030000000000000000000000000003000000030006000030000030000001000000
000000500000400000000000044000000000000430000000500000000000000000000000000000000100300000000000400000000300100000000000001000000000000004400000005200000000000003000000
300000000000000033330000000033000000000000000000031003003000000000000000333300303300003003030000003430331033030003000000000030330033000000003033013033330000333000000133
000000000000000000000000000000000000000003001000000000000010000600010000000000000000000000001000000050000000000000100000000000610000000000330000000000000030000000000000
000000000000000000000000000000000000000300000000000010010000000000000000000000050000000000000000001050000000000000000020003010000000000000000000000000000000000000000030
003000033300000000000030333300005000000001603000000300000030000000001603032333030000300000203033330005300000000000000600000000003000000000000003003000000000000003000000
000000000000000000030000000000000000000010000000100000000000000000003000000000100000000000005000000000000030000005030000000000000000300000000000010000030003000000000033
000000000000000000030000000030020000000003001000000030000000000000013050000004006000000001000000000000000003010000000000002000000000000000000000000000030000000300000000
000000000000000000000000000000000000000040000000000010000033340030000100000000000000000000000000000000005006444000000110000500000003000503400000060000034000300000060540
033330000000333300333330000000330300030000000003300303010000000036000333003000000033010100333000003000000000000000000000030030033330000000000300010000000033000330000000
