000000000000000000000000003000000300010000000000000000000000000000000000005000000030000000000000000003000000300030000010000030000000000000000000000000000000000000004030
300000000000000000000000003030010000300000000000006000000000000300000000000000030133000000030000000000000010000000000000333000000004000000000000000000000030000000300030
000000000000000000555000000001000000000000000055500000300010000030000000005550000000000055000410000000000000000000030000000003333333000315550000000003000000060000000000
000000000000000000000002000000000003333030000000000010000001300000000000000000000000000000000300000000003330303000000000600000000000000000003001060000000100000000020100
000000055550000000003333333000030000000000000000300106000000030555033000000000030000000000300000005556000000000055550000000000000000000000030000000555500000000003333030
300003333333000000000000000000000000000010000000050000530000033330030000000000000000000000130000333033000000000033333000000003006010000000000000000301330000000330000030
000000000000000000000000000000330300003000000300000000030000000000060000000003000030000030000000000000000000000000000000300000000000000000300000000000000000001000000000
000000000000000000000000000000000000500300000000000000500000000000003000003000000000000000000000000000030000000000000100000000000033000000000000030000000000000001000000
030000000000000033333300000000333300030100000000000000000300000100001030000000000040100003000333330000030300000003000100000000000003100000003000000000000000000000030330
000000033333300000000000000000000003303330000000000000000000000000000000000003333010303330000000000000100000000000000000000000000000000100000000040300303000000550000000
333303000000000000000000000000000000000000000000000200003003020102000000000000106000000000001000050020000000000033300301000000000000000000000300000000000000000000003310
000000000000000000000000000000000300000000555500003333310600300301303000000000000000000000000000000330300002000000000011000000333333000000000000000004030000000000000000
000000000000000000000000000050000000000000203300000000000000000200000000000000000000304000000000000000000000000000003003000030000100000000034000000003000000000100000000
000000000000003000000003333330006000000000000000000000000000000003000103334000000000000000330000000000000003303306000005000000000000100333030033333000300000000003000300
