000000000000000000000000000000000000110003000100000000000000030000000000000001000100000001000000000030000000000004010000300000000000000000001000000000003000000010000000
000000000000000000000000000000000000000013000005000000000000003000000160000000000000000000000000000100001000000000000000000000010000000000000003000000000000000010000000
000000000000000000000000000010010000030033010000000000030033003000000000110000002000000000000000000031040000000000000000005005000003000000000010300003303300000000000000
000000000000000000000000000000000000330003000000000000000033013303000001000000000000000010000000000003000000000000000000000000000000000000001000030033303300000000000000
000000000000000000000000000000000013333003100000000000003303003000000000000100000010000000000000000003000000000000000000000000000000000000000000003133300303000000000000
000000000000000011000000000322000000333003000000000000000333003001100000000030020020030000300110002200000000000000000030022000000300002000000030023003300020000000000000
000000000000000000000000003303000003303030000000000000003333330000000040333005003333000003300000033330333000000000000001300303000000133333033333303333333030333300000000
000000000000000000000000003300000000000000000000000000060030000400000000000000050000003030300000000000000000103300000000000010000000000000330000000000000000000000000000
000000000000000000000000000301000001000000000500000001000000000000000000000000000100003000000000000000000100000310000000003000000000000001030000000000000000000000000000
000004000020000011000003303300020000100000001100000000300000300001000000000000003000000200000110000000000003300300010000000000000000005000030100001000000000000000002000
000000000000000000000033303300000000000000000000000303001000000000000010000000000100000000100010000002000036003300013060000000000000001330330000100000000300000010000000
000000000000000000003333300300000001200030000300103000000000000100000000000000001000000000000000233000000330100300100033000000000030033330030000000000000000000000000004
220000000220200000023033300300020200001003000002000110000000000000000322000010000030002202300000230000000033300303010200000000001100003330033000003000000000010000022020
333333333333333333333333333333333030000000333133300000000000000100003333333330000000330333331103300000000313333001303330000000010000033330330000033030010010000013003103
