000000000000000000000000000003000000030003003000000500060000000000310001000000000003000000000000000000000000000300000010000000000000000000000000000000000000000000000003
000000000000000000000000000000000000000000006010000000000000000000010000600303003000010000000000000000000000003300000000000010000000000000000000000300000000000000000030
000000000000000000000000000000000000000000000000000000100000000000000000000330001000000000000000000000000010003300000000000000300000000000000000000330000001000006000233
000000000000000000000000000000000100030010000000000000000000000010003000003030000000000000000000110030100000003300300000000000000000000000000000000005000000100000010330
000000000000000000000000000061000000000000000000000000000000000006000000030300000000600400000000000000000000333360000000001040000000000000000000000010003000000000015333
000000000000000000000000000000000000000000000000000012010000300020000000033330000000660003000000030000003000333300000004000000000000000000000000002000000000000000003033
000000000000000000000000000000000500010000000000030330300000000000030013333330000000333033300001000000100300033313100000000000000000100000003333330033333000005003333030
000000000000000000003000000000000030000003000050000000000003000000300000000000000000030000010000000400010000000000000000000030000010000010000000000000030000000000000000
000000000000000000033300000000000000000033000000000001003000000300006000000000000000000000000000000000000000000000000001000003000000200400000000100000000600000000000000
000000000000000000033300000000000000000003000000000000003010000000000001000000303100300000000000000000000000000000000000000033000000030000000000000000000000000000000000
020000000000000000333000003000000300000300000010000000000000030000200000000000000000000303000000000030000005100002000000000303000000000000300000000001000000400001100000
660000000000000003333000003000000300003030660000010000000000010000000000000000000000000003100000000000000000000060000000003332300000000000300000000000000000000001600000
660000000022020033333300003060000000030333660000000000003005030000220106003000000000300003000000000002202000000016000300003303000220000400300100000006000000000006000000
333333333333333333333333333300331334333333033333010000013330030333333333003330030000000331000000003333333000000010333330033300033333063313330000000000000000300004310033
