000000000000000000000000000000000000000000300000000002000100000500000030000000000000100000000000000000002000000000000030030000006000000000000000000000000300000001006000
000000000000000000000000000000000000000060000000000030020000300000000000000300000000000000000000000000005000000000000000000040000100100030001000000000000003000000000000
000000000000000000000000000000000000006000000300020000000030000004000304004601000000000000000010000044400000000000300000000000300000004040400000000044440000000000040001
000000000000000000000000000000010000000000000000000000000000000000000000000000000300010000000000000010000000000000000000000000000000000030000003000000000000000000000000
000000000000000000000000000000000003000020000000041000000000000000000000000000000000000000000000000000000000000000000030000000000000000000000000000030000100000000000000
011000044444000000000000000000000000000000011010100003000000200001000000100000500000000000000001000000000434041500003020000000000000000000001000202000000000030000006000
000000000000000000000000000000000303333330000000000000000033300333313003333330000000011003000000003313330100000003300030000000000600010003300303003331300300030000233333
000000000000000000000000000000000000000000000000000000000000000000000000000000000000001000000000000000000000000000000000300000100000000000000000003000000000000000000000
000000000000000000000000000000000300300000000000000000000000000100000000000000000100000000040003000000000000000000000000000000000100500000000000000000000000003002000000
044000104444400000000000000000000000444410010000000000010000020000000300000000001000000000000003000400001000000000000000440001000000000000000000000000000000000000000000
000000000000000000000000000000000060000000000000000000000000000003000000000000000310000000000000000000000000000000000000000000001000000005000000000000000000000010000010
000000000000000000000000000000060000030000000300000000000000000000000100000000010050000020000001003000000000000000300000003000000000004000000000000000300000000000000000
000000000000000000000000020205444000000000000000205000000000000003000001100604404403000030210000000000030011000030000010000000011000044414000030000440040000000000100000
333333333333333333330033333300030003030003013333013333330000000033330000000000000000030033300000003033333000050633331000333003000000300000000000003000000003331300000000
