000000000000000000000000000030000000003000000000000000003000000000000000020000300000000000000000300000033000000000000000003000000000000000000000000000000000000000000000
000000000000000000000000000000000000000000001060000000000000000000000060001010000000400000000000000000100001000000000010000001000000000000000000000500000000001600011100
000000000000000000000000000002100000000300030000100600030200000600000043000300000441000004100000300100000110000000000010000441000000000010001000001000000000000600000000
000000000000000000000000000006000000001000000000000000000600000300030000000000000001000000000000000000000000000100000000000000001000000000000000000000000000000100000000
000000000000000000000000000066060000000000000000000000006000000000000000000006000000000000000000001000010000000000100003030000300000000000000000000000000000001000000000
000000000000000000000000000066500000000000200000000000006000000000300000000002000100500000050212000000000000000000030003000300000000012012002000050000000000000000221000
000000000000000000000000000033000000000004033333313103003330000000030000000003303303333533330033330000003330330000000003333333000200033343031333034000000000000000333033
000000000000000000000000000000000100000000030000000100000000000000000000005000000000000000000000000001000000001000060060000000000000000000000030000003040000000400000000
000000000000000000000000000000000000000300000000500000000000033010000000000000030000000000000000000000000000000000000000000000000000300000000010000000000000001300001000
000000000004411100000020000000100000000000030000000100000400000000000000000001100000020500000000000060000000000011000001430000000000000000000300001000013000000001101000
000000000000000000000660000001300000000000000100000000000000010000000000000000000000010000000000000000000000000000000000000030001000006000003000000060000060000000000003
000000000000000000000660000000000000030300000001000000000000005000000000000000000000660006000000000000000000035000340000000000000000006000000000000661000000000000000000
522120020000000000000660000012212000003000000000000000000000000522000000000030000300060000000000000000000000000000000000000100000000016003000003000660000000040000000000
333333333333333333300333000003033030000300000000000000010030000330313330030003306300003000000000000000000000000033303000030003000000030000000000000333000003000003330300
