000000000000000000000000000001000300000060000000000000300000000000000000000000003000000000100000000000000030100000000000000000000000000000000000001000000000030105000000
000000000000000000000000000000000000000000000000000100000000000000000000000000000003000313000000000000000000060001000000100000000033100006000010000000000000000000000000
000000000000000000000000000000000000000000000300000010000000000001000031000000000000000300000000000000000000000000000000000004000000005300000305000000000000500000001000
000000000000000000000000000000000106000000000300000000600000000000000310000000000000000000003000061000300000000001003000000002000300010000030100000000000010001500010000
200000000000000000000000000000000002000000000000000000100050000000000000000000000000000000000001002300030000000020002000000000106600000010000066000200000004000000000000
111110000000000000000000000000000001111130206000000000000000010000010100000000000003000010000000001011000000200001011000001001006600000000000000300111100000000000002000
000000000000000000000000000000000000010000333333300000020000000333333300000003333303000000000000000003100313303301000000000030330303300000003033333600000033363330330333
000000000000000000000000000000000000000300000000000001003000000001000000000000000000000000030000000000000000400000000000010000000003000000000000000000100000000000000000
000000000000000000000000000000000000000000000000001002000000000000000000000010000000000000000000000000000030000300000000000000010000000000000000000000000003000000000300
000000000020000050000000000000000000000000010000000000000000000000010060020001000000050000000500000100000000200000000000030000001003300000060000000000000000000000000000
000000000030000000000000000000000000000000000000000000000000000000000000030000000000000000000000000000000000300000000000000000000000000000000300000000000003000004004000
000000000660000000000000000000000000000000023003003000102000000000000000060000000000000000000000000100000006000003000000000000000100000000000000000000000040000000000000
000200000660000000000000000300000000000063000030000020001111005000200000660000000000000000000000000000003000600000000000602003000300000000030000000001000000000000500003
333333333333333333333333333310000103030330333330333330300000000333030363333300000000000010033333333333330031033303333033333331100000033033000000001100000000000000303333
