000030000000000000000000000000000003300000000000000000000000000000000000000000006000000000000000200000000000030000010000001000000000000000003000101003000000003000000000
000003000000000000000000000000030500010020000000000010500000000000000003000000001000000000000100000000000000003000600000003000005600000000000000004000100000000300100006
000000000000000000000000000000300300003000000000002000000000000000003300010000000000000000000000000000000000000000000000103000000000003000000000000000003000000000000000
000000000000000000000000000010000000033000000003033003000000000100033300000000000000000015230000003300000000000036000000000002000010030300000003000000033300000000000000
000000000000000000000000000001000660333330000000030000300030351000000303000000000066000006600000003000000001000030000000000060000000000000000333333000030300000000000066
000030000003300000000000000000000063311010060033030000000000000000300304003300000066000006300003343000000000030000000000000000000000000000103033000000333330003000000066
000000000000000000000000000033303033030000000000000333330000000033033300000003633333330300300000000033000000000000330333333333000000000000000003000033303300000000333330
330000000000000000000000000000003000000100000100010000000000000000031300010003000010000010033005003000000000000000010000000000300030000000300000500000060000000000000000
000000000000000000000000000000000300000000000600000000000000000000003000000000005000000000000000000000000102000300000000000000000003003000000000000000100030000000031000
000300000000333000000000000000000100400033000000000000053000000000000000000000003000000000000000000030003000000000000330003000100000000000003000003000003000000050000000
003300000003333300000000000200000000050331000000000000003000000010003000000000033000000000000030000000233000000000003330030000100000030003000300000000000000000000000000
333333000003033000000000006600030200000303010000000031030050000000000000000003333330030000033303000010303000101001003133333330000000000000053000200000000300000000100000
333300000033333000000000006640303000000333000000000010000000000000000000060001333000300000503300000003331000000000000333310000000030030003303000000030000000003000000003
333300003333330033333333333300000000303031000000000000006033030000000000130003330000000060033300000333333000000003033333333000000000000300000033333000030000100000000003
