003000000000000000000000000300000000300000013000000000030000000100000600630000000040000000300000000000000000000000000000000100000000000000000000003000000000001000300000
000000000000000000000000000000030030000000030000300000000000000000000000000000000000000000000000000000000000050010000004000110000000100000030000000000000000001100000000
000000000000000000000000000000000000000000001000000030000300000000000000000000003000000000001000000000000000000100000000000000030000000000000500000000000000000001300000
000000000000000000000000000000000000500000000003000000000000000000000010003000000001010000000000500000000000003300000000000000000000000000000000000003000000300000000030
000000000000000000000000000000000000000000005010000000000000003000000003000000000003000000030000000000000000000000000300000000000000300000000000000000000500000000300000
000000000000000000000000034000030000000000000000000003400000000000030000500000003000500030000000000010006000000060000000000000000000003031000000340003000000000000001000
300000000000000000000000000000003200001003300000001000000000003000012000033330000000000000000033033000300330330000000000333333001106000001000000000001330003333330000003
000000000001000000000000000000020300000100000003110000000000100000000000000000050010000000000001000600000100000000503010000000003030100001060000000000000000000000030100
000000000001100000500000000001005000100100000003001000000000000000050010000000000000600000000001500000000000000020040010003000000000000310001000500000000200000001000000
000000000000000000000030000000000001000000000001300000000000000000000030000000000000030000000000000000000000000100000030000000301000000003000000000000000000000050000000
000000000000000000033000000000000330000600000000000000000000050000003300000000000000000000000000000010001300000000000000000000200000003000330000003000000000000000000001
000000000000000000000000000000003000000000000000000000000000000000000303053000001300003000000300000000000100300000201000000000000040000000000000000000000000000000000000
000000000000000000000000000000100000000000000000000000000000000000000000000000000000000000000000000010000000000000000030000340000000000000100100000000000000000000000000
003333303333333333300000000303300000301300000001000000000333333333300030000000001100000003300330331000000000000030000000000000003330303330003333004000000010000003000000
