000000000000000000000000000000000060000000000000000330040000000100000000000000000000000000000000000000000000000400000300100000000000001300000000000000000000500000000000
000000000000000000000000000000000000000000000000020330010000000000003000000000000050000000000000000000000020000200100000500000000600020330000000000060000000100050000000
000000000000000000000000000000000000010003000006600300000300000000000300000000000061000000000000000000010000016600030001000000000000000300000000103000000100000000010010
000000000000000000000000000000000000000000000000003330300000000000000300000000000000000000000010060100000000006601000020060000000000003330000030000000063300000000000000
000000000000000000000000000002000000000300001006603330100030000000066600000000000066000003000000000030000000006600001000010000000000003330000000000300066600001300000000
000000000000000000000000000000004000000000022006603330000000000000000000000000220066000001000000000000000020006610100000000000100000000330000000000000063000000000000000
000000000000000000000000000000000000000000303333340030330100000033333300000003003333000000000000000000000030333300000000000000001000000330030000000331333303033330010000
003300000000000000000000000000000000000000000033000000000000300003300000000010000000050000000000000000000003300000000000005100000000000000000030000000000030000000000000
203300000000020010000000000000030000016000003000010000000010000200300000100000000000001000000001000000001200300130000000000002041000000000002034000000030200000000000000
003000000000660000000000000300030000000000000000000000000000000000000600000000100000000000000000030000000003000600000000006166000000303000002030000000006600000000000000
033300000000660000000000003300000001000030000000310000000000000035300010000030003003000013010000300010000033300000000000000060000003300100000003000000006600000000000001
033300000000660000000000066603003000000400000036600000000000000030300000300000000000000000500006660000000333300050010000000066000066603000000330000000006000000000100000
033300002200660000000000066600000000000000000066600000010000000033304000000000000003000000000306600000000003300000300000220066003066600000060033000020006000000000000001
003333333333333333333333333300001003360330330333300000000333333000330300000000100000030300333303300000000003333330340030333333301303300000000013303333333300000000000003
