000000000000000000000000000000000010000000000001000000010000000000000000003000000000300000000001100000000000003000050000000000000000030000100000001000000030000000000000
100000000000000000000000000000100000000000010000010000000000000000000601000000000000020000000500000000000000000004000011000000000000010010030000000100000002000030000000
110000000000000000000000000000000000000303003000011000000000000210000000000000001303330036003300000000000000000000050001100000000030030000000000000010000013330000003000
000000000000000000000000000000002000001100000020030000000100000000000000002300000000030000000002300000000000020000033010000000001610000000000000300000000003000000000000
000000000000000000000000000001066000006630000600000030000000000000003000066000006000000000000066001000030000060000166000000000300660033000000000000000000003000000006030
000000000000000000000000000020066000306601010060000000000300000002000001066100000000010000000016000000000200660000060000000000330600133300000000000000001030000001005600
000000000000005000000200000030333333333001001033001300305000003000000000303330303300333333300033032000000333333033333300000000303030030333335300000500000033330030303303
000000000000000000000300000030000000003000000000300000000000000003000003060000000000000000000100000000003000000000000001000000000000000000000000010000000300000003000000
000000000000000000000020000002001000000000100000000000000000001030000000000000200000000000100000000000000100300000003000000000000000000000000010001000000000000100000000
000000000000000000300330000030000100000300000000000003000000000000000000000003060000000010011001000000300300002000001030000000010000000000000000000000630000000000010000
000020000002000006300030000003100000000000000000000000000000200000010000000000300000100100002000033016300000000000000000000000000020000000000000000000630000002000000000
000660000066000006600330000033000000000000000000000000000000600000000000003003300000000000000000000006600000000005000001000000000660000000000000000000660000006000000000
200660000066000306600330000036000001000300000000000000002006600000000000000003300000000000000000000106600000000000000000000000000600000000000000000030000000064000000000
333333300333333333300333333330333302010000000000050000000303330000000020000003300333500000000000003333110000000023000000000000000013050010010000000333303000633031000000
