000000000000000300000000000003100000000000000000000000000000000006000003000000010030000000000000001000000000000000000000000000000000000001001000000030000000000000000000
000000000000000000000000000000000000000005100000000000100200050000000000000000000001006000000000000100000020006000000000000000000000000000501000000000000005000001300000
000000000000000000000000000000000000000000500000000300036000140000000001010000000000000100011111000000000660114100000000000000101100000000003110100000000000101000000030
000000000000000000000000000000000000000000100500000000006600000000000000300000000000000000000600000030010660000040000100005000000003000000000300030000000000000100000000
000000000000000000000000000000000300000000300000003100006600000000300000000000000000000010000000030000300600000000300000000300000000000001000000000000000000000500000000
000000000000000000001411110000000010000000411600000500006600000000030000000001000000000000000000000000000660000000000000000001000000041115000000000401110000000000000000
000000000000000000000000000000000000000002000000030000006330303400000003343130000000330303330033303000000300333000000003000000111333000000000033033000033000000003000000
000000000000000000000000000000000000000000300000000000003000000030000000000000300000000100003000000000000000100000300000001000001000300000000003000003000000040000300000
000000000000000200050000000000010000000000000005000000000003000000000020000000000000010000000000000000000000000000000000000000000010100000500000000020005100000000000000
331100000000006601141111110000000003311000060110101111030000000000030000000003311000000000110000000000000000000000001000300000000000066001413311000660010100010000000000
000000000000006600000000000000000000000300160000000000000000000000000000000110000000000000000000000000000500000000000000000000000000066000004003030000000001000003000001
000000000003006600000000000000000000000030660000000000000000000000000000000000000000001000000400000000000000033000000000000000000000066000000000000660000000001000006003
000000000000006600000000000000000000000000360030000000000004000000000110000000000000411110000000010000000300000000000010000000000000060000000000000663010000000000000011
333333330000003333333333333302000060332032003333330330031000000000000000000003333033000000000001000000000100000000000003333333001000033333303333333030333300000000000000
