000000000000000000000000000000005000030000000000000010000000000000000000000000050000000000000000000000600000010000000000010000000000050000000000000000000000003000000101
000000000000000000000000000000000500000000000300010100000000000000000000000010030000000000000000010000000000100000003005000000000000000110000000000000300000000300000000
000000000000000000000000000000000000000000100000000000000300000000000000060000000000000000010000000000000000000000000000000000000001000000000000030400000000000000000000
000000000000000000000000000000000000000300000010000000000000100000000000000000000000000000003020000300000000000000000000000000060000000020000000000300030000000000002000
550000000000000000000000000000000000000600000100055000000000000000000055000000000000000000040160000000000000000001000000000000000000000660005100000000000000000000016000
000000000000000000000000000031000000000000000000000000000050000000000000306000000100300000000600200100000000000000000000000031200001000660200000000000000000000000066020
000000000000000000000000000003305333000000000000200001000333333000000000000000000000030000003333330300010033333310000000000000300330003033330000000000000010000003333333
000000000000000000000000000000000001000000000000000003000030000000000000000000001000000000000000000000000000000030001000130000600000000000000010000000000000000000000000
000000000000000000000000000000000000000000000000000000000000000000000010000000000100000000000000000000000300000000000000000000000000000000000000000000030000000000100000
000000000000000000000000000000500000000300000000001000000000010000000000000300000003000010000000000000000000000400100000100000000000000000500000000000000006001000000000
000000000000000000000000200000020000011061000000500000000000000000006103000000000000000001000000100000300000003000000000003000000000000000003000000000020000000000000000
000000000000000000000006600003660000000000000100060000000000000000000000660000000001000000005000000010000000000000000103005000000000005030100300000003000100000010103000
000000020000000000020006602000000200000000000002000000000000000000000000660200000000000000000000000000000300003000000030000020001000000000000000000000002020000000000000
333333333333333333333333333333031303333133333003100003003033303333333003003330000000333330300000000000000330330300000003303333313303000000003333032033303301333333000000
