000000000000000000000000000000000000000000000000000000000000000000100000000000000000000000000000005000000032000000000000000000000000000000000100050000000010000000000000
000000000000000000000000000000001003000050000000000000000000003000000000003000050355000000051005000000000000555500525055550001000000000003500000000600530000000000000000
000000000000000000000000000000000030000000000000000000000010000020000000000000030000000000000000000000000000000000000000000000300000000000010000000000010000010000000000
000000000000000000000000000000006330000000000000000000000000010000003000003030000000000000000000500001000000000000000000000000030000000000000000000000000000000000000000
000000000000000000000000000003000300000000000000000000000000000000000300000000000000000000000000000000000000300000000000000000000000000000100001030000100000000000030000
000000000000000000000000003000000330000000000000000000000000000000000300003030000000000020100000000000000000000000000000000000001100030100300300060000000006000000000100
205000000000000000000000000033000333303030333000000000000302010300003333300331333333333000333333300500000030333333333330303333000030000000000000001033311306000000000000
000000000000000000000000000040000000000300000000000000300000000005011000001000300300031000000000000001000000000000000000000000000000000000100010300000000000000000000000
000000000555555055500000000000010005055500000001000000000005500000500000000000600000000000000000000000013000000000100000000000000000500500000000000005555500000000300000
000000000000000000000000000000000000030010000000000000000000000001000000000500001000000000000000000000000100000000000000000000000000010000000000000100000000030000000030
000000000000000000000000003300000000000000000000000003000000000000000000000000000100000001001000330000000000000000000000000003100003300000000000130000000000001000000001
000000000000000000000000003300000000000000000000000000000000000000000000000000000000000000000600600000010000001010000000000000300003300000400000033000000013001000000000
000000000000000000000000003300000000000053000303000000000000000001000000000000000000000003000000330000000000000000030000000000000003300000000000033000000016000000000000
333003333333333333333330003300000003333330000000020530003333133000000020500000000000000000033000330300000600000033300300000000330003320500653300033333333300000000000030
