000000000000000000000000000030006030000000000001000001000000200000000000100000000000000000000000000000000000000000000000030000000000000000000000000000000000000005000000
000000000000000000000000000000100000010000000000000000005000000000000000000000000000600001003000000010003000000000000000330000000000000000000000000000100300000000000001
000000000000000000000000000000000000111130020000001000005000030000000030000010000300000000000000000100000311110000000000100000010000000000000003301010110000000600000300
000000000000000000000000000000060000000000560000001000000000100000000000000100000000300000000000000000003000000000000000000000003000000000006605000000000000000000000000
000000000000000000000000000000000000000200663000020100000000000000000060000000000000000000000000000000000000000000000000000000000000000000006600000000000003000000300000
000000000000000000011414100000100000000000660000000000000000000000301066000000000000414603000000300000000000000000000110000000000000000002006600000000000000060004041000
000000000000000000000000000000000000303300033313463031030000000000000103303333330333000310000300003303010030300300000000333000003000003000000303303033330003300330000000
000000000000000000000000000000020000000000000000000300000000600000000000030300040006000010000000000000000000500000010000000010002000001060000000000000000000000000000300
000000000000000000000000000000103000000000000060005000000000000000000000000010000130000000000000100000000000000000000000000001000000000000000000030100000000000000000000
010000000000000200001011110005000000000000000010000000000000300000000300111000100000005000000000010000000000000000110000000010000001012000010100100001000000000000000000
000000000000006600000000000000000000000000000000000000000000000000000000000003000000000000006300000000000000000000100303000300000000006000000000000000000000000000000010
000000000000006600000000000000000000002001000000003000000000000000001000000000000000010000006000000000000000000000000003000000000000066000000000000000003000000000300000
000000000000006600000000000000000110000003000000041410000000001414100310000200030100000031066000000000011010001000001000000000410100031000000000000000000600010000000000
333333333300333333333033330003000000000000633000000000000210000000000003033000333300000000033330330000000333003003130000000000000000035333230033030000000000000000000003
