000000000000000000000000000000000001000000000000000000000000000000000000000000000000000000000000000000000000000010000000000000000000000000000000000000000003000000010000
000000000000000000000000000000000000302000000000000000000000001020000000000000000003000000000000000000000050200001000300000000000000000030000300002000000000020000000000
000000000000000000000000000000100000036001000000000011110000000110000000000000000000100000000000000000006006610000000000101000000000000000000000000000101100660000000000
000000000000000000000000000000000000066000000060060000000000000111002000000301000600000010050000000000030006600000000001100010400000000001100000000000000000065000100000
000000000000000000000000000000000000060003000000000000000000000000000001000000000000000000000000000000000006001000010000000000000000000300000000000000000000660000000000
000000000000111100000000000011000000016000000000000000000003003010000003000060000011100000000000003000000000500000000010003030000000000000000000001000030000300000101000
000000000000000000000000000000010000333333000000033333330000000333333303333003003000000500000303000000000333033300300003300330010000000004000010000031331330333000000001
000000000000000000000000000000000000500000000000000003000010000000000000000000000030000000000000003000000000000000000000000000030000001330000000000000000040100000000000
000000000000000200000000200010000300000000000006000000000000000000000000013510002000003000002000000000003000000001000000000000000200000000000000003000000002000000000030
000111100100001100000006600011000000000000001000000300000010000300111100000000660000006000003000100001000300101000010000003010000600000011110000000000000011000000010000
000000000000001100020006600001000000030030000000300000001000000000000000000000066000000000010000260005000000000000000000000000000100000000000000000000004001000200000003
000000000000000100000006600010000000000000003030000000000000000001000000000001066000000000001000000000000000030000000000000000006600000000000000010001000001001000000000
000000000000000100000006600001000000000011000000000000001100000000000000000000306000000031101030000000000000000000010110000000006600000000000500200001000006000000030000
333333333333003333333333333333303333000000333030000300000600050333333000000000033330300000033330330000000333033300000013330000033333333333330000000000000400333030331300
