000000000000000000000000000000000000000000001005000000000000033000000010000000000500000001303000000000000000000000000000000000000000003000000000005100005300030000003000
000000000000000000000000000000000400000000000000000000000000033000000000000000000000000003300000003030000100000003010000000000000000000010001000000000003300000030000100
000000000000000000000000000000006000001000000000100000000000003000303006500000000000000003300000006000000000000000000000000000000000000000000001001000003300000000001000
000000000000000000000000000000000020200000000000000000000003033000000100000000000000000033300000000000000000000003000300005100000010000000000010000300333300000000000000
000000000000000000000000000000000006600000001000000030000003333000000000000000000000000333300000003000000660000000000000000000100000000200010000000000030301001000006003
000000000000000000000000000000000006600000300000000000000060333000221200000000000000003003300000013000002600200000000010000000000100330001000010000003330350030021000000
000000000000000000000000000000300010330033000000060000003303033333303000000000000003333333300000003333333133331300000010000000000000000000100000000300330333433330000000
000000000000000000033000000000500330003000000000000001000000000030000000000000000000000030010000000000000000010010000000000000000000001000000000010000000000000000000000
000000000000000000033303000000000333030000000000000001013030000000600000000000030000000000000000000000000000000010000000000033303000100000000000300000000030300001000000
000000000000000000033300000000000330000000000000000000000000000000000000000000000000000000000000000000000000000500000000000033000000100000000000030000000030000000000000
020000000000000003333300000000030330000000000000000000003000000020000000000000105000000000000000000000030000000002000000003331300000000001001220000000000033000000000000
660000000000000003333300000000033003000100300000000000003000000660000005000001000000500000000000050003000000000066000000003333400000000100606010000000000030000000005000
660000000022020033333000000000003330000000000020200300000000000000000530000000000000000000000022010000100000000060000000033333000000000022026600000300000000003000000000
333333333333333333333333333303333300033033030330200000003333033330030300000060010000000030000003330000000000000033033033330333033303333333000333331000000030033330000005
