000000000030000000030000000300030000050010000000000100000010000000000300003010000030000000000000000000000000340000100000003000100003000000000000003100000000010000000100
000000000033303033303000003000033303003303000000000000000000000300003000000010033303000000000000003003000000033000000001000300331330100000000000030003000000000000000000
000000000000000000000000000000000000000030500013300000000000050000000000000000000000000003000000000000000000300000000000000000000000010000000000000003000000000000000000
000000000000000000000000000000000000000300000030330000040000006003000000000000000000000000000000000000000000000000003010000000000000003310000000001000000000000000000010
000000000000000000000000000000000000010000300000110003000010000000000000002300000030330015004000100000030000010000000000003000000000000000300000030000000000000000000000
000000000000000000001110000000000000000006000000000000000000000000000600000030000001000000000000000000100001000000000000010000000000100030001100000006000001000000000000
000000000000000000000000000000000030101000000300003050300040006000000033003000000000000000033333303300300000000000100313303330000000000000000000000000000500000330303303
000000000000000000000000000000000000000000000000000000000000006000200001030100000000000010300060300005000000000050000030001000300600010000000000000000003000000002000000
000000000000000000000000000000030300000000000000000000000000000000300000000300050000000003000333000000500000000000000300001000000600000033000000000303330000000000003330
000000000000000000033000000000101000000300301000000000000000003000301000000005000033000000000001000000000000100000000000003000000003000000000000011000300030000231000000
000000000000000000000000000000000000000000000000000000000000000000003000000000000000000000000001000000000030000000000000000000000000000000000000400000300300000300000000
000000000002333300000000000000000000010000000000000000330000000000000000000003300000000000000000010000003000010000000000030233030000010000000010230000000633000000000000
000000000000000000000000000001000000004000000000000000000000000111000120000000000000100000000100010000000000000010000000000030000000300000000000100000000100000000300000
333333333003000003000000003330003000010000000000033003100000030030333300000000003000000000000000000010330000000000003003300000000300000000003300300060000000030000000000
