000000000000000000000000000000003030000000000000000000000000330000000101000000000000000003330000000100100000000100030000000000300000003000001000000000000033000053000110
000000000000000000000000000010000000000000000000001000000030000030000000000000000510000000000000000000000040000000000000000000000000003055000000060000000000000200000000
000000000000000000000000000000030003000000000001000000003003010000000000000000000000100340030000040000000000000000000000000000303000000000000000000000005010000003000000
000000000000000000000000000000030000000000000000000000000000004001300600030000000010002000410000006000000000000000000000000000000000000000000000100000010000000000000000
000000000000002000000000000000000000000003000001000000011000000200000000000003000000006000100000000000000200000000000002000000000000330000000000000050000000000000000000
000000000000000000000000000000001000000000000600000000010000000000000000000000000000000000003000000000000000000000000000000000000000100000000000000000000303600000000000
050000000000000000005550000033333300000000000030050000010330033000000505000001030000033033000000000003000000000005000001000006000000003300005300006000000033303330000003
300000000000000000333330000000000000300000330000000000000030000033010030301000000103000003000000000003000305000005000000101000330001000003300000000300030000000000000333
000000000055000000000000002000100100045000050002000000000010010000002000000000000000003100000000000005500000103000000001000000030002000000001000000000550000001000000000
300000000000003003000000000000000030000000013000300000003000000000060000000000000010000300000001000000000100000000000000000000010000000630000000000000000000000003003000
000000000000000020004000000000000000000000000000010000000000000000000000300000000000000000300000505000000000000000300300000000000000000200040000000000000000000000020003
000000330000000000000000000000030003000000000000020100000000000000000000000002600000000000000000036000000000000000000000000000000000000000002000000300000000000320000000
000000000000000000000000000000000000003003000000000001000000000000100000000000000010500000010000000000000000060000000000000000000060000100040003001010002000000000300000
000000003300003333333333333305000000330000333330300000050000000330033330001033500000500000005000003330000333333300000000500003033003030333330000005033000015000010333333
