000000000000000000000000000000000000013000000030000000000000003000000200000000600000000000000005000000000030000300000200000000000000300000000000000000000000000000000000
000000000000000000000000000000100000000000000000100000000000030000000000000000000100000030000000060000000000003330000000000000000000300000000000000000000000000000000000
000000000000000000000000000001000000000000000000030000000000323010000000000033000000000030030000000003200000013300000000000000300030300300000000300000000000030000000000
000000000000000000000000000000000000000003000000033000020300030100000300300000000003000000033000020500000000333300001030000000000303000603000000000000000300000000000000
000000000000000000000000000000000000000033000000003000000033333000000000000000600000000100030000000000000000310300000030000000003343000000000000000030400320004000000000
000000000000000000000000000030000000030033000000433000010333333000000001001000200003300000033000030000000033333302000330000000033031330000003000000020300300000000000000
000000000000000000000000000033033333333003002000001303033330303000000000002003003003303333333333030000000330330303303300000000330003333003333003333333330300000100000000
000000000000000000000000000300000000000000000000000000230000000000000000000000000000000005000000000000100000106000000000000000100000000000001000000000000000100000000003
000000000000000000000000003300000000000000000000000050030000000000000030003000000000000000030000001010000000000000000003000000000000000033000000000003000000000000000033
300000000000000000000000033300000000000000000000000003333000000000000000000600040000010000000000600000300100000010000000000000300000000000003000000000000000000000000333
330000200000030000000000333300060003100003000000010033033300002200000000000000000000000000000001000300003000100000100350050000300000200300003300002006000060001000000330
330000000000330000000003333303030000000000000000000333033300000000000000001000000000000000050000000100033000000030000001000001330200000000503300000003000001000000033333
330000302000333000000033333300000000050000000000003303303300000300000060000006000001000000000000003000003000000002000000000500030000300001003000003000000000000000333033
333333333333333333333333333300000000300000000000033330033033303333533300000000000000000000000001000033333000000000000000000000330333300300000030330060000000000003333333
