000000000000000000000000000000000000000000000000000000000001000000000000101000301000000000000000000000000100103000000000000000000030000000000001301000006100000000000000
000000000000000000000000000000000000000000003000000000000000000000000000000000100000003000001000000003000000000000000000000000000000500001000000000000000000000000000000
000000000003000000000000000000000300100300000000000000000011000000000140000006000000000300000000004000000000000000000000000000006000040000000000000000030000000000000000
000000002000200000000000000000000000200020000004000000000000020000000000300030000000000000030000000000500000000000000000000000000002000000006000000020002000000000200000
000000003333000000000000000000000000333000000003000000000000000000003000500000000100000000000000010000000030130100000000000000000000000000000000000033330000000000000000
000000000000000000000000000000100230000000020003000000000000000020003000002020010010021003100000000000002000000000000000000000001000000002020100000000000000303000000020
000000000000000000000000000000300330000000333330050000003333030300330333330033333300333033300000003303303000001300000000000000330303333033300000000000010206001003330000
000000000000000000000000000000000000010000000000330000000000000000000600000000000000000000100000000000000000010000100000000000000100000010000000000000000000000000000300
000000000000000000000000000000000000000000600031003000000000000000000000000000000000000000000000000050000000000000000000000000000000000000000000000000000000000000000000
000000040000000000000000000000050000001000101000040000000300400000000000001000000300000000000000000000000100500000000100050300000000030000000000004400002000000300000000
000000000000000000000000002000000000000000000000000000000000600000060002000200000000000002000000000600000000000000000000200020000000000002000000000000000061000003000000
000000000000000000030000000000000000000000000000000000050000000000000000113000000000000000000300000000000000005000000300333004000001000000000000030000010100000005000040
000000000002020200030000002000000003000003000000006102020000000000000000360000000000000002000000000003000020000000000300003000006000000000000203030000020230000000000000
333330033333333333333333333300000060000023333030013333330000000102000000000000100000333030000000003333313000000033333330300000330000003333003033333333333000100000333300
