000000000000000000000000000000000001110000000000000000000050000030000011100000000000030051100000006000000010000010100000000000000000003300000000000400100030000000000000
000000000000000000000000000000030000101000000000300000100000000000100401110000000000100001000000030000000100000001100000000100000003300000010000000000003043000000000300
100000000000000000000000000000100000010000030103040000000000000050010000100000000000100000000001100000010103000000300000000010000003300000001000133000000000003000000000
000000000000000000000000000000000010000000001033300000000000000030030000000000000000100003000000000000000000000003030000100000000033301000000000313000000000000300000010
000000000000000000300000000041000000000000000033300003000000000000000000000000000000000000010000000000000003003000000000000000103333300013000133003000000000000010000000
000005055500000000000110000011000000000000000001330000005550030000000000000000200000600000100000000000000000005000000001000000000003300100000030010010000005500000000000
000000000000000000000000000000060003333333333333000000000000000303333333303530300004331303330333300000000000000033333330000000063333300000003333303000000000000600333300
000011111100000000000000000000000000000000000000010001110000000000011130000000000000000000000100000000100000000000000030000000000000000000000003000111000000000000000111
100001001110000000000000000300000010000000000000111000000100000100001000000300300043000000001110000000000000000300000100000000000010000000000003000011100000000001000040
100000000100000000110000003300000000300000100000110001001000000100000000000000000030000000000300000000001000003310100001000000003011000000000000000000100000100030000000
100000000000000000000000033300000006000000000010000000300000000100000003000000600330031000000000000000000000030010000000000000000000000000001000000001000000000000000000
000000000000000000000003333300000000005001000000000000000000003000000000003000000033000000000000001000000003033300000000000000300000000000000013600000000000000000010000
600000000000000000000003003300000015503000000005060000000000050000000000000000630033550000000000001101000003003361000000000051000000005000000000000000000000000506000000
333333333333333333333333333313030330100000000000033333500003000333300360000003333333030003130323310000000330333033333330003000333333000000000000000333063300000303333333
