000000000000000000000000000000000000000020000000000000000000000000000000050000000000000000000000000000001000000000000000100000000000000000000100000000000300000100000000
000000000000000000000000000030000000000000020000500000000000000000010100600000300000005000000000000300005000030000000000000300000000000300000000000300000000000000001000
000000000000000000000000000001000010000300000000040600000000001000006000000001000100000000600000000000030000000000000000000000100000000002000000000000000000000003000000
000000000000000000000000000000000000000010013000003000000000000000000000000005000000000000300003050000000010000010000000000000000003400000000000000000000200400000000000
000000000000000000000000000000000000000000000000000110000000000000000000000000000300000000000600000000000000001000000001000000000030000000000000150000000000000000000000
000000000000000000000000000000000010000000000000020021000000000000000000000102002000300000000000000000000400200010000002002000000000000000000020300000000000000000000000
000000000000000000000000000000000000333333333603330003333330333000000010000003313303333300333033330000000363332000000003034300330333300000000000000000000033303330000000
000000000000000000000000000000010000000000000000000000000000000400000000000000000000000000000000000000000000000000006001000000003000000000002000000001000010000000003000
000000000000000000000000000000000005000000000000010000000303000000000000000000000000000000000000000000060000000000011001000003001003000000000000003000000060000010000000
000000040000000000000000000000000000000000000030000000000000000000100006000000000300000010000000300000000000000000000000000000000000000000000000000000000000000000000000
000000000000000000000000000000600000000000000000000006300030020050000000000000030000030010000000000010000010000000000000000011001000013000000000000000030000000000036000
000000000000000000000000003300010330000000010000600000000003000000000010100000000030040000000000000000035000000000000000010100003010000000330000033000000000000000000000
000000020020000000000000003300100330000000000000000000060000000000000000000000000033000000000020000000013000003040000000000000000300000000030000003210200000001000000000
333333333333333333333333333300303510000000000000300000000003050333330300000000000033001000000000000333333000000300005000000100333003330033533333333300333301330300000000
