000000000000000000030030313300000000000000020300300000300000000100001000000000000000050000003001300010001000000050000000000000000000000000000001000000000000100300000000
300303300033000000000000003305000003003033100003300000000000000300303001000600000000000000000000300000030011000004013310000000003000001010000000000000130000000000000000
000000000000000000000000000001600001000100000000000100140000000000000200000000000000000000000000000000000000600000000000000000600000000000000000000100000000002000000000
000000000000000000000000000000000000000000000000000000100303000000010000000000000000300000000100000000000000000000000001003000000000000000000000000000000000000000000000
000000000000000000000000000006300000000300000000000000000000000000100030000000000000000000000000000000060060000000300000000000000066000000000000060000000000001000000001
000003000000000000000000000002000000000030000000000003000001010000003000000000300000320000100000000000360300000000010000000000000060000000000030660600000003001010200000
000000000000000000000000000036300000000000000000000000003333333000000003000000330000033000000000000310330030003000000003300333036003001010300306330000000010101000310600
000000000000000000000000000000000000000000000000000000000303133100000000000060000030000000300000000000000000103000031030130000000000000000300000000000000000000000303033
000000000000000111000000000000053350000000001100000000000000033000000000031000000030000000300030000003003000000600100333040033000100000000050111003000000030030030000030
000000000000000000000000000000000000000000003015000000000001000000000000000000000000060003000000000000000003000000010003000000010000000000000000000000000000000000000000
000000000000000000000000000040003000000000000001000000300000000400000000000000000000000000000001000000000000000000030000000000000000000000000001000000000000000000300000
000000000000000000000000066000000000000000000100000006600000001000066000000000010000000000000000003000005000000003100000060000000000000000000000603000000000000000000000
000000002000000000000000066031000000000000001000000036601000000006066000000000000000000001000000001001030003000000000000000030050000000300100000000000000000000301000030
333333333300000300030033333000000003133631030000000333300000000000003000010000000000330003000040000000000000000030000000000060033030000000000200030333030300100000000100
