000000000000000000000000000000000060330300000000000100000000030100000000003101000000000000010030000000000000000000000000000000033006000000000000000003000200000300003000
000000000000000000000000000000000013313500000100000000000000100600000030000003000030000000000000000000300000000006000010001000333010000000100030000303000010000000005000
000000000000000000000000000000000003333030000000000000030000000000000000000005000000000000050100000000210010000060000005000000331000000003005000000303301003000003000000
000000000000000000000000000000000000333000000000000002000000000001000000000000000000000000300010000000600000100000000000000200333300000060000000200333300000000000000003
000000000000000000000000000000000033333000000403000066000000000300000003010000006600000000300010000006600000003100000016006600303300011066000000600333300000000000000003
000000000000000000000003000000001003033010000100000000000030000000400000000000001600030603300000000006030600100000000000106003333300000066000336000300300003000000001033
000000000000055000000003000000000050313100500100033333030030010000500500000053333330333333300000003003331500000051001000033303333300033333333000330333300300000053300033
000000000000000000000033000000000001000100005000000000000000000033000002000000000000000000003000000000000010000303000010000000000203000000000600000000000000000000000106
000000000000000000000333300000000100000000000002000000000000000333000000006000000000000000033330000000000000000010000300000001000600005000000103000000000000000000000000
000000000002000000000333300003100003300000030020000000000010200000300000000000000000000001033301000000500000000000000000000000000000001000000000000000000000002100000000
000020000066000000003333300000000000000000000660001000130106610033300000000000300050300000033330000000100000000000000000000000000000000000000000000000000000003000000000
000660000066000000003333300000001030030000000660000002000006000033300000005000000000000000003330000000600000000000000000003000000000301000310000000000000000060000000030
000660000066000000033333300000005000010000000660000000000006600303600100000000000043003100003050000006600001000000001000000000000003300200600001000000000000066000033000
333333333333333333333333300003000000000001333330333303003353303013300050000000333330003000033330003330032000000500010050000000330030030100005032000000000033333330030000
