000000000000000000000000000000100300000300000000000000000010300000000003000000000000003000100000000000001100050000000000000001000000000000100000000300000000000000000100
000000000000000000000000000000000000000000000000000005000000000000000000000000000000000000000000030000000000000000000010000000000000000003000000300000000000000000001000
000000000000000000000000000000000000000000331300000000000000000030000013030000000000130000000100430000010001000000003300003000030000300000001010100000003033300000000000
000000000000000000000000000000100001003300002000000000000000000100001000033000000000000000000000330100000000000101000000003000300000000000000000000000330030010000000000
000000000000000000000000000000000000003300100300000000000001000330000000000000000000030000030000330000000030000100000030033300333600000000000030000003330033000000000000
000000000141000111000001111101110300330300033020000041000011010030022130330000011100330020000000030000600000000100000000033000302002000141003601000033330033001200004100
000000000000000000000000000000000003330305333333300000200300000333333300333000500010333330330303030000000331033000000003003133313300300001003333330033333003303330003000
000000000000000000000000000000000000000000001000100000000000000001000000000000000000000000000000000000060000000000000000000311000000000003000000010000000000003000000000
000000000000030000000000000000000000000003000001000001010000000000001000000000000003500000000000000030000010000001000100000000000000300000000000100000000000050030010000
000300001100333300000111110001111100110000000000000000001111101000000000000000310030001000000000000003000000000000000000002000310000311111000000000000000000100332000000
000330000000333000000000000000000001000030000300000000000000000000000000000000000030000000000000000003300000000000000000000000000003000000000000000000000000000330000300
003330000000333300000000000000000000000003000000000000000003000000000000000060000033000040000000000003000000000000000000000000000000000003000050000060000000000330000000
033330000000333300220200000020000000001033000101100000000000000000000000110000001053001410001010000300300001111001110000001101000003320000000011111111100000060330000000
333333333333333333333333333033333303303333000100020100003133336000000001030003033303000000000000003130300000000000000000000000333300333333300030000000000033333030000000
