000000000000000000000000003000000000100000000000000000000000000000003000000000000001000000000000000000000000000000000000300000000000000000000000000300003000000000000000
000000000000000000000000000000000000000000000000000000001000000000000000000001000000000001000000000000000000050000000060000010000000000000000000000000300000000000000001
000000000000000000000000000000000000000000103000044430000000300000000014401000011000000000000000000000000040000000000000510000000000000000000000000100400000000000300050
000000000000000000000000000000000020000000000000000000000000000000000000000000000030000000000000100003000000001000000000000000000000000030000001000010000000000000200000
000000000000000000000000000000000000601001000000000030000000000013000000003000000030000000006000000000000000000000000000000100000000000010000000000000000000100106000001
111000000400000000000000000002022000000000111060000003001110000000000000000000046001111050066000002102200000101020022031110000000000000000001040005000000000022006100200
000000000000000000000000000030333300330030000000033333100000300000000033333300100050001000033333303330303333333033303300000000002000133313310000100100000030333303033333
000000000000000000000000000000000000000030000005000000000000006000000000000001000000010000000000000000010000000000000000000000000000000000000000000000000000000000000001
000000000000000000000000000000400000000100000000000000000001010000030000000000000000000000000000002000000000003000000000060000000000010000000000000000000000000000500301
444000000000000000000000000000000001000000000000000000300000500000000000000000000000000000001000000010300000000044000100003000000001030000000000000444000000000000000000
000000000000000000000020000002000000000040000000000000000000000000000002000000001000031010000000000000000000000000000000200000000100000000100000030000000000001001000000
000000000000000000000660000066000000030000300000000005000000000000000046033000000006000000000000000000000000000000000006600000000000000000000000000000000000000000630010
000000000000002202200660020000001000000000004000000003300200200000000066000000000003004000000003050000000000000000000006600203004300300010000000003000000000000001110000
333333033303333333333333333303330330000000000000000000013033300333033033333300000000000000033303330030000100000043330303333333000000000000000000000330333031303300000000
