000000000000000000000000000000100001003000000000000000000100600000000000030000000000000000000000600000000003000000000000000000000000000000000000000000000000000000000000
300000000000000000330000101000000000000100000000000100003000000001033000000000000000000000000010000000000000000000000000000030000000000010100000010000030000000300030000
110000010000040000301111111000000040000200000000000000001100000300030160000043000000000000010000000000000030026000000600000301200000411111101061010000000430003313600000
000000000000000000000000000000001000000030000050000302000000000000500000000000300000000060000050000000300000310000000000100000000000000000000000000000000000003000300500
000000000000000000000000000000000100330300000000000066000000000000000110000000000000001100000000000006600033330000060000000000000001000000000000000000600000040000300050
000000000000000000000000000000010000334300000000000006000000000000000100000300300000200000000020000000000033300000066000000000000000100000000000000000001000000000050000
000000000000000000000000000000000003333331333003003033330000000010000000000013300333333330000340000003333300230000030330200000000003300000000000000000000000003003000303
000000000000000000000000000000001000000000000004100000000000600000000000050000000010000000000000000000100000000000000000000000000000000000000000000000000000000000000000
000000000000000000000000000000010033000000000030000003300000050000000300000000031010000003130010100000000000101000000000000000000030030003000000000000600000030410000006
000000000000000000200300000001111101000000000000000003010016000000000000002001111110000020101000103000000110010003003003001060000000001000001106000000000000000000000200
000000000002000033300030000001000500000000030000010000000001200000000050333000000000000000000000000000300000000000033000300000000000000005003000000000020000000000003300
000000000066000333300030000003000000000000030000000006000006600000000003333300000000000000003000000300001000000403333000300000000000000000000000000000060000000000333300
200000000066000333300030000000000000000000030000000000003006600000000003330000000600000000001000040301000000000030303000300000200000000000000000000000610010000030333300
333333000033333333333330033300000000000000330030330000000013333333300003330300000000000000003000003300033001000003333333300333330333000000000003000000333333033003033330
