300000000000000000000000000000000003000000000000000000000020000000000030050000000000020000000000000000000300000030033000000000000000000000000030000000000000000000000000
300000000000300000003000000300000033000001000000061000200000003000000330000000000121000002000100000000003300000010000000000000000000000000030000100000000000000000500001
000000000000000005555000000000000000000000000030033100010005555000000000010003300000331000000000020000000000000000000000000000000030000055050000010000105000000013310000
000000000000000000333000000000000000000000000002000000000000333030000300000000000000000000000000660000000100000000000003000600055000005003030000000050000000006660000000
000000000000000000000000000005000000000000000000010000000000300000000000200000000300300000000300660300000000000000000000000000004001005200000000000000333200000660000010
111000003300000000000310000011000000100000000000000000100000001310000010103000000000300003000001063000300011000010000000300000000000000000000110000000000010000660000050
000000000000000000000000000000000100000500000300003003330000000001000030001003343303313333001003030000000000000000000000000000000000000000000000160300650000003303333333
000000000000000000000000000000000000000002000050000030001000000000300002000000000300006000000000000000000000000000000000000000000000000000000000000010000000100003000010
000002000000000000000000000000300030101030000000000000000000000000000000000300014202000000000300000000003000300000100000000020000000010000000000000000003050000003500006
331000000000000000300000000200030530000010000000000000000000002050030000000000100001000000300030000065055031010000300000310000000000000000020006300000000000001050000000
000000000000000000000000006600000300000000000000000000600000060000000000000000000000000000000000000000330000003000003000005000000000000000160000000000003000003030000000
000000000033330000000000006600100000000000000330300000060000066000000000000000000003000333000000000000000000000000033330300000000000100000660000000300000000000010000000
000000000000300000000000006600000000330000000000000000660000006000000003000000000030000003003300000001000000300000000000000030310000000001660050000030000000000001010000
333333330000000003300000033300006000000100300001000003030000330000300000000000000000300000000000000500000000030130010100330003000000000003305003300000000000000000000000
