000000000000000000000000000330000000003010000000000000000000003050000010000000000000000000000000001001000000100000000000100000000000300000010100000000005005000000000003
000000000000000000000000000000000000000000000000031010000000000002010050000000000000000000000000000000000000000000000000000000000000000000000000000001000030000000003000
000000000000000000000000000010001000010001100000000004001100000000000000053000000000000000000444401100000000200000003000000000000000000000010000000000000010000000000000
000000000000000000000000000000000000001000160003000000000000030000003000000000000001003001000000000000030001010000000000000000000000300000300000010050000000000000000000
000000000000000000000000000010000000000000031000000033000000030000001000000000000000000300000000000000030001200001000000000000000030000000000000000000300000100000000000
500000000444004400000000000000000005010000000000000000000000030100003000445005000000001000060000000000000004140000000000000000001000000000021000000104400044000000000000
000000000000000030000000000030033330000000300000030000303333303010000000000000000010001000030000033303033000000000003003333333030030030300000000000000000000300000000300
000000000000000000000000000000000000000200000000000000000000000100000300000000000000300003000000030000300300000000000100600000000010000300000000000000000000000000000100
000000000000000000000000000000000003000000060000000010000000000001000000000060000000000005000000400000000000000050000030000000000003030000000000000000000000000000000003
000000000444411100000000000000000003000300000000010000000000041000000000000030000000000000000000000000000003000000000001100000000000000404410000000000000011000000040440
000000000000000000030000003000000000000000000000000000300000000000000000000006000060100000000000000100000000013000000000030130030000000000000000033000000000000301000003
000000000000000000030000000001001000000000000000000000300000000000000000000000000000000000000030000100000000000000050000000030000006000000000000020000000000030300000000
000000000000000000030000000000440004400000000000000000010000000000000000000000400005000100000000004000000000030140000000000030004340000000000000000000000000060003000300
333333330000333333333300000000001000030100000000033332313000033000000533333031030001000330000000000130003300000000000003003033000010035000003000030330303300303333000000
