000000000000000000000000000000000000000000000000000000000005000000000000000030000000000000000000000000000000000000000000000000000000000000003000010000000000000000000001
000000000000000000000000000000000000000000000000000010000000010000000003000000000000000000000000000000000101000300030000200030010000000000000010000000001000000000000000
000000000000000000000000000000000000010000000000000001003030000000000000000000000000040000000000000000000000000003000000000000000003000000000000010000000100000300000003
000000000000000000000000000040000000000000000000010000300000000000030000000000000030060000002000000000003000000000000000000030501000002000000000000000033000000000100030
000000000000000000000000000000000300000000000000000033000000000000000000000000006030000000006000100000000100000000000100003331000003066001001005003000300000100000000000
000000000000000000000000000003000300000002000000000300040000000060000000000050000030000000066000000030000000000200000000033300000003066000000100002003333000000000000000
000000000000000000000000000033330300000000000000033333031500033000000000000003333330000000033133000000000033333300000003333300303333030033000303050333303003000003333330
000000000000000000000000000050000030030030000100000030001000001000000000000000300300000000100000110000000000030030000000000000000100003001000000000000000000000000000000
000000000000000000030000000000000000600000000000100000000000030000000300000000000000100000000000300000000000000000010000031000000300000003000000000006000030000300000300
000000000000000000000000000000003000000000600100000000530000000100005000000000300000000000030000150000000000000000000500030000000000000000000000000000000000000000000500
020000000000000000330000003000000100001000000000002300000000330000000000003000000000000000000000100030030001003000000000000010000000000000000100000000000000001000100500
660000000000000003330000003000000000000300000000000000000003000000000066000000000000000000001103000000030000000001000000000010130000000000000000000000000056000000000000
660000000000020033330000003000000040000301000030501000000060330000001066000000000000000000010033100000000000000000000026000100000000100300000000000000000060001000000000
333330033333333333333333333000000000333033100030003333003030300000100000333003331330600050033033333333336100000033333330004001300000003000000000000000010033330000000100
