000000000003000000000000000000000000000000000000000000000000000000000000000001030000000030000000010000000000000000000000000100000001000001000030000000000300003000000000
000000000000000000000000000010110000000000000300000000000060000000000000000000000000000030000010000000000000000000000000000000000000000000000000000000000010000000000000
000000000000000000000000000000020000000000000000000111100000000001110001000000000000300100001000003000030001011001000000011110000000000000060011110000300005000000000000
000000000000000000000000000003000000000000000400010000000000000030030000000005005330000000000000000000000000000000000013000003000000000033300000300000000003000003000000
000000000005000000000000000000005300000000000000000000000000003000000000000000000000000050000000030000000000000000000000000000000000000000000300001000000000005000000030
000000000111110000000444000000101100000600000500003000001000000000000002000000000300003101120000000000000000000000300000000100000000000603000000000000003000111110000000
000000000000000500000000000000000000333013050000003000003330333030000301033303333003000000133333303033333000000033030300300003330000310033040300003006000630030000500000
000000000000000000000000000006000000000000000000000000000000000000200000060000610300000000000006000030000000000000003000000000000000000000000000000000000100000000600000
000000000000000000000000000000200003000000000000000030000110000000000000000100000000000000000040000000000010000001000000000000000001000000000000000000030000000030000000
000000000111100000000010000000000000000000000000300002000000000000000000000000000000000000030003000000006000000000000000300000000000500000000000011000100001010000400010
000333000000000000000000000000003300010000000000000000000000000200130000000000300510000000000030000000000000330000000040003000000000000000000000003010333000000000001000
000000000000000000000000000000010000000000000000000000000000000000000001000000100530000001000000000000000000000000000000000000000000000000000000000010000000000000000000
000030000000000000000220000000001000000000404000022000004400030000000050000000010101000510043400000000000000030300111010000000444000000060004100001000000020000000010000
333330303000033333333333333033000031000000020301003331300001000000000305610000000000100010000000000500000003310303000003303031000000013000000000000333030330330033333333
