000000000000000000000000000000000000001000005100000001000100000001300000000001000050050000016000000000000000000000000000010000010003000000000000000000000100000000000000
000000000000300000000000000000000000000000000010002000000000000000000000000000000000000000000000000000000000000005000000000000300000002000000000100000003000000000110010
000000000000000000000000000000000000000000000000066000000000200000000000000000000000000000000000030000000000020040000000000000000000066000001000000100000010000006600000
000000000000000000000000000000300000000000000010306300000000600010000000000300000000000000000000300000000000060000000000000000000000060000300000000100003000000000003003
000000000000000000000000000000005000003000000000001000010006600050000000000000050000000300010000300000000000060000000000000000000100060000000600000000000201000006000000
000000000000000000000000000000000001300000000000160000000000600000000000000000050000000000000030030000003000060000100400000050060000006000000000000000000000000006010001
000000000000000000000000000000000003333035001000020333303303333000000300000000000000333300300000000000001303036033033030000000003000043303304500000000000033130300300330
000000000000000000000000000001000000000000005000000130000000100000000006000000300000000001000000000000000011000000000000000000000000000000000000010000050000000000000000
000000000000000000000020000003000060000004011000000000000200000000000000000000000030020000060000000000600000003000000000000003000600000011300000030010000030000000000000
000000000002000000000660000005002000000000000000000000000600000000000030000000000000660000100000000000000000000100000000000000000000000000000000000000020000000000000300
000000000066000000000660000000066000000040000001000000006630000000000003000000000000660000130000000000000001000030000000000000000300000000000500000000100000000000000000
000000000066000000000660000040066000000000010000000100000000030000000050020000000000361000000010000000000000000000000000010000001066000000000000000000660000060000003000
000000000066000000000660000000066000000000000050000000006600000511000000000000000003060000000000036000000000000000000000000000300600000000000000000000160000000000000000
333303333333333333303333333003303330000000300000360000000330030133300306033000000000033003033030230000000000000000000003303030033330000000000000000033031300000003033303
