000000000000000000000000000000000010000000060005000000010010000300000050000000000000004300000360000000000014000000100000003000010000010000000000000000000030050000003000
000000000000000000000000000000000000000000000000000000030000000000000000000000000000003060000000000000003000000000000000000003001000000001000320000030000000000000000030
000000000000000000000000000000000003000500000000010000031303003000000000000000000000303000060000000000000110003300440011000000000000000010000010000300200000000000030001
000000000000000000000000000000000003033000000000000003330001033000000300000000000000000000600000000001030000013301000500000133000000000000000000000303000260000000000000
000000000000000000000000000006000000000003000000000003330000333000000000004000000000000010000000300000000000003300010000010300000000000001000000000300000000000000060000
500000000000000000000000000003000001000000000000001003330100330000000000000000300000000000100000000030000000030300000000600300000001000000006000000300010020000030003000
000000000000000000000000000000000001000000000001033333330033003000000603333330000000000000000600003330330333333333333033300030303363330000000001000000000001000003330333
000000000000000000000000000000000000000000000000000000030000000000000003000000000200010000000000000000000000100000000000000000000000000000000000000000000000000000000000
000000000000000000003000000000000062000060000000000000000000100000000000060000000000010000001050200000000050060000010000000000000000000003000000000000000000000030000000
000000000440011100033300200000000000044000000000000000003002003100050010440010003000400001001442013005000000000000000000001000300200030000000000100000000001000030000000
000000000000000000333303300000000000000000000400000030000033000000000000000000000000600000000000003033000100000000000000100000303000000000000003000560001000003330020000
000000000000000000333300000000000003000000000000000010000000002000000000000020010000000104000000003000040030000000000000000000000000000000000000000033001001000330005000
000000000000000000333300000000300000000000300000000000030001000500000100000010000000500000000030003000000500000050030020300000300010000000100000006010000030003035000000
333333333333333333333000000000000003330333300000033333030000000000000130333330000000000000033333030000000000000000004000000010000000000000010000000003033303333030000000
