000000000000003000000000303310020000050000000000000233300000000000000000030000003003003000000303333000000003303000300300000000000600100000000003133003000000000000133303
000000000000000000000000000100000000060000000103000010000000006000000000000000500011000000010000000000000000000000000000000300000000000000000000000000000000001000000000
000002000000000000050000000030000000000000000002000000000000000000002000001500000000031000000000000000000000000000003003000100000000000001200600000000230000100200000000
000000000000000000033000000000000000000000000000000000000000000000000000000330000000000005000000010000033300000000000001000001003100300100000000000000000000000000030000
000002000000000000000000555003333030000000003000000000000300330000032000010000005550000001000000000000000300000000000000330333000000000000200005550350000000000200000000
333330333333000000000033000030000103303000333330000000000000000333300300000000330000303300003000000000000000000003000000000000333330033031030330100000001033303030000000
000000000000000000000000000000000400302000000000000000030000000000000010000000000500000003000000000000000000000300000000000005100000000000000000000000000300000005000000
000000000000000033333003330000003303000001000000000030330000000503110000000000313313000303300000000000000000000500033300000100300000000303000050000000000030500000000000
000002000000000000000000000000001010000000000002030003010000000004000000050100000000000000100000200000000100000000000011000020000000001000000000020100000000000000000000
333300330000000000000000000000030000000050333300350000020000000000000030330030000000000000033330030000020000000300001003003003000105000000000333000301000000100500000000
000000000000000000000000000000000000100033300000000000000000100000000000000000000000000000000000000000310000300330000000000000000003000000200000001000000000000033000003
000000003333330000000000000000000000000000000301000055500000000100000000000000003000000555000000000000020033333300055500000006000000000000000000000000000000000000333303
000000000000000000000000000000000000000000000000000310003030000000300000000330000000031010030000003030000000000003300000000030000000000000000000400330330000100000000000
000000000000000000000000000300000000000060000000000000000000000000000300000000000001000000300000000000000000000000000000000000000000000000030000000000000000000000000000
