000000000000000000000000000000000330000000000010000001000000000000000230000000000000000000004000000030000000000000000003300000100000000000000000000000000000000000000000
000000000000000000000000000003000000000000000000020000000000003600005000000000000000000010300000000500000000000000000003330003000003005030030000006000000000500000000005
000000000000000000000000000000000000000000000000000000000000003000000010000000000000000000300300000000000000000000000003333000000000000000031000030010030000000000000000
000000000000000000000000000000000000000000000000000000100003303100000000000000000000000333303300005000000010001000000003030000306000000003330003033000000000000600000000
000000000000000000000000000000000000010000000000000000000103333011000000000000000000000330300000000000000030000002000010330000000000000001030003303000000000000000010010
000000000000000000000333000000000050000000000000033300003013003000000000000006000000200004300500000100000000000000000003000000000000020033130003303000000000000000000000
000000000000000000000333000000000000030000333033136300003303330010000030000303333333053033033303333000000000004033033330633030000000033033300330030006060000000003333303
000000000000000000000333000000010000000000033000000000100000000333000010000001000060300000000000000000000000000000004300000000000010000000000000000000000033300000300000
000000000000000000003333000000000000000003333000000000300030100003000000400000000000333000000300000000000000000000000000003000000000000100000000000000100033300500000000
000020000000000000033333000000023000000003003000000000000000200033300000000000000000301000000000000300000000020000000030010000300020000000000000000003001333301000000203
000660000000000003333333000000066001003333133000000300000006600331000001000000000000330000000001000001000000600000000000000003000660000001050000000000000033300000006600
000660000000000003303333000000062000000301033000000000000000000033000000000000000000330000000000000000100000060000000000000000000660030001000300000001000033000000006000
200660000000002003303333000020060000000300330000000000002000100303000000000013331000333000000060001000000200660010003003330000200660600000003031000600010033300000006600
333333333333333333330333303303333333303330320003300100100333303333303300000000330000030103330310000000110303353300000003310300133333300001001330000000030033030330000033
