300000000000000000000000000000000000000000000100000000000000002000000000000013000010000010600000000000000000400300000010000000000000000000030000000300000003000000000000
000000000000000000000000000000003000630000000001000010300000000000000000000000000000000000000000000000036000000000000000000000000000000110000003000005000000000000000000
000000000000000000000000000000000000001300300000300300000000030000000000100000000000000000000000000000000000010000001300000000000000300001000300030000000000000000000000
000000000000000000000000000000003100000000000301000000000000000000003000000000000000000000000000000000000010000000100000003000000010300000000500000000000000000000000000
000000000000555002000000000000600000000000000000000005001000000000005500410000000100000305500000000000000000000000000000003000000000010000550000000011000000000050000000
000000000033000000002000033300001000000053100000000000000000000000330000000000001000000330000003300000000031100000001000000003000000003030000000000020000000013000000330
000000000000000000003330000000000003000100000000000000000060000005010000000600000000000010033000000000000000000000000000000030000000000000000000000000000000000003100000
000000000000003330000000000003300000300000300000000000003330000030000000030300030000000000000000000000000333000040000001000000233000000000000000000000000033300000000000
000000000000000000000000000000000010000000505003000000000000000000000500000000000030000001000000000000000000000100000000000000000000000000000000000000000000000000000000
000003300000000000000000000030000030000000005000000000000000000000000000000000000300000000010010330000300000000000010000000000030000000300000030060000300000000000000000
000000000000000000000000000010003000005000005300000000000100000000000000000000010000100000000000600000000001000000030000000000000000000001000000000000000000000100000000
000000000000000000000000000000000000000050000000050020000000000000003000000005002000000300000000000000000100003000000000000000000000010000000001000500203000000000000000
000000000000000000000000000000100000000300000000000000000000000000030300000000130002000000000000000000000000000000001330000000000000600000020000010000000200005000000000
000000000000000000000000000000000005000000003000001200031000000030000000010000001053000000000000100000001000000003001000000000000000000000000000000000000000000000000000
