000000000000000030000000000000300000004000000000000000000000100000000000000000000003000000100000000030000000000000010000030000000000000000000000000000000000000030000000
000000000000000000000000000000000000355000000300000000000000000000000000500000050000100006000000000010000005000000000006000000000001000000000000000015006000000000055301
000000000000000000000000000010000000100000000000000000000000002000000000000000000000000000000000000000030000000300300000000000000000000000000000000005000000000000100000
000000000000000000000000000000200000000010100000000000000000000000000000000030000000000000000000000000030000000000000000003003000000001000000000000000000000000000000000
000000000000000000000000000000000000000000000000000000000000000000000000000000000000000001000000000000051000000500000000000000000000000000000000000001000000000000000000
000000000000000000000000000000000000000003000020000000002000000001000000000003000002010000000005000000001000000210000000000000000600000000000000000000000220000100000103
000000000000000000000000000001003003303033333331103000000303333000000033330333330033000000000000000000000031333300000000000000100000000000003333330030333300000003033053
000000000000000000000000000000000300000000000102000000000000600000600030000000000000000000000010000030000000000000300000000000000030000000030000000003000000000000011000
005000000000000055000000000000000000000000105000000000010000000060000100000000000000000003000006000055000000000000550000010000000000000000000600000000000000000000300000
000000000000000000000000000000000000000000000000000050000000000000000000000005000010000000000000000600000000000001000000000000000060000040000000000003000500000000000000
000000000000000000000000000000000000030000000000000000000600010000000000000000000000000000600001001000000000000300050000000303000000000000050000000000300000000000030000
000000000000000000000000000000000000000000000000000000030030100000000000000000000000000000000000000000000000000000000000000000000000000000000300000003000000000000000600
000000220000000000000000222200100000000000006000200000000000000000000000000000302222000000000022320004000210000000000002000010000202200000020000000000000000000000002220
333333333333333333033333333333330330000000333033300200000000000000000000000003333003000000033331333333033333131333330000033333336333333533000000000000000000000003132033
