000000000000000000000000000030010000003000000000500000000000000000010000000000000000000000000000000000000001000000000000000000000000000000000000000000000000000000000000
000000000000000000000000000000000000000000000000000000000000000030000000303000000000010000000000030000000000000000000000000000000010000001000000000000000000001000000000
000000000000000000000000000001300000001040000000000000001000000001000000000000000000000000000000030013000000000006100000100000111000000020000000000000000000000000000000
000000000000000000000000000000000000000010010000000000000000001000300000000300000000000000000030000300001000000000000000030000000001000000000000000000000100000000000000
000000000000000000000000000002000000010013000000002000000000000000000000000000000003000000030000030000003001000000000400000306000000000000000000030000006000000010000000
000000000000000000000000000000000000000023000000000000000006010000000000000000000003202000000050000100003000010000000000000030200000000000000000000000000000000012022000
000000000000000000000000000000000300333103000000000000000000000333133300000003333331333331300030003333333000000033330330000000330333302330303000300303333300000000333330
000000000000000000000000000006000000000030000000010000000000000000000000000000000000130000000000030010000000000030000000000000000000000000000000000000030000000000000010
000000000000000050000000000000000000000300000000000500000000000000000000000004000000000000000030030000001300000000130000000001000000000000000000030000300000000660000000
000000000000000000000000000000000000000000000000000001000000003000003000100000020001000000000001031000000000010000000000000000000000000000000000016000000000000000000000
000000000000000000000000000000000000300000000000000300000000000000000000000000000000000000000000000000000000000000000000000000000000000030100000300000000000000000310000
000000000000000000000000000300300000403000001000000003000000000000000000000000000000000000000000010000000000000000000000000000000000000000000000000300000005000000000000
000000020220000000002000002320220000000004000000100000020000002202100100000000000000000010000000000000002000000000500300000000000000210000000000023000000000000000003000
333333333333330033333333333333033033333333000000000303330003133333331000000000000000010000133033330033333000000000000000003000003333300000010333330000000000000000030331
