000000000000000000000000000003000000002000000000000040110000000000001300000003000000000000300000000000000000006000000000000003000003000000000000030000000000003040000001
030000000000000000000000000300000000000000230000003000000000000033000000003000005000000000300000000000000030000003000000000000000000000000000000000000000300300000000100
000000000000000000000000000000000000003000000000000000030000010000060000000000000000002000300000000000000000000000001000000000000000003600000000000000000000000000000000
000000000000000000000000000000000000000010002000000003030000000000000000000000000000000000000000000000000003000000000000000000000004003600000000000000004100000000000010
550000000000000000000000000000000300000000001000055000000000000560005000030300000000000000000000000000005550000005050000100000003300031650000000000000000000400000001106
000000000000000000000000000000200210020000000300000000000003022000001000200000500000001000600300000000020000000000000000000000100000030606000020000000000000000030000020
000000000000000000000000000030301033333033000000000000003333313000000033333330000030000000300010300333303010002000000000000000033303303333300333333011050000100001330033
000000000000000000000000000000000000001000000000020000000000010010000000001000000000000000100000000031000000000000000001000000000000000030000000300000000000100100000000
002000000000000000000000000000000020000000002000000000000000003600000000000000020000002000000000000000000000000000000006000000000000110000000000000032000033000000000000
066000000000000000000000000000000300000000066030000001000000030000000000000000600000006000000000000000000000033000000000000004000000600000030000000061000000000000000000
066000000000000000000000000000000000000000066000000000000000300000000000000003600000066000000000000000000000000000000010000000000000000000010000010066000000000000000001
366000000000000000000000000000006000000010066000000000000000000000000000000000600000306005040000000000000000010000000000030000030000000000000000000306000055000003000000
366000000000220020000002202000000040000021300000000000000100600000000000000003660001306000000000200020000000000000000000020001003000000000220000060360000000000000000000
333333333333333333333333003300000003331033033303300003000000000351103300000003333033033333033000330000333000000000001003330033000000033301033030030333333300000000000000
