300100000000000000000000000000030000000000000000060300000000000000000000000000300000000000000000000300000000010300000000000000300000100000003000000003000000000000000103
000000000000000000000000000005300000000050000030000003000000000000000005310000001000000000300000000000000000005053000000000003000006000001500010013055000001000500000000
550000115100000000000000000011110160006110000300000000000000000050000111100100001101000000000000001000010000011011111051010000000000000011135500001011101100061110000000
000000000000000000100000000000000000000000000001000000000000000000000001000000056600000000000001010000000000100000000000000000030000003000000000030000000000000000000010
000000000000000000000000000100000000000000061000000000000000001000006006000000000000000000000000000000000003300000000000000000000000100300000000000300100000000000000001
000000000000000000111111111100000000000000000000000533111110410005000000000000001000003005000001111111111000000000000000000000110110100000002000005001300000000000111111
000100000000000000000000000060333030333030010000300000000000000100001030333330333303330000300000000000000330333330333330010000000000033303330001000330503303333030000600
000100000000000000000000000000010000000000300300000600000300000000005000000040001000000101000000000001000000000030010000001000000330000000000401000000100000000000000000
000100000000000000050555000006010000000000000000000000000000000000000011000000001000000100050000500000000000000000000000101000000000003000000001000000010000000000000000
000000000000000001111111111000000000000060500000115000000100003151000000000000000030000003310101105500003151000035030010100000000000000000000000001000010100004001210600
000300000000000000000000000000030000060000000000000000000000000000000000000000003000000300030010001000000000000000000000003100040000000001000033000000000000001000000300
333303000000000000000000000003330100000000000060000000000000000000001000000003300000013303000000000000000002000100000003333100000000000010003333000000004000000100010003
033303000000000000000000000003330331111011000000000003000006000003000000000010033030003303000600000003000000300000000000333000000000000000100333030300000000001110000000
333333333000033333333333333313003330000000000100000000033300000000000000000000033303133333333333300000000010050000000001303333000010300000005333333000003100300000000000
