000000000000000000000000000000000000000000000000000000005000000000000000000000000000000000000000000000010060000000000000000300000000100000000000000100000000000010000000
000000000000000000000000000000000000000000000000040000000000000000000000000000000000000100000005000000001000000000000300000000000100000055000000000000200000100010000030
000000000000000000000000000000000000000030000000000000000000000000010000000000300000500000000000000000000000000300300030001000000000000010000000000000000000010000000000
000000000000000000000000000000000000000010000000000000000000000013010000000100000000000000000000000000000000000100000000000000000000100000000000000000000000000000000000
000000000000000000000000000000000003011000010000600030040000010630000001000000300551000000001000030000000030000001300001000030005000000000030000000000000000000000030600
000000000000000000000000000000000000000033010010000000000002202000000001000000306000003000001000000000000000010001000000000033050320200000030000000000000001003300000201
000000000000000000000000000000000003300003333333300000000333333000000003033330000000003000030333000000000000000030333333030003633030013330330001000000000000000003333033
000000000000000000000000000000030000000000000000000000000000000000000000000000000000000006005300000000000000000000000000000000000000600300000000001000030030000000000003
000000000000000005500000000010055000000000032000000000000006000000030000105000300000000550000000001000100000000063000000000000000000010000000000000000000000055000000010
000000000000000000000000003000003000000000300101000000001001000013000000003030000030000000000000000000000003003000000000300000000000500000000000000000003000000000000050
000000000000000000000000003000000040300000000000000000000000000000000100000000000030001000040006000001000100002000000001000000000000000060000000000000003000000000100000
010000000000000000003000003030002030020000000000000000000000000300000000000000000000000000300000000030000000003000000000000000000000000000000010000000004000003030000000
010000000022020000003000003301000030000000000000000020020000000030000000000000000013000000300022020000000000503300000000000000000000000000000000100000000300005030103000
333333333333333333033333003300330035000000000000000333300000000000000033330133330013333303353333330000003033003305010000010030000000000000000300000303003333330333330333
