000000000000000000000000000000000000000000100000001300000000000000000000000000000000000300000000000000000313000000000000000000300000000000000000000010003030000000000000
000000000000000000000000000000000000000000600000000000000013300000000000000006400000000000000000160000000000000200000020000000000000000300005000000000003000000100000000
000000000000000000000000000300000030000000100000000000000010000000100300000000000000000000100000000000000000000200000020000000000103001000030000000000000000000000000000
000000000000000000000000000000000303000100000000000000000000000000003300003030000000002000300000000000000000000001000660050000000000000000000000000010000000000000000066
000000000000000000000000000000013030000000000000000000000000500000030300000000000000000003000000000001000000000600000060000000000000000000000000000000000000000000000336
000000000000000000000000000000033330000000100000000000000000001000303300000000000000000001000000000000000602006502000600000000010100000010300000000003060000400000020066
000000000000000000000000000033333300001000000000000000000000000330333000000000000000033333000000000000000330333333033330305000000000000000003333330000100003300333003331
000000000000000000000000000000000000000103000000061000000000000000000040000000000000000000030100010000000000000000000000000000000400000000040000100000000000000000000000
000000000000020010000000000000000000000000000350002000000000002000000000000000010000000300000000000000300000000000030040000000001000000000000000000000000000000000000060
000000000000020000000000000300003000000104000000000000050000002010000300000000000300050000000000000000503000000000000030001001000200000000000000000000000000000030000010
000000000000660000000000003300000160000000600102000001000000066300030300001002000000000000000000000006133000010000020302060000000004000000000000000400000000000330000000
000000000000660000000000033300000600000000000000000000010000066000000000000000000060001000000000100000303130000000003330000000010000030000000000000000000010003300000000
000000002200660000000000333310200060000000000500000000000220066000000000000000010300060000000000100003333000000000003330000000000000000000000001000005000100033330000000
333333333333333333030333333333303313330303330303000000003336303000000033033333000030100303000000003303333000000003033300003000330303030003130000000003000033033000001000
