000000000000000000000000000000000000000002000010000000000000000000000000000000000000100000000000300000000000000000000000000000000010060000000000000000000000000000000030
000000000000000000000000000000000000000000000000000000000000000100000000000000000000000000004000003000000000000000000051000000000000310000000010300000000010000000000000
000000000000000000000000000000000000000000004044000000000300000010030004404400000000003000000500300001000001001100000000110004004440000000030000003044444061100040015000
000000000000000000000000000000000000000000010000000100000000000010030000000030003000000000000000010060000000000000000000000000000000300000000000100000051003000000000000
000000000000000000000000000000000000000000001200000001000000000100000300000000000000000000000010100000000000000000000000000000000000000400000000000000030000000000000000
010000111110000000000000000001000000000000000001000000001111000013000100000000000000010000100400001111000000000000000000020000000030000002000100000000000000200000100200
000000000000000000000000000000000010000000303013303033000000000001000030300330010000000000001033000030000000000003333000333330033330300330300000010333330333333330333330
000000000000000000000000000010000000030000000010000003000000000000000001000000000000000000000000040000000100000000510000000000100300000000000000000000000000000000002000
000000000000000000005000000000000000300000000001003000000000000000000000000000000000000000000006000005300001000010000000000300020003500000000000000000000000000000000000
011000404444400000000000000001100040050000000000000000000100000300001000000003000400100000000010001310004044450000000000000003000000000000000000000000000000000000000200
000000000000000000000000000000000001000000100000006030000000000000000000000000000000000000000006000601000000100350000001000000000000000020000000000000000000000000030005
000000000000000000000000000000000000000000000000000006000000000000000000000000500000000000000000300030000000040000000003000000000000000000030003000010000000003001000000
202000000000000000000000020003230001000100011100100000002020000000000000010000100300000000000003002020000000000011110000100001000400000000000000000000000011110000100001
333333333333333333300033333001333333033330000000000000000303330333330000000000103330000000003033303030300330303300000000030000030000000000003333300030000012000000000000
