000000000000000000000000000200000000000001000000000000020000000000000000030000000000000000030000020500000000000000000000000000030000000000020000500000000000000020030001
000000000000000000000000000000001000000006000000000000100000000000000000000001000000000003000000000000000010000000000000100000000000000000000006000000000000000000000000
110000000000000000000000000020060010000000030000000000001100000000000000003004430100000200000000001130000000000000000030000000000000000000001100000210100100000000010000
000000000000000000000000000060000003003000010000000001000000000000600000000003000000006600000000000003000000000000660000000000000050000000000300100600000000060000300000
000000000000000000000000000000000000000000030000000101000000000006603000000100000000006600000000000003000000000000600000030000000000000000000000030600000000100000000100
000000000000000000000000000060100000000104000001000404000000000306600003000000000000030600001000000000000000000000600000000000000000000000000000002600000000010000030000
000000000000000000000000000000301330000000001000000000000000000333333000030000003030333333300000000000005000000013033300000000333333300000000000310303030300000000000000
000000000000000000000000000000000000000000001000000000000000000000000203000300000000003001000000000600000000000000000000000000000003000000000000000000000000000000000000
000000000000000000000000000000000000000000003003000300010000000000000016000000000000000000036000010000000000000000000000060000000000000001000000000000000000010000003005
200000100000000002000444000000000003400000110100000000060000001000000003000500000020001000101000000000000404000000430002000001110030005006000000000404000030000000000000
600000000000000066000000000030000000000000010500000000006000000000000000300030000000600004000000000000000000000000000003001000000000000000000010000000000100000000066000
600000000000000066000000000001000000000000050000000660002000000000000030010000000000600000000000000000000000050000000006350003000000000000000000000000000100000000006000
600000000000000066000000000000000000000000000000500360006000000200000000000000000000600000000000000000000000000000000006000030022000000030300000000000000050300000066000
333333333333333333333333333330303303333323000000303033303303333030000033033330000000330336333333331000000533333330303030331303000130033000000010000300333331033333333333
