003300000000000000000000000000000000300000000000100000000000000000000000000000000000000000000000000000000100000001000000030000000000500000000000000000001000630000000000
003000000000000000000000000000000001000000000010060000000000000010000000000000002300000100000000000000000000000000000000030000000000000000000000000000000000000010000000
000000000000000000000000000000000610001100000006000000010000000000110000000000001033000000020000000001030000000000011000000000000000000000000000000000000000040000000000
000000000000000000000000000000000000010000000000505000000000000000000000000000001100000200001000000000000000004010000000000000000000100103000200000000005000000000030000
000000000000000000000000000000000000000000000000000000100000000003000000000000000000000000000100000000000000000000000000000300000000000000060000000000000000000000000000
011111110011110000000000000000000000000120000200000000000000000001200000000000220000000000000040021202020100311102025200111111030010000000020003000000000001111110002302
000000000000000000000000000000000013333303303331630033333000333333333300000003530333100333333330036332333000005001333330000000000300030333033000000300033300006013333303
000000000000000000000000000000000000100000000000000330000033000130001000000000000003000000000000000000030003100000000300100060000000000000000100000003000000000000000000
000000000000000000000000200000020000030300050000000300000030000000000000500000010000010200000000000000000003003000003000500000006200010001030300201000000000030000000001
000110000000000000000001100000010002000000000000000000000000000030300000000000030000001100500000000000300000000300000000000000001100000000000003000000000120150000001100
000000000000000000000000000000000000000300000000000000000000000000000003006000000300000000000100000000000000000030000000000000000000000300000000000000000000103000100000
000000000000000000000000000000001000000000300000000000000000001000000000000000000000006000000000000000000000000300000000001000000000000002000000000003000300000060000030
020202000000000002002022000002200011001000100110101111110301111100111100020100000000002010000000000000000011116000300000000000002000010001010000000100010106000001210020
333333330033333333333333333333303335000000000030000030000000000000300003033320000000333331300000100000000000000030033330003020333333300000000000000000000033333033333030
