000000000000000000000000000000000000000000000000000000000000000000000000000000000100000000000001000000003000000000000000000000010000000000000000000000000000300000000000
100000000000000000000000003010000000000300050000000000000000000000100031000001000200000003000000000000300100000000000000000000030000000001500000030003000000020000002000
000000000000000000000000000000000020000006000000060000000000000050000100000000006600000100000000000000500000030000010000000001000000000066300000000300000001000000000030
000000000000000000000000000000000000000205000053000000000001000000000000000000006003000000000000000001000000000000000000003000001020063066001000000000000000002000000002
000000000000000000000000000000000000006600000010000000000000600000100030005000000600000003000000000011050030000000000000503000000660000060000000400000000000026000000000
000000000000000000000000000000000000006020000000400000303006600300001000301000006600000000000000000000000051000010000000000000000060000066000030000000000000066000000000
000000000000000000000000000000000003330333000005033333303030333000000033333003033300000000000000000000300333333333333030000300333003330303305000000000000033033330000000
000000000000000000000000000000000000000000000000000000000000000000003000000000004100000300003030000000000000000000000000000000000000000000000100000000000000000000000000
000000000002000000000000000000010310000000001000000002001000000000303000000000000300000020000000001000000300000000000300000000000000010010000000200000000000000000000000
000000000066000000000000000000000000000000500000003066000000000100000000000060000000000660000000300000000000030000000000100000000000000000000006600000000000000001000000
000020000066000000000000000000000000000000000100001066000000000000000000000000000000000660000000000000005000030000000000000000000000000530000006600000000000000000000000
000660000066000000000000000000000000100000000000000166000000000000030000000000000000000660310000000000000000060000300000000000000000000000000106000000000000000000000000
000660000066000000000000000000000000100000000000000006000000000000000000000000000000300000000000002000000000660000010000000000001300000000300006600030001000001000000000
333333333333333333333333333300000003300003100000033333330000000000300033303330030000333333333333330000003000033300000003333303000101000000003303300333033300000003330333
