000000000000000000000000000000000000000000000001000000000000010000000050000000000003400000000000000001000000001000050000000000100000000000000010000000000000000000000000
000000000000000000000000000000030000003001000000000100000000000330003000000000100500300000000010031000000000030000301000000000000000000004000000000000000010000000000501
000000000000000000000000000000660000000000000000000000400066000000000000003000000000000000031000010000000000443000000100066000300000000000006004440000000000060020016000
000000000000000000000000000000660000000150400006100000000066001000000000001000000030000000010000000000000000030000300000066000000010000000000000000000001000000660066000
000500000000000000000000000000000000000100100006000000000050004000000000053000000000000100000000000300000001000000000000066000000000000000000010000030006000000160060301
000000000000000000000000000000060100000000000006000000000063020000000000002000000000000000000000000000000000000000500000066020000000000300000000000006000000000000066020
000000000000000000000000000300533303000330303003333133333033310010000300003000000000000000000000130004000330030310010033533330000015300000003333001003033333333330033330
000000000000000000000000000010000000000000000000000010000000000000300030300000000000000000000000300000000000000000000034000000003000050000000000000000000000000000030000
000000000000000000000000000000000000000000000000000000000000030000100000000000000000000000050000000000000000013000000000000030000000010000000000000000000000000000000000
000444000000020066000000000005600000000000300000000000000000002300344000000000000000000000200000000000030006600000000023010060030446000001000000500010010000000000000100
000000000000660066000000000000000000000003300000000000000100066000000000000000000000001016600000020000000000600000000606000010000000000000000000000000000410000000000000
000000000000660066000000000000000100000000000510000000000000366000000000000000000000000036000010000000000006600000000600000000000000000000000010000000500001000000000030
000000000000660066020000000000000000000000000000000000300000006000000000000000000000000006600000000000000006002000000660000000000000000000000000050030000000000600000000
333333333333333033330000033300000000060000000000000300033330330333333300003330000000333300300003330010000303333003333000000000333333300000000000003000100000504000000000
