000000000000000000000000000000000000000000001041000000010001000000000000000000001000000000000000000000000000000000002000000003000000003000000000000000000500000000000001
000000000000000000000000000000000000055000010000000000005000000550500001000000003000115500100000001000000000120055050000000000000000000200000000100003000000000030000000
000000000000000000000000000000000001110100010000000000000000000000000006000000000033111010000100000000010000000010001000000003050000000001000020000000100050013000000000
000000000000000000000000000100000000000300000000110000000000000000000000000000000030600000000000000000000000000000000100000300000000000000010010030000000000000000010000
000000000000000000000000000000000300301000000000000333030000000000000000000003000003000000000000000000001033333300000003000003000000000000003000030000000030101000000030
000000000000000000000000111100000000300000030300133330001000003000000000000000000003000000000000000000000033300500000000000333000010000000110300333000001000000300001001
000000000000000505000000000001050003030303000000033330000000000313133205000003330303033300300000000005000003000033303330331333000300000300000333033000530100500000000005
000000000000000000000000000000001000010310000000000000000000000000000003000000000003000000000300000000000000000000000000000000000000000000003000000000000000000030000000
000000000000000000050555500000200510000000000000000003003000350000003000000000010030000000000000000001000000205000000000000000100100100000000001000055500000000500000000
000000000000330000041111110003000000000000000003000000000000040000000000000000000000000000002000030100040000000000000000000001000000000000000000000110010300000414000000
000000000000330000000000000000000000000010000003300000000000000000000106000000000000000305030000030400100000000006000002410005003000000000000000000000000000003010000000
033333330000333000000000000030000000150000303001300000003000000000000000003000333300003000030000343000000030000000000000030000000000001133000333300004060330000000000000
033300000003333000000000000030000000300000000133000000003000310000100600000000300000000000000003030300000000100110000001000003000000003130003033000000000030000000000003
333300003333333333333333333331313330000000033333300000003333343000000000000003333000000000001333333330333003300000030103003333630500033330003333000363303333330030000000
