000000000000000000000000000000000000000000003000300000100000000000000000000000502550000010000000000000000000000000000000000050000000000000000000000000000000000000000000
000000000000000000000000000000600000000000000000000200000000000100000000000000000000000000000000300000000000000000000000000030010000000000000300000000100000000000000000
000000000000000000000000000001000000000000100000000000000000000000000000000003000010000000000000000000000010000000030000060110000003000000000000000000001000050000000000
000000000000000000000000000000000000000000000000000000000000000000000000010000000000000000000000000300000000000000000000005000000000010003000000000000001000001000000000
000000000000000000000000000000000000000000000000000006000000000000600000000000000000000003000000000000000000000000000000000000000000000030000000000000000000300000000000
000000000000000000000000000000000000000030001000000000000000000000000000000000000000000001000000000500002020220000011000030000060000000100000000000000000000011000000000
000000000000000000000000000003330300000000333063330000000000000030303300000003031313000000000000003033033333033003033330053030000000000000010000000001000000030003333003
000000000005500000000000000000000000001550000300000020000000000000000000000001000000003000003064000000000000055000000103000000100000030000000001003000055000000001000000
000000000000000000000000000000000000000000000000000000000000000030000000000000000000000000000000000000000000000000000000300000000003000100030003001000000000000000100000
000000000001100000000000000000000000000111000000000000000040000050000000000000000000000000103000030000000000010000000000000000000000000000000000000000001000000000000100
000000000000000000000000000000004000300000000000000000005500000010000000000000000000000000003000060000010000000000000600000300000000030000000000530000000000000000006030
000000000000000000000000000000000000000000000000000000000000010000000000000000000000000000000100000000000000010000000000000000000000000000000000000000050000030400000000
000000000000000000000020220002012000000000000000000000000202200001000005100006000000000000000000000001000000000000010000000000000030002021000000100100000002302000000010
333333333333333333333333333333330303130333000000000000003333030000006033333330000000000000516333330000014033003300000003310333000000030330333303333300330330333330000000
