000200000000000000000000000010001000000000000000000000000000000000030000000000000100100000000000000000000000000000000030001000000000000000000300030000000600000000000000
000000000000000000000000000000030000000000000001000030000000000000000006000000000000000000000010130000010300000000010000000100000000000000000001000000000000000000100000
000000000000000000000000000004000000000000000000033303000000000323330000000030000100000000003333000300500000000030000000000200000001033033003301000000030000000003033000
000000000000000000000000000000000000000000000000000003000000000000000000000000000000000000200003000000000300000033000000000000000000000103003300330000000300000000000300
000050000000000000000000000000000000000500000000000000330000000000003000300000000000000000610003530000000000000000030000000500000000000001300000000004000000000000001330
000033000000000000000001110000010000000330000030000003000020300000033000010000010100000000600033100001100000000000001000300330013000000003300000000000110303000000001330
000000000000000000000000000000000000000000000000133333030000000331330300000000000000133333033330330000000000000000130330000000000100030003330013303000000000001000303341
000000000000000000000000000000000003000000060001000000000002000000000000000000000050000000100000000002000000000000000000000000000001000100500000000000000000000060002000
000000000000000000000000000000000000000100000000000000000000000000000000000100000003000000000060000000001000000060100003000010000000000001000000000050000003000000000000
333330000002003300000000000000500000300030001000000002000300000030000000000000003233330000000002000000000030000000000000000000000000000000001100010000003000002000000000
000030000003333300000000000200000003302000300000000001030000000330000000300020000330330000001003330000100000000000000000030333000000200000000000000000501000003330000000
000033003300000000000000006600000661000000000300003310030000500000000000000660030000300000000001303000000000000003050026333000000000000000660000066000000000300000000500
000033000300000000000000006600300610000000000000000300000000333000000100000060000400000000001300000000300000000000101000030000000000000000010000006000000100300001000300
333333333300000033333333333303003330033333000000003000000000000100333330333133030000001333333300000000000010000000010001330030000000033333300333330000000033300010000003
