000000000030000000030000000000000000000003000333000030300000000000000000000000000000000000000030000000000000000010600000000003000000000030000003330000000030000000000000
100000000033000000000000000300011400003000000000000000000000003001330040000000000002300000200030001000000000010000000005000001000010000033000030000000000104001000000003
000000000000000000000000000000010003000000000000000000000000000000000000000000000036000006000000000001000333006000000000000000600000000000000000000000006000000000000000
000000000000000000000000000002000000400200002000000000200000000300000010000000030063000006600000000000000300000000000000000200000000100300000000000000000600000300000004
020000000000000000000000000000000000000003333300000000100000000000300002000000000066000006060000000200000000000000000300000033020000000000003303003000006000000010030000
100000000000000000000111000001060000000003000000000500001100030000000010000001000166000006600000001000300000000000000000000000111000000000000000000000006100000101110000
000000000000000000000000000033313333300000000000000000000000000100000000020000003303001333300000000002000333303300001000300000000000000000000000000000033130000000000000
000000000000030003330000000000005000003000000000000003000000400000000300000300063330130333000010031000000000001000033300001000100000000000000000003000000000000300000000
000110000000000000000000000200000033003300000000000000000000100030000004000000000000000000000000001000000000000300060001000000000000000015000000000000110000000000000060
333000000000000000000000006600000000000001000000001050010300500001001000000000000000036000000000001000000000000000010003000000000006633300000000300333000000000000000000
000000000002000000000000006600000000000100000005000000060000000000004000000000000030000000000002000000000000000000000000200000100006000000501000200000300000000000003031
000000000000333333000000006600000000000000020000000000660100030000003301000003033000033306000000131000000030000033001000000000000000000000000000030004000000000002200000
000000000000000000000000006610000400000000100000000000660000000000000000060000000100000000000000000003300113000000000001000000000206600000000000000000000000000000000000
333333333000000000000000333300000000000000000000600003333301330330000000000000000003000100033000000000000000000000000000000000100333031003333300000033331300100000001000
