000000000000000000000000000000000000000000000000000000000000000000000000000000000000000000000000000000100000000000000000000000500100000130000000000000000000000001000000
000000000000000000000000000000000000000000010010030003000000000000010000500000000010030000000000000001002000003000000000300000000000000000030000000000000000030000000000
000000000000000000000000000000000000000000000000000000000000000333000000000000003300000003003333300000000000401000000334050005300000000000020000000303333000000000000006
000000000000000000000000000000000000010000000000000000000000000000000006000000000000000033103000003000010100000000031300000000001000000000000010000000000000000000000000
000000000555555050000000055500500030000000000055100000030005505000000000005320000000000300000000000000000000000000301005050000005555300100000055550000000003000020000000
000000000333003000000000033330100000000001000313300000001330000001000000043330000000001000000000000010100000000000000010000000000330000000000030300001000030000000000000
000000000000000000000000000000000000000000010000033303330030006004000300000023303003000000300000030000000333130300060000000000000000300000000000510000000000000003363333
000000000000000000000000000000000000000000000000000000000001100000000000000000000000000000001000000000000000000000000300000300000030000000000000001000000000530000000000
000000000000000000000000000000050000001000000001100000000400000000100000000003003000000003000000004000100000001000030000000000000000000500000000000000000000001000000010
000003333333300000000000000030333300000000000000000500300000033000300000000100000010000000000010000000600000000010000002000100363031000000300000000000000000103330000000
000033000000000000000000000000600001000013001000000303300000300000000003000000600000000000100030000000000000000000000000000000000000100000000000000000000000003300000400
000000000000000000000000000000100000055505000100000000000001000000000000000605050000005004000000001000055205550500000000000555000000000000000000505000000000500000001000
000000000000000000000000000000000000033330000000600010000030000030006000000003000000100000000000000000033001300000000000000333000000110000500000303000000001000000010001
000000000000033333333330303300030030000000330303310000010000000000000033330300000003000100033330330000000041000033000000000000000000033333330130000030303300000100000000
