000000000000000000000000000000000000103000000000030003000000600000000000000000000000000010000000000000000000000000000000000000000000000002000000000000000000000000010000
000000000000000000000000000000000000000000000000000000000000000000000000200000000000000000000000000000001001000000000500000000000000000000500000000000000003000000030050
000000000000000000000000000000000000000006000000000300000600000030000000600000030000000030000030000000010004400000000300000030030001010000000000000100011000000001000100
000000000000000000000000000030000000000000000000000000000000200000000000000304000000010000000000000066000000030000302000030030006300000000000000000006600000005000000000
000000000000000000000000000000000000000000000000000000000006600000100000000000300000000000000000000060000000000000016000000000006000000000006000000006600000066000000000
000000000000000000000000000000000300000000000000000000000006000000000016000000000300000310000050030011000000060000066100000000001000000000300000000000100000306000000000
000000000000000000000000000003001000000030000000000050003033333100000000300000000000000000000000003300333333333333233330000030303033310333330000000303031333330333000333
000000000000000000000000000001000000000000001000000000000000000000030000003000000000000000002000000000300000003000000000000000100000000000000000000060000000000000000000
000005000000000000000000000000010000000003000005001060000000000000000000000000000550000000000130000000050000000000000300000000000000000000060000000000030000000000000000
100000000000000002110444400044400000302110100000000000004444300000000000020100000000000000000603001000000001000000000000100000444400000000000000000000000000000204044000
000000000002000066000000000000000000060000000000100002030000010000000000160020000500000000000302000000000001000301000000000000000000000000000000000000000000003000000000
000000000066000066000000000000000030066630000300000066103000000000000000660000000000010000000036000000000000000000000001000010000000000000000000000000000030000006000000
000000000066000011000000000000000000001003000030000066060000001001001000111000000000305000000006000000000003000100000000000060000030050000300000300005000000000000000000
333333333333333333333333333333333333313333303333303330330330330030010033313033303336000000033333330333203000000000000000000006303333300000000000001010000003300003033333
