000000000000000000000000000000000000320000000001000000030000000000000000000000000000000000000000000000000000100030000000000000000000003000000000000001000000001000001000
000000000000000000000000000000003000000000001030000000000000000000000000000300000001000000000000000000000000000000000000000000000000000000000000100000000100010000001000
000000000000000000000000000000020000000000000400000110000002000000030300000030000000000000000003000000020030410000000000000000000000000000000000000300000000041000002000
000000000000000000000000000000606000000010000000000000000060000000000000010100000000000060000000000066000000000000100000000000000000003000000000300000010030000000066000
000000000000000000000000000000660000000000000000000000000066000000000000000000300000000000000660000066000010000000560010000030000000000000010000000006000000000000066030
000000000000111100000000000000000000000011020000003000000066300000000000000000100000000000000003000166000000000003660001000010110000000000010000000006100012000000066000
000000000000000000000000000033033000000000363313310303033033303000000030000000000000000000000000003333033331333333330030005000000000000000000000000303330033030000301333
000000000000000000000000000000000000000000000000000000000000000000040300000000000000000000000000000000010000000000000000000000100041003000100000000100003000000001000000
000000000000000000000000000000000000000000000000000000000000000000000000000100000000000000010000000000010000000000000000000001000030000000000500000000000000001000000000
000410000000000011000000200000000000000000001300000003000000000011000000000000004100000010000110030000000000001000000000011000300200000001000000000000000000110000000000
000000000000000000000006600000000000000500036000300000000000000000000000000000000000000003000001000000000000000000003000000000000600000000000000000000000300000000000100
000000000660000000000006600000000000000000000100050603000000300000000000060000000000000000000000000066000000000001000000100000106600000000000000003000001000000000010000
020000000660000000000006600000000006000000000000000060000010000000000013663000000000110000000003000006000000000030003000000000006610000500000000050000006060000001100005
333333333333030333333333333305000000000000060000033303030000000033303033333033333333000000103033333303303000000000000000333033303331303433030000000040000103303130000000
