000000000000000000000000000000030300000000000000020000000003000000060000000000000003100000000000000603000001000600003000000000000000000000000000010000000130000100200000
000000000000000000000000000000000010000000000000000000000000000000000100000000000000000000000000000000000000000000000010030300000000000001000000000000000000000500000000
511011131000000000000000000000300001000000000000030003000000050000001003330033100000010000000000000001000000000000000300003003000000011000000000001300000050101010000000
000000000000000000000000000000000000000010051006000000000003000000000200000020000000000000200000000000000000000200006001000003000000000000000050002000000000003000000000
000000000000000000000000000000000000030060001000000000000001001010006633000660000003330006600006000000000000006600000300300066000000000000000000066000010000000060000000
000000000000000000000000000000030040000036300000130000000004000020036003300660000010333006600000000000010060306600000001330006003000000000300240000000000000000100050000
000000000000000000000000000033333030303333110000000000000000000333331331333330000000033333300000003503333333333000000003033633303313333333333333333000000000000000000400
000000000000000000000000000000000000000000000000000001000000300000001000000001002040010000000000050000000000000000000600340000053000000003000000000000000000000000000000
000000000000000000000000000000004000000000000000000000000000000000000000000000000000000000000000000000100000500001000000000000000000000000000000000000000050000001000002
000000000000000000000110000000000005110111000000000000605110101010000111000000000000510311131010300000000110000000000000000000300000051101110100000000000000000001000100
000000200000020000000000000001000020000030000000000600020000000000000010000000000000000000000000000000000000000000000000000010000000000000000000002000000010000000000000
330006600000660000000000000000001600000000000300030000060000000030063000000000000000000000030000060000000050000000000000000066000000000000000300166000000000000000000005
333006602000660000000000000000000660000010000000003300660000000010000100000003000000000000031000000000000000003000000000000066000100000000003300066000000000000000000000
333333333333333333333333333303303330000030004001033333300000000003000030330303333300000000000000000000000333336300600500303333000000000000003303303333303300000103033303
