000000000000000000000000000000000000000000000030000000000000000000031000500000010000000000003200000000000000000000000000000000000000000000000000010000000000000000000000
000000000000000000000000000000010000000000000000300000550000055000000000000000000000000001000000000000000000000000000000000000000000000000300000600004000060000000000000
000000000000111110111111111100030010004011110011130000000000000000000100000110000000000030000011111100000011030100300001110011000601103011110000000110010011100000000000
000000000000111110101111100000000000110051311000030000000000000000005000000110000000000000000112010111110101000000000001111000000001100111110000000001000111011110001000
000001000000111111111111100100000000000010111010100000000011030000000000000110030310000001001101111111000111111100000001101001000301001111010000000111116111110000000010
000000000000111111111111110000000000000011101110100011000000000000000001000100000000000000100111010130131011010103100001101100006000103101610001000110111101111110300300
000000000000000000000000000033333000000030000000003033336330330333330000000000000000000001030100033000333000000001003000000000006030000000133333000010100032303030000060
000000000000000000000000000000000000000200000000001000000000000002000000000003000000000000000000000010000000000010000000000000403000000000000000000003100006000000000000
000005500000000000000000000000000030000100000000000061000000000000000000005000000000001050000000000000000000005500000554050000003000000000000000010000010000030000001050
000000000000010001111111100011110011000000000101000001000001111101103011001110100200000001101010010000011000000000000001111003121011100000050001101000601111011110000000
000000000000000011111111111111100001311010001100100000000001101110101111100001011000000001111110000000000000000000000001111111101010000000000011101000001131410001000000
000000000000000111111111110011010011110000010111100000100111011111110011141110156001000201111100010000000000000000000001101100111110130000000111111000001111210010000000
000000000000000011111111111110101001011111001101130003500000101031111101101101111000000001111011300000500000001000000001311011111111000000000101111000000110011300000000
033333333333003000003333333300000003333330000003300000001000003330353300000000010000000000000200003301000013330303333333333333000000033030003000303000000000000604333333
