000000000000000000000000000000000000030000033000000000000000100000000000000005000000000000000001000000000000000000000000000000000000000000030000010000200000000000001000
000000000000000000000000000000400100000000000000000000000110000000000000004000000000000010000000000000000000000000103600030000000000000100000000500004000000003000030000
000000000000000000000000000000005000004000001100000000000000000000001000010000000000000000000002000100000000610000000000300005000000000002000000230000000000000300330005
000000000000000000000000000000066000000000300230000300003000003000660000000000100000000000600006000300000000000000000003330000000000001066000006000010000000000000330000
000000000000000000000000000000306000100001010000000000000100000000600000000001000000000000000000000000100300000300000000300000000000000000000006600000000000000000310000
000000000000000000000000000001004000000000000003300000003000000000600000000003000000000000050006006000000000000010100003302003300000000036302001600000000000000001330040
000000000000000000000000000033003333000000330333003000000000000033333300000000000010000000333333030000000000000000010002300333000050033035033303333000000000000003330303
000000050000000000000000000000001000000000500000000000000000000500000030100000003000060010000000045003000000000000004000300000501000000030000000300000001050010000000000
000000000000000000000003000000100000030000000500000000000000000000010000300040000000003000000001000000000000000030000000000300000000000000600001000000000000000000000001
000020000000000000000033000503000000331005000000001000000000000000000003300350000300033000300033000000000000010000000000100001000003000000000000000000031000000000100103
000660000020000002000333000000000053360001000200000000000001000000000033300000000100303010000020000000000000060000020001000000000230500000000002000000000000000000000000
000660000000000000033333000000000003530000000000300000000000000000000533300000000033331300000000010000000000000000100030000000000000001600000000033000000000000003000000
000660000000000000033333000000000033330000000001000000000000000000000033000000010033330001000000330000000000003000000330000300103000000000000000033000000030000000000000
333333333333333333333333033300000003330330333333300100100000000303330033303330333003133033333363033303303000000033333030001000033333300000003333033100060033303330000130
