000000000000000000000000000000000000000000000000010000000300000000000000000000000000000000050000000000010000000000000004000051000000100000000000500000001000000000000000
000000000000000000000000000000000300000002000010000010000000000000001000000000000000000000000030100000030000000033110100000000000000006000000000000010000000000000000000
000000000000000000000000000000000000002000000010000000020010003000000003060000000000000000000000050000000000000000000000000000033000010600010000000000000000000000000000
000000000000000000000000000000010331000000000000000000000300000000030130000000000000000000000000000006030000006630000000050000000033000000000000016000000600003330000000
000000000000000000000000000000003000000000006000000000160033303000000000000000000000100000000010000006100003006600100000000000000030000000000060000000006303003000300000
000000000000000000000000000000333300000010000200000000660030010000033000000010000000000020100000000000000000000605000303400003000033000000000000300000106000003600300000
000000000000000000000000000033330000000000000000003331033003333330330000010000300101000000000000000010000333013300333330000500333330000000000000000333333333303000000000
030000000000000000000000000000000000000000530002000000300000000000000000000000000060000000000000000000000000000000000000000000300000013000000000003000000000000003000000
000000000000003311110000000000100050000000000000033111100000000503000000000003011111000000000300000000000331010000000000000000000000030000000050000301101001000400000000
000000000000000000000000000200000303000330000000003000000000130000031000000000000060100000000001310000000000000000000000300000000000200000000000000000000000000000000000
000000000003333000000000006600000000100010005000030000000040003000006600000003000000000000050000000000033300000030000000000100000006600003001000000300000000000000000130
003000000003000000000000006600000000000000003000000000000003000100000600300000010000000000000300000000300000000303000000000000000066600300030330003300000050000000000010
003000000003300000000000006600000000006001013000000000000000000000000300000000003000000000000300000000300000000000100000000000000000600300000000000000000000000000053000
300333333333000033333333333300000000300000301333100103330000000303333001000003033033000000030033333310300000333000000000000004333333000033360003033000033301020000000000
