000000000000000000000000000000300000000000000000000000000010000000000000000000000000000000000000000050000001000000000006000103000000000000000011000000000000000330000030
000000000000000000000000000000000003000000051000000000000000000000100030000300000000000000000000005005001000000201000000400003000000000000000000000000100000000360302000
000000000000000000000000000000000003000050000000100030000000000035000030000500000000100000000000003000050000000003000300003033000000010000100000000000000000000030000000
000000000000000000000000000000000003000000100051000003000000000000000030000000005000000000000004000000000000000000000000000330000000000600000000000000000000003330000000
000000000000000000000000000000003003000000000100003000000000000000000011000000000000000000001000301000030000000000600000003333000000000000000000000000000000003310000000
000000000000000000000000000000000030000000000100000022000002200000000033001000006000000220000000003050020034000000000000031303000200000000000000100000000000013330000100
000000000000000000000000000003033333300033000000033330333333333333333303003300010300353300333303333303303000000003330103333332313303300000000000300000000030030030000000
000000000000000000003000000000000330000000000000000000000000003000000000000000000000000030000003000003003000000000010000001000000000000000000000000600000000000000000000
000000000000000000033300000000000330000000030000000100000000030000006003000000001000306000000000600000033000000030010000000000011000000000303000000000000000003100000000
000000000000000000033300005000060030000000100000000000000000033100000000000000000000000000000000010010033000000001000103000050000000000000003000050305001000000000040000
000000000000000000333300000000003030000003000000000000000015103000000040400001000000000000000000000020033000000000000003000050000000000003001000000030010001000000000300
000000000000000003333300003000033300000000000000001000000033333000000200000000003000000000000010006003363000000000000000000130300000001010003010030000000000000010000100
000000000022000033333300003000303330010500000000000000000030033000000000000000000000000000000000000030033000000006000003000030000000000000003000030005200001000000000000
333333333333333333333330333303330330000001000500003000000333330000000100011010003000000000000603003303300000000000000103000333001000000000003300401303313300000000033330
