000000000000000000000000000010030000000000000100006000000000000000000000000010000001000040000000000030000000000000000000000000001000000000000001100000000000000010030000
000000000000000000000000003030000300000000000000100000000000000000000000000000010000000000000050000360500000003000000300000000000100000000000001030200001000000000000000
000000000000000000000000000030000000030000000000200000000000002006000000000000000000000405000000000000000000000106000000000000000000000000001005000000000010044400000000
000000000000000000000000000000000000000000000006600000000000030000000000000000000030000000000020000300030000100010001000000000000006000000600001000000000000000000000030
000000000000000000000000000000000000000000060006603000030030066000000000000000000000000006603665000000000000005000000000300000000006600000300000000010001000002663000000
000000000000000000000000000010000000000000000300610000000000006200000000000000600000000003100600000000000000000030000003000000000006600000000020000000000000000660000000
000000000000000000000000000000000003000000031033300040013160333000000000000000001000300333333303000005000000000000000000000100303303300000000000000004000030330030000000
000000000000000000000000000000000000100000000060000000000000100000000000000000030000000000000000000000000000000000000000000300000000000000000000000000000000000000000000
000000000000000000000000000000000000000000000001001000000010000000000000000000000030000000000000000000030000000000000030100000000001000000000000000300000030000000000000
000444000000020000000000000000000000000010000444000000000004440000003000000000000000000000000000026003000003503000030000004000000000000003000000000000000200500000201000
000000000000660002000000000000000000002000000001000020000000100000200010000000100002000000030000660300000000000000000600000000301010000000003000000000006600020000000000
000006600000660066000000000000000000060000000006000000000600066006600000130000000000630000050000660000000000000030010000000066006633000000300012000000000000000000000000
002006600000660066020000000000000000060020002306600000000020066006612000010000000000000010000000600000300000000000000000020006000602000010003001000000006600003000000000
333333333333333333330000000010000350300330301313300030003033353333333000000000000000000000003303330030000000004000000000333303133333000000000000000333333330303330000300
