300000000000000000000000000000000000300000300000000000000000000010030000000000000000000000000100500000003000300000000000000000001000003000000000010000000000000003000000
000000000000000000000000000000005010000000301100100010000000000000000000010010000000000030000000000004000110000000000000030000200000000000000000000000000040100000000000
000000000000000000000000000000001000010600000000300111100060000000000150030000101010000100000000000101110000000000100003000000000010000000000000000000010000000000060000
000000000000000000000000000000000000003000000000000000000000000000300000000010000010000000000030000000000000200500000000001000000000100000000050000000000000030000000000
000000000000000000000000000000000000003000100000000000200300000001000000000000000000030000000030000000000000600300000000000000000330003004030000000000000000003001003010
000000014141100000000000000000003000003003000000000000000000000005000000300000000000000050000003000000000202200000000000404000000000000000000000000040401000003000000000
000000000000000000000000000030331333333313000000030003330000000000000013331333501333000000033000033300333033133303133130000000303333000000003133333000010033033330001000
000000000000000000000000000000000000000010000000001000000000000000000000001000000000000000000000003000060000005000030000000000000000030306001000000000000000100060000000
000000000000000000001110000000000000100000000000000060000000000000000000000031100036000000100000003000000000000010010000000000001000000601001100000000303000003000000000
000000001111100000000000000000000000000000000000100013000000000000000030000005000000000000000000000000000000000000000000000360011011000000001000100000000001110130000000
000300000000000000000000200001000000002000000003000000000000020000300000000000002001000300000001003000300000000000020000000000000000000000000302000000000440000000000000
000330000000000000000000000000000600000000000300000000000000010000333000000030000000000000000000000000500040000000300000000000000000000000110000001000300000000000000000
000330000000000000000202200001000002022000040411000000000000020600330014101302002000000000000060001000000041400020120000000000003100000000001022001000000000001300000000
333333333003333333333333333300000000033330100000000001000004000333033300600033303033030333130000000030000000000003333300000000030033300100003303303000000033000530000000
