000000000000000000000000000000010000000000100000000000000000000001000000003000000000000000000003000000000000001000030000000000001000000030100000000000000000010000000000
000100000000000000000000000000006010000000000100000000000000600050000000000000000000000000000002000000000000001000010000000000000000000000000000000001000010003000001030
000000000000000000000000000000000000103003100000000000000000000000000300000000000000000000000000000003303000000000000004000000000000300000000001000030030000000000300000
000000000000000000000000000000000000000000030000000000000000000000000000000000000030000000000100300000000010000030000000000030040000000060100000000000100000100300000000
000000000000000000000000000000000000010000000000000000000000000000000000000000000001000000000000000000000000000040013010000000000000000000000000000030000000000000000000
000000011110000000000000000000000000000100115000000002000000202000000000011000000030101101300000000000000000202000000000000010000000030000000000000002202000000000000000
000000000000000000000000000000000003000033000000033033333033033000010000040003300333000000035003333001030303330000000003033333000600000000000000000003333333333310000033
000000000000000000000000000000000000000000000000000000000000000000000000000300010000063000000000000100000000000001001000010003000000000110000000000000000001100000000000
000000000000000000000000000000000000000000000000000000000000000000100000000000001000300100000000005000000003000000000000000000000000000000000003000003000000003000000000
000000003033000000000000000000000000001000000000010000000303000100000001000010000010000000000030030000000000000500033001300100000000000000030030050000000000000000000000
000003000000000000000000000000000000000000000160000000000000000000000000003000000000001005000000000000000010000000000000004000000000000000000000020001006003000000000000
000000000000000000000000000000000000000000000000000000000003500000000000005000000000000000000000000000000000000000000000000000000000300000000006000000000100000000000000
000000000000000022020000020200000000000030002000000000000000000000001011113000022000000000000032031050000000000000000000000202002200001000001111000000010000000000000232
333333330000333333333333333313330330100000303333300000000003030000000000000003300033030000033333330000000000000030000333333330333330300000030000000000000000000000303330
