300000000000000000000000000000001000000000100000103000002000000000000000000100000000003000000000000030000300002000001000000000000000030000000000000330000010000000000050
300000000030000000000000000000000000000000000000000000000000000000330001000000300003100000000000010000003300010000000000010000300000033000002001130000000000002000000000
000000000000000000000000000033330000600000000000000000025600030000140060000420050000030000000000006600000000000000000000003000660010000000000001000000001000000000000002
000000000000000000000000000000000106000030000000000000666600000000000000000660000000100000000000006300000000000006000600000000610040000001100030000000000000000000000066
000000000000000000000000000000000030300000000000000000660603000040000100000060000001010000000000006000000005000600003000003330660000300003000030000010000000000000003666
014444000000000000000000000000000303300000000000000001663300000000000000000660000030000000005001003000000014044000000660003300030000000444400000100003000003001000000060
000000000000000000000000000003303300000000100000000330330000000100030000303330000000003000000000000000001000000000333333330000000000000301100000030000100000000000033350
000000000000000000000000000000000000003000000000000000000000000000000000100100031300000000000000040000000000000000000000000000000000000000035000000100000000000000001000
000002000000000000000000000000010000100000300000000000000000000003000030000003100020000000000000200000000000300000000200000000300000000000000000000000040030000000000020
333300000000006600000000000220000000000030000000000000000000000000000000000003330000000100033032000000000000000033300000000010000000000000000000000601000000000003033300
000000000000006600000000006600000000000000000000000000000000000040000000000000000000000000000000000000000000000000030000000000000000003000050000000600000100300031000030
000000000033306600000000006600000000003330500000000000000000000000330000000000000000002333010000000000066012000000305000000000030000000000000000330630000000000000000004
000000000033003300000000006600000000003300314140000000000000000000330001444400000000000330000000000000066300000000060000000300000000000000000003303030000001054400000000
333333333330000000000003333300001003303000000000030000010000000333300000000003333533331300000033300030300100000000333330000000010000000005003103000030000000000000303333
