000000000000000000000000000000030000000000000000000000000000000000000000000000000000000000000000000000000000000001000000000000000000000300000000000000000000003000000000
000000000000000000003000000000000003305550000000100055000000000000001030555000000033001000003505000050500000100000000000000003305505000000003000000030000300550030010000
000000000000000000000000000000033300300000000030000000000000000000033300000000000000000003000000000000000000000000033300001000300000000000000000000000333000001001000000
000000000000000000000000000000000000000300000040000061000000000000000000500000030000000000000000000020000000001000000000000000033000000000000000000000000000000000000000
000000000000000000000000000000000000000030000000000000001000301000000000000000000000005000000000000000006000000300010030300010000000005000000000000000001100000000000000
000000000000035000000000044303000000000000000000000000000000000000000000000105000000003000000000000000000500000300030001000000000000000000100000403000000000500000000000
255000000000000000000000000003000333333003200500033330010000100330000333030035000030255000033134000053333000000033300330000000333300333300010000010030000033333333330003
000000000000000000000000000000000000000000000000000000000500000000000000001000000000000000000100000000000000000000000100000000000000000000010000006000000000000000000000
000000000555533355550000000000000000000000000000000003030000000005505303000000000000003000000001000000000000010000000000010000000535300000000000003000000000000000355050
000000000000000000000000333000040000300110006000030000000000000030000000003000000000000030000000000000000060333002000000001000000010000000000000030000000000000000000030
000000000000000000000000000000000100000010000000000000003000000000000000000000000000010000000100000000000300000006000000000001000000000000100000000000000000000000000000
000000000000000000000000000000000000000010000000000000000000000000000000000060000100000000000000000050000000303000000001000010000031000010000000000000000000000000000000
000000000000000000000000000000004430000000000000350300000000000000000000030000000043000044300000100000013000000000004430000003000000000000005000000000000000000000110000
333000333333333333003333003300000003330003000000000010000036003333333325500000301000000000003300030000000303603300000010001000013333305500060000000205000000000000330003
