000000000000000000000000000000000000000000030000000500500500000000000000001000001010000000010004000000000000005000030000000100000000000000000000650000000100000000000001
000000000000000000000000000000000000000001010300000000000000110000000030030003000000000000030000300000003100000000030000000000000010001000000000000000000010300000000000
000000000000000000000000000000000000000001000030010011100000000003000010000100000050000000000300003000001100011000050000001600000010000000010001110000000000000010000000
000000000000000000000000000000000000000000000000000000000000000000000000000000300000000000000000000000000601000000000000001000000000000000000000000003000000000000000000
000000000000000000000000000000000101003000000000101000000000000020003000000000000000000000000000000000010100000000000000000000010000000000000000000500300000003100000003
000011111111100000000000000010000000030000000000000300000000003030011100000001110110000000000100110000000010000000003001111110000010100330300000000113111000030000000000
000000000000000000000000000000100003130000333333000003300000000003100010003300000300333030300000003333310000033000000000000000003000033033000000033000000003300000000000
000000000000500000000000000000000000000000000000000010000000000000000010000500000000000000000000400000000000000200030000000000000000000000000000000000000000000000000000
000000000000000000000000000030000000000000000000000000000030020000000000000015000000000000000000000000010000300000001000000000600000000000000000000000000000503000003000
000000110011100000000000000000000030000000000000000000000010100001000000000000600000010000000000000000004000000010031100000010300000000100003100000000206000050000000000
000000000000000000000000000000000000000000000100000004000000000000300000000000600000000600000060000020030000000000001010000030001000000000000000000000000000000000001010
000000000000000000000000000000000000000000000000000000000000000000000000003000000100000000000016000000000000000000000000000000013000000000000000000003000000030000000000
000000000000000000000222000016011501220000000001000001000000000000010022000000000010000000022200000111010000301006000000000000002010000003000006040000000000006112320000
333330000003333333333333333300000003333333000100000000003333300033333333310300000400000000033303330000000003000000013330000000333333303333330000000330313300000000333235
