000000000000000000000000000030000000000000010000000000000300010000003000000000000000030000000000000033000000000000000000000010000000500001000000000001000000000000000000
000000000000000000000000000000303100050000000000003000000005000000040002000000000000000000000000030000000000000000000000100000000005000000010000030001000002300000000000
000000000000000000001110111100600000000000111100001000000000000000000060000111101000101000300000030000000000000011011110033000360001100000000600001111100000010110000000
000000000000000000001111110000000005000000000000100000000000300000000066000600000000000300300000000330050000000411011000000000663030600000006600003000000001111300000100
000000000000000000001111110100300000000052010000000030000000000000000066004000100000011000000000000000000000000000111010000000060000100000006600000010000011111010050000
000000000000101001001111111100003100030000000000000000000000000030000056000550000600000010000000000000000000001011110110005010060005500000006600055001000011100010000040
000000000000000000000000000000002303300000003303033303333300101000000003000000003330003033031103330000000000000000000000000030300003133333330300033053333600000003333330
000000000000000000000000000000000050000000130000000000000000000000005000000000000000000000000600103000000000050010000000000000000000000000000000400011001000000000000003
000000000000000200050000000000000100200000000000000000020000000000000010000003000000063005000000000050000000000000000001000000000050300000500000000000000000000130000000
000000000000006600011111110000000500600011000000111010110000000000000000000000101111630000100000001101111000300510300000000000111100000100010000301000000001000000000000
000000000000006600000000000000000006600000050000110111000000000000000100000000111000630000000003063111000000000100000000010000000000001000010000001530501100000001003000
000000000000006600000010000000000006600000000000101331010000000000000001500011151000600000000000000300111000000100000000000110010000000000000000001300030000100400000000
000000000000006600055000000000000006600055100100101111130000010100005310000011001110660005000000001111111000100100000000005000000000010010101201001100000000000000000000
333333333000003300033003333000500000300033000000000000000333033000000000000000000000300003333000000005000000000033000000000000003303000300000000000000000130000003000031
