000000000000000000000000000000000005000000000000000010100050000000000600000000600000000000100000000000030000000000000000010000010000030000000000000000010300000000000000
000000000000000000000000000002000304000000003000300000000000000000000000000000200000000000002005000000000000050000001000000001010001002000010000010006000000000000000000
000000000000000000000000000066000000000000000000000005300010000000000000303306600000000000061000304000000000000050600000004300000010006000000000000000000000000000000500
000000000000000000000000000006010000000000000000000000000000010000020000000000600000003000066000030600000010000600000000000000000000066000000000000000000000000000000000
000000000000000000000000000040000000000000000000000005000000640000000000003000601000000000066000000000000001000000100000000006001000006010000000000000000000300000000000
000000000000000000000000000066003000000000000002010300000010000020000000000006600000000000066000000000020220000003000002000000031000066000000000000000000000001002000000
000000000000000000000000000033303000000000000000003033300000000333330300000003333300010000003013003030303303330300000003333333000000030333010000004000000000000030300333
000000000000000000000000000000000000060000000100000000000000000000000000000000000000000000000000000000050000000000000003000000113000000000053000000400010010300000030000
000000000000000000000020000000010000000300003000000000000000000000000300000000010000001000000000000000000010000000000000000003000100000001100230030000000000004000000300
400000000005000000000660000053000003000000000000040000000000010003051000030000000003000300000000000000000000040000000000000000000000500001006600000400000000000000000000
000000000000000000000660000000000000000000000000030000000040000000000000000000000000000200000000000000000000000000000000300000000000110001006000000000030000000000000000
000000000000000000000660000000000000000000000000000000000000000000000000000003000000000000000001000000100000000000000000000000000000000000006600000000000000000000001000
000022020000002200000660000000010012033000000000000002000000210200000000000000000000050000021000000000000000030022000000000003000000000030006600000000023030000002260000
333333333333333333303333330000000000030003000000033233331333030003333300000000100000000000103333000000020000500333433000000300030000033333330333300333030300000003033103
