000000000000000000000000000000000000002003000000003000000000000000000000000000000003000000031000000302100000000000000000000400000000000100000000100000000010000003000000
000000000000000000000000000000006000003000003000000000000000000000010000000000003003000000000040000000003000000000030000000000000001000001000000000000003000000000000100
000000000000000000000000000000000000000003000000000000000040030000000000000100333003004030000000000030000000000000000003040000000000000000000000000000000000010000060000
000000000000000000000000000000030603030003000000000000050000000000000000000003033030000000000300013030003000000000000660000000000000000000000000000000000000010660000101
000000000000000000000000000000000003303003000000000000000000030000000000000303030003000003300000003333000000000000000660000033000100000001000010000000000000000600000033
000000000000000000000000000303020503333003000002000000030022000000000000000133313003002203310000000033003000000300060660002030000000001000030000000004000000020660120033
000000000000000000000000003333333003300033000000000000103033033000000000000303000033333333104000003300033000003333033333030303000000300000330000000000000030303103333303
000000000000000000000000200300000000006000000000000000000100000000000000000000000000000000000000000000000000000000000030000000000000000000030000000000000000000000200000
000000000000000000000000300300000000100000000000000000000001000000000000000000000003000003000000003000010000000000000000100000000000000030100003403300000000000600000000
000444000000020040000033300300000000000010000444050000000004040300000000000000000002000000500000050000000000441000000000000000001444003331030333003600010000044000000000
000000000000660000000333300300000000000000000030000000000000000000000100100000000066000000000000660000001300000000000003000000000000133330003063000035000001000000010000
000000000000660000033333300300000330000000000000000000000001000000006000000000000066000000200003663000000000000000000000000060000000533301003333103000001000000000000000
000000000020660022033333300330220030000033000000000000000010000000000000001000002066000000000020000000060000000005000000030000000000031330033233000000000000000000030003
333333333333333333333330003333030130004033333003300000003303323000000000006003333030000000003033300000000333330300000000000000003303333000330300033000605333333530000033
