000000000000000000000000000000501330000000000000000000000040000000060000010000000300000000000000003000000300001010000300000000000010000000000000001000000000000000000500
000000000000000000000000000000000300000000000000501031003000000000000000000000000033100000110000050000101500000050000000000000000000001000005000000100000000010004000000
000000000000000000000000000000333030000300000000000000000000000000000000000001003333000001000000000000000000000000000000000000001000000030000000000000000000000000000000
000000000000000000000000000003063313000000000000000000031030000000000000000001333333300000000000003000003000000000001000000000000000000000051000000000010003000300000000
000000000000000000000000000003333300000000033000000000000000000000000000000003335033000000000100000000000000000000000000000000000000000000000100000300000000000000000000
000000000000000000000000000303303333000630020000000000100400000000001040500000303330100030002000000000000021000000004000100000000600000000000000000000000000000000000000
000000000000000000000000003330333333130003030030000000000000030000000030333333003333001000033303000000000003333500333330000002030001000300000003330333330300000000000000
000000000000000000000000033300000000000000000000000010003000000001000000000000100000000050000000000000030000000000003300000000000000000030000000000000000000000000000330
000000000000055000000000033300001000000000000000000000005000000001000000030000000005060030310000010000000000003100100330000000000000500000061100400001000500005000000033
000000000000000000000003333300000001000030030010030000050001000000000000060010000005003333300000000010000000000003300330000000000000010000000000000000000010000000033330
000000000000000000000033333300000400001000000100000000000000000000003000000000000000033033330000000000000000000003330130000500055000000000000000000000000000000000300330
000000000000000000000333333300000000000000000000000000130000000003000030000000003000330313000000000000000000000301333330000001310000006003000000000000031000000003333333
000000002000000000000033333300000400000000060400300000000000000000000303300000200000033033000000030000000000000003333330000000020000010000000003013020000000000005303303
333333333303000033333303333300000000000000000003130353300030330000003330000003330100306333300300303333333000000330333330000033333330000333330000003333030000006003000033
