000000000000000000000000000000001000000000000300000000000010000000000000000000003000000000300000000003000000000000000060000000000000000000010000100000001000000000000000
000000000000000000000000000000000005001000013300000100000001000000000000061000003000000000000000000010000000000000000005001000003000000000000000000000000000000200000000
000000000000000000000000000000030000000000003000000000510000000000000000000000033000000001000000000000000200000000000000000030000030000010010000000000000000000010000000
000000000000000000000000000000000000000000330333000040060002130000000000000001003036000000003036000000000000000000020000000000000000000030000000000000100000000000000000
000000000000000000000000000000000033000003034303300330030000000000000000000003030003000000000000020000003000000001200030000003400000000000000000000002000030000000000000
000000000000000000000000000000010000000033300303300001030003000000000000000003000636000000000000000000033000000000030000000033000000000000300004000001300000000000001010
000000000000000000000000000000000000130333333303300000013333333100000000330033333330330000300300003330363000030033330333403303333333300000003310330330353000000000000040
000000000000000000000000300000000000000002000000000000000000000000000000100000000003000000000000030003000000000000000000500000000000011030000000000000000000000000063600
000000000000005000000003300000000000000000000000000000000001000000000000000000000000000000030000000033000000000000000000000000000000030330005000003000000000000000033000
000000000000000000000003300060000000030000000600000000000000000000000000101000000003000000030000000000000000000000300006000000000000000000000000005004000000000000033100
000000000020000000000333303000000000610000000000000310000000000000000000000030000000000000000020013030000000000010000000001000000001033330300000000000000000000003330030
000000000200000000003333303300100010000000000000000012000030000000000300060000000000000000000200003003033000000000000030040000000000031330330000003003000000000003033033
000000000030000000033300333300000000000000000000000030300000030002003300000000500000100000000330013003303000030000005000001000000002033103230010233000000000000000003033
333333333333333333333333333300001030033333010300053304330066010000330300000010000030110000033333103033303000100000000000000600000000033133333033033010000001000000030033
