000000000000000000000000000000500000000000000000000000010000000300000000000000000000000000000000001000600000000000000000000010000000000000002001000000000030300000300000
000000000000000000000000000000000000000000000020000000000002000010000000000000000010000000000002000000000000000000032000000000000000000000000000000000100000000000000001
000000000000000000000000000000000060000000000600000000000066005000000000010300000000000000000006000000004030010010066033000000000000000000001000000000000410000000000001
000000000000000000000000000000000000000100010630001000000006000000000000000060110000000000000066000000000000060000061000000010000000000000000000000000000100000000000000
000000000000000000000000000000003003060000000000010000000066000000000000000000010000000000000366000000040000000000036000000003000000000000000000000000000000000000000000
000000000010000000000000000000230100000050000010000003000066000000000000030000000300000001000006000000000000000000006000000000002002000000000000000000063000000000000000
000000000000000000000000000033333330000300333633300000003303330000000001000000000001333330330303303050333000000030330030000100333333300000000000000303316300000000000000
000000000000000000000000000000000500650000000000100100000000000000003000041000000010000000000000003000000000003000600000000000010300000000000000003000000300000000000000
000020000000000002000000000050000030000000000000005000000000000000020000000000000000000200000000030000000000000000000003000000000060100020000600000000100000000000000200
000660000000000066000000000450000000000000006000001000000001400050600000000040000300006600000300000000000000003000000000050000000000000060300000000000600000000010006601
000660000000000066000000000000003300000000006600000000001000000000660000000000010000003600000000000000001000000001000000000000001000003060000000000006600100100030006600
000660000000000066000000000030000000000000006600000000001100000000360000000000000000006610000030000000002000000000000000000000000000000060000030000006600000000300000600
000660000200200066000000000000000000001000306605000000000000000000060000003000020020006600000003000101060006000000100000003000500000000060000100000006600000206200006600
333333333333333333333303333300000300000000033333330310330000503333333310300330330303303333000000000000000000000400000003033333000000033330330030000333333033303320100333
