000000000030000000000000000000000000000000000000000000000000300000003000000000000000000000000000100003600000000000000000000000000302000000000000000000000000000000060000
303400000030000000000000000000000000000000300400000000303300000000000000000000000000103400000030000003000600000003050001000000000300000000000000000130000000300000602000
000000000000000000000000000000300000000000000000000005330200000000000000000333300000300000000000000030300000030000000000000031000000030000003300000500000103000000000000
000000000000000000000000000000000000000000000000000005000000000000000000000000000010000100000000000000100000000000000000001100000000000010003000000003000063000000000300
002000000000000000000000000000000000303000002100000000000000001000000000000503000000000000000000000010000000000000000010000000000000000000003010000000000010020000000001
200000000000000000000000000000000000030000200000000000002000000000000000000003000000010300000000000005000000000060000005050000000000000000003000000000001000000000000000
300000000000000000000000000030033330330300300000100033313000000333033300100300300000300000003330330000000000000003303000003333000000000050000000000010000000000013031330
000000000000000000000000000000000000003030000000000003000003000000000000000000000000000300000000000000000000000000000020000000140000000300000000003000000000000000000001
000000000000000000000000000000000300003000000000000000030003000300300000000100000000000000300000006000000000600000001000000000000000030340000003000000100000000000034100
000000000000000000033330000000001403000000000000003000000010000000000000000000000000100000000000005300005000003300000000000500630000000000000000000000000000000300000000
000000000000000000000300000000000100000000000000030000030000020000100000000000030000000000000000000000100030300000006003000000100330000000000000000000000000000000000000
000000000000000000000300000000000003010000000000000303000000000030006000000000303000300000000000003000000000100000001030000000300003000200003000000000000000000000020000
000000000000000000000300000000000000000003000000130000002000100000000300000000000000000000000000000000000300100000000000000000000000020000000000001100000000060000010000
333333333333000003333000000000000000000000000050000000000310001010000000000003333300030301000000000000000000313333530330000000000001000000000005000333330000033330000000
