000000000000000000000000000000000000000000003000000000000000000000500000100000000000000000000000000000000003000000000000000000000000000000000000000000000000000000000000
000000000000000000000000000000000000000000000001200000000000000500001000000001000000000000000000000000000000000000000000000000030000200000003000001000000300000000000000
000000000000000000000000000000001000000000000000600000000000000000000330000140000000003300010000000000010000000000000303000014100006600103000000000000003300000003000000
000000000000000000000000000000030000000000000000605001000030060300000030000300000010000000000000660000000000000000000003060330000006000000000000000050033100000010300000
000000000000000000000000000000000005060000000366600000000000003000000030000000000000030003000000000000000030000053100003000050000006600000000000000000333300000000000000
100000000000000010000000000000100001000000000006600050001000000000000033001000010003000000000000360000000000000100000000300000030006603000001000000003313300000000010000
000000000100000000000000000000000001310000033333306100100000000001500630033330000000303333000030330005000000000000000603303333333330110000000000000330333001100000000000
000000000000000000000000000000000000000000000000000010000000003000000000400001000000000000000000300000000000000000000000013000000000000100000000000300000000050000000000
000000000000030000000000000200010030060000000000160000100000000000000000030000000400000010000000000000000000000300000000000000000000000000030000000000000000000000000000
033300000000333000014100006600000030010000300001003000001300066333300005000000000031300001400000000005000300003303330000000100000000000000301000000300001003030001000666
000000000003333000000000006600003330000000300030000003030000061000010000000005000303300000000600300020100000033300000000000000000000000000300001000300000000300000000036
000000000033333000000000006600033300000000300040004000001000016000400000000003000330000000000000500000000000333000003330000000050001000030300000000300000300000000300000
000003000333333300000000006600303331000000030000000000300002166000000000000000033033030003100100000004000003003300000300315000100000000020330000000030000000010300000066
333333333333333303333333333330333330000000330033003333033030330133333310000000303303300321003000000010000306033333332330000000000006000330330000000330033333333300333300
