000000000000000000000000000000000000000000000000000000000000005000003000100000000010100010030000003000000000000000000000000000000000000000000060000000000000300000000000
000000000000000000000000000000000000000200000000000000000003200000000000000000000040000000000100000000000300000000000401000000000000000000000000000000300100000000000000
000000000000000000000000000000000001016000000001000000010406600000300000000000002000000000002000000000000000200000000000300000000000000000000002000000000000000000000000
000000000000000000000000000000004300000600000000001000000000600000010000000000000300000000000000000000000000003000000000000000000000000000000566000000003000000000306600
000000000000000000000000000000000000106600000000000000000000000000000000000003006100100000000000100000100300600000000000000000000000000000010021000030500000000000006600
000000000000000000000000000000000000006600000000000000052003600000000000000000066000000000000100000000000006301000000000031000000003000100000060000100010064000000006000
000000000000000000000000000003030303133303343333300000003303333000000033303333303030003330300000003000000300333300000000000000000000033003333133303003000033305033333300
000000000000000000000000000000000000000000000000000000000000000011000000000000000000000000100000000000000000010000000000000000000050000000000000100000000000000050003000
000020000000000000000000000000000000000000000100000000000000000000000000000010000000000020000000000000000000000000000000000000000000000000001000000000000000000000000000
000660000000000002000000000000020004000010000000000001000350000000000000000010000000000660000000000000000000001000006000020002000000000000000000600000000003000001000010
000660000000000066000000000000603000000030000000000030030000000000301000010500000000000660000000000000000000100000066000000000000000030060000300000000000000000000060000
000660000000000066000000000000100000061000003000000000030000000000600000000000000300000600030003000000000000000000006000000000000000000600000000010000000000000000000000
200660000000000066000000000030660000000000000000005000000000000002010010000302000000200660000000000000000000000000006000000000003000000600100000000000000500000000000006
333333333333333333333333333360533030000030000000000000003333333304100000000000000000333330300000000006000103336300033330000000333333330333000000000000000300000103303030
