000000000000000000000000000000000005000000003003300000530000000003000000000004000000000000000000000000000010000000300000000000003001000000000000000000030000000000000000
000000000000000000000000000000000100600000000100301130006010005000600030100000000000000000000000000000000000000003000000000000000000000000100000000300000300140030000000
000000000000000000000000000000100000000000141110000000000100000000000000000100300000140310000000041030000000003014131000000000000000100000000000000000000400000000000000
000000000000000000000000000000000000000000000001100000000600030000000002000000000000000000000000000000051000000000000000000000000002000000000000020000000000000000000000
000000000000000000000000000000000000000300001000000000000000100100000000000201000000530000000000000000000000003000000050100000000066000000010003600000000000100000000000
000001111000000000000000000000000001100000020000000030000000010500000000000000000050020000000060020000000000001102000000000011000066000000000000666010001200000001100000
000000000000000000000000000000000000000000333103003230330000000000000033000300000000003303330330330000000000000033333330000000033333300000003333333303033030133330000030
000000000000000000000000000000000000000000000000060000000010000030000030030000000000000000000000000000003000000100000000000005000000000000300003001300000000000000100010
000000000000000114000000000000000000000000600500000005000000000030000000000000100020000000003600000114000000100003000000000000011000100000050000000000000000000050000000
000001414111000000000000000060000000000004050001000000500000004000110000006000000000000000000000000000000000650000000000000000000000000000140000000000000000000001411100
000000000000000000000000002000000030000000300000010000000000000000010000000000000020000000000000000000000000002000000005000000000000000300000000000000000000000000001000
000000000000000000000000066000006600000300000300000100000000000000000000300000000060010000000000000010100000066010000000000500006000000000000000000000000200000000000003
000000202000000000000000066600006060000030000000000000000000002050000001000000000066110000100041000000030000063600000001100000000000000000120010300000001100000000200000
333333333333333333333333333300303303333303000000050000100303301330303300000003033330000100000000000333333333333303000010000060333030033330030000000000000500000003033303
