000000000000000000000000000000000000010000000000000000000000000000001010000010000000000000000100006000000000000000000000000030000000600000000010000000010000010000000000
000000000000000000000000000000000000006000000000033000000000000000000000000000000000000000010001000000300000000010000000000000000000003000000000000000000000000000000600
000000000000000000000000000000000000004440000000001100000000000000000050040000000000000000000003000000000000444000013000000000000000000000000004440000310001100010216000
000000000000000000000000000000000000000000000000000000003400100000000000100000000000000000000001000000000002000000000000000000030100000060000000000004000000000030600030
000000000000000000000000000000000000000000030000000000000600000000000000000000000000000000001000000000000000000000000000000000000000210000000003000000000000000036600000
111000000010000000000000000030010002000000113010020200006600000000000020000000000000000010030010011110000240000020000300000002000030000010000000000111033020000100000100
000000000000000000000000000000000003313333000000033003303333300000000033333330005020000000000000000000100333003330303330330333000000030000000003333001050033333333333300
000000000000000000000000000000000003000000000030000000003000000010000000001010000003000001000000530010000000000000000000000000000000000000000000000000000000000000001000
000000000000000000000000000000000000000031010001000000300000000000000000000000000000000000030000005002000000000000010300000006000000000000000000001000000000010000000000
011000100044400200000000000000101000000000000200000000000000000011000000000000000000000000101100010000000000000000000000100000220000200003000010000000000000000000001000
000000000000006600000000000000000006600030000100000000000000000000000003000000003036060000003000000003000000300000001000300000661200000003000000000000000000000001000030
000000000000006600000000000000000006600200000000000000030000000000000000000000000000600000000000000000000000000001000061000000660000010000000000000000000000000000000000
202000020000006600000000000200300006600000000100030000000000002202016011100000000000060000020200000000000000000210000002020006660000300000000000000000100000000500000302
333333333333333333300033333300001003031300030333310000000033330331303300000002003000330330033351330000000030313300000003330333130330000005000000000000000030000000333301
