000000000000000000000000000000000000000000000000000000000000000000000000000000000000000000600000003060030000300600000000000000000000000000300300002000000100000100000000
000000000000000000000000000000000000000000011000000000030000000000000000000060000040000000000000033050030000000000005500000000000000100000000000000000000000000006000000
000000000000000000000000000000000000000000101300000010330000000111000000000003000500113000000000003300001000000000030000000000000000110100010110000030000000000000000001
000000000000000000000000000030000000000000000000200000330000000000000200000000200000100000001000003300100000000000010000001000000000000000020000001000300000000500300010
000000000000000000000000000000000000000000000006600003330000230001006300000000000000000006600000003300000000030000020000000000000000000003660536006003000333000010000000
000000000000000111000411111100000000111000000000600300330011000120006630000004111111000600600000003000020011100000000000000000101111100000300000066033000100003004111010
000000000000000000000000000000000000000000330033303333330000000133330306000000000000003303300000003003323000000020000005000000000000033330330030331333303300000000000000
000000000000003000000000000000000003000000000000000000000000300200000030030000000000000103000000000000010000100000000000000000003000000000000000000000001030050000000000
000000000000033000000000000003000003000000000000000000000010000030000350000000000000000000000000300000000030000000000500000001000000330000000000003000000000300000053000
000300000000333300001111000000000203300001000000030030000003000000013333000040000000000000000000330000000500000000033000000000000003303000010300030000000033000010000000
000300000003333300000000000200000003003000000000100030000303000000033333001010000000000000000003030000000000301000030000010000030003333005000000333000000003010010000100
003300000033333300000000006600050603300000000000000030000033000000333333000000000001000003000033310033000000004000300000000000300333330000000003330000000030000000000000
033300000333333300020000006600031303300020111101603330000333000003333333000000000000000000000333350303000411111106330003111000003333303003210003303000000033000210001000
333333333333333303333333333300000003303310000000033330300330330333333303130330000010000000033033233335363000003133003000000000033013333033303333330000000033030330000000
