000300000000000000000000000030010000000004000000000000003000000000000000000000000000000000000000001000000000000000100000000000000100000000500000100000000010000000000030
000000000000000000000000000000000000000010000000000005000300030000000000000001010000000000001000100000000000000000000000000000000100000000000000000000000003000000000000
000000000000000000000000000000000000000000100000000000000000000000000100000001000000000000000000000000001000000000000003000300100030000000000003000011005100000000000000
000000000000000000000000000000000000000000000020000000000000000000000000003000000003000000000000010060000010200000002000000000000000100000000000003000000003000000100000
000000000000000000000000000000000010000006000300000300003006000001000000000000000400000000000050000000000006000000000000000000003000000030300030000000000000000000000000
000100000000000000000000000003050000000000001000002200000061300000000000000040000000000100020000020000000006600000030000220000000000000000000006000000050003000010220000
000000000000000000000000000000000010000000303303303303033333333000010030000000000000000000003330300003000333330333003336333333000000100000000000000000000000000003303333
000000000000000000000000000015000000003000000000000000000000000010000000000100000000000000000060000050000060000000000000000000000000000033000003000000000000000000000000
000000000000000000000000000000000000000000000000000000000000010002003000000000000000000000000000000020000000000000000000000000000000000000040000000003000000000000000000
000000000000000000000000000000000000000000000000000101000000300000000000000000001000010000000000000000000003000000600000000000000000000000000000000010000000000100000000
000020000020000000000000000000000010005010000000000020000000200000000000000603000000000010000000000000200000000000020000000000000000002000000000000000020000000000010000
000300000660000000000000000000000000030000000000000660000003000000000000030000000000000000000000000003050000100000000010000001100000000000000000000000300500000000066000
000300000660002000002022000020300025001000000000000660000000010002000000000060000000022000000000010003000010000000060000000000000000000000004005000000000000000061061000
333333333333333333333333333313033300010000000030000353333333353633133303000003333433330013300000000330333000100334333003303030000000000000010000000003030333301033033333
