000000000000000000000000000300003001000100000000300000000000010000001000000000000000000000000000000000000000000000100100003000600000000003000300000000000000101000000000
000000000000000000000000000000000000005000000010000000000100060000000000000000002001000000050000000010000000000000000020000000000003000000000000010000001000000000000000
000000000000000000000000000000000000000000053000300000000000000001000000000100300331000000000000000000010000300000000003000000000000003330110000000000333100000300330332
000000000000000000000000000000000060000000000000000000000000000000000000000000000000001000000000100000000000000000000003000100000000300000001000030005000000000000000000
000000000000000000000000000000000000000000000000000001000000000300010100000050000000000000000010003000000000000000030000000000000000000000000303000100000300000000600100
000000001400000000550000000060000000010550000001000000001000050000000312000000000630000000000005001000000000000000005500050000121000000000000140000000000000000000000000
000000000000000000000000000030133000000000000000000000000000000030330033303333010000000000060000000330333333300000000000000000303333031300030000000303103033333000000000
000000000000000000000000000000000003000003050000600000100000303500000000000000003000000300000000000000003000000000000000000000000000000000000000000000000000000000000003
000000000000000000000000000000000000000000000000000000000001000000000300000000000000000000000000000000100000000000000100100000000000000000000010000000000000000300000010
000000003333310000000033333300000500000000030003100000310000000033333000010000000000000000003333330000000533303100000001000000030033300040000000000000000000000000000000
000000000000000000000000000000000000000000000000004000000000000005001000000000010300000000000000000000000000000000060000000000000000000000000300000000000000000000300006
300000000000000000000000000000000600030000000000000000000060000000000100400000001000000000030000000000000000000000000000600030000000000000300003000000000030000000000000
120000000000000000000000000001400000000010000000002000000001010000000001000000300030000000000000000000000000000000002000100000000000011400000000000000055012000000400000
333333330300333333300000000010000000000000303000333333300000000000000000002040000000000000000000000000050003103335331000000000100000030010000000000000000030000333003000
