000000000000000000000000000000000600000000000000000000000010000000305000100100000000000000050000000010000000000000000000040000000000000000000000000030000000001000000000
000000000000000000000000000000000000000000010100000000000000000000000000000000000060020000000000000000000000100000000000000000000000000000000000000000000000000000000000
000000000000000000000000000000000000000000000004100000004410000000000000000001000000000000000300000600000300004400000002030000000004000030000000040000000000000000000000
000000000000000000000000000010020010000000000010000000000000000000000000000000050000000000000000000000000000000030000004000000300000000000000000000000000000000000400000
000000000000000000000000000000000000000000000000000000000000010000000000100000000000000000000000000000000000010001000000050000010000000000000000000000000000000000000001
210000004400000000000000000000000105000000000000031000000200300000000000000010440000000030000006503000100000000000000000000100000000004400000000000000000004400152100000
000000000000000000000000000000000300000300333333300000003303333000000133336330030000001000033033330030002303330000000000000000333333000000003331033000030000000000030000
000000000000000000000000000000000000000000000000000000000000000000000000000000001000000000000000000000000000000400000000000000000010100000000000000003000000000000000000
000000000000000000000000000000003300000011600001000003100000000002000000300000000400000000000000100040000000000000000000002000000000000000303000000030000000000000300000
044000000000444400000000000000000000340000540000000000000000030000000400003000440000000003000060000000000400001000000000000000044001004000003000100044000044000003000000
000000000000000000000000000000030000000300000000000000000000000003000000000000300000000000000300000000000000000000000000000000000060000000000000000000000000101000000000
000000000000000000000000000000000003100000000030050000000000000000000000000000000000000050060000000000010000000000000000000100000300000000000000631000000000101000000300
000005500000000200000000000050000000000055020000000400002100000000000000030000001055044000000000002000000020000000050002100000000505502000000000000000002502300301000000
333333333333333333333333333333333333333033033313310000000000000300303300400003333330000000033333030000000333333303333330000000333030033133300000000033333033030333303033
