000000000000000000000000000300000000000000000000000000000100000003000003000000300000000001000000000000010000100010000000000300000000000000000000010050000000000000000000
000000000000000000000000003000033300000000000000000002300103630000100000000003000000000000000006010003330030000000000000000003000003000000000000000000000000000000000000
000000000000000000000000000000000000100000000000001000000000000000000001000000000011000300000000000000000000000000000000000000000000000000000300000050000000000000000000
000000000000000000000000000000000000000000000000100000030030000000000033303300010110003000000000000000000000001000000303330000000000000300000300000000000000000003003030
000000000000000002000000000000000000000003000200000000000000000000000000000000000000000000000000000000300000000000000000000000000000000000000000000000100000000010001000
505550000003000002002000000003000000000300000200000000000300000530000000000000000000000003000000000040000000030036000000000000030006000003000032002000030003000000100050
000000000330000000033300000000000000033000300000330000000000000000000030010000000000000000000000000600000003300000000000000000500000000000000100030003000030000001010030
000000000000000000000000000000006300000000305000000000000000000000000000000000000003030000300006000000000100001000000030000000000000000000000000003000000000000000000000
000333000000000000000000000000000000000000000301000300000000006000003000000000000030000000000000000000000000060000000003100000300100000000000000030000000000033000001000
000000000000000000000000000000000000310000100000000000000300000000000003000300000000000000000000000300000500030030000000000000000000300000000600300000000300000000000000
000000000000000000000333333000000300000000000000001343300000000000000000100000000000610000033303300000000030300000000000000005000600000000030000000000000000000000000000
000000000000000000000000000000000000000000000000000000000002000000000000100000005030000000000010000001003001200100350000000000000200000000000000000000000000000000000000
030000000000000000000000000000000003010000545550000000000002002003030100000100000000505500000000000000000000000200000105055500000200200000000000300505550000000000000000
000000000000000000000000000000000000400000000010000000035000000003000005000003000000000001000000003300000000003033000000000000000003300000013000000000000000000030000000
