000000000000000000000000000000000100000000306000000006000000000006000000010001000000000000000000000000000006100000010000000000000000000301000000000000000000000030066006
000000000000000000000000000000000000000000006600000000000000001016601000000000000000000001000100000000000000000000000000000000000000300000000010000000000000001000066000
000000000000000000000000000030000000004110106600000000000001100006600000000000005300000200000000100000000006601000001300000012001110000000000504110005000000401000006000
000000000000000000000000000000000000000000006600000000020000010006600010000000001000000000000000000000006006000000000100000066000030000000030000000000000300000000066000
000000000000000000000000000030000000300000106600000000000000000006000000000003030000000000000010000000066006000000000000000016000000000000300000000000000000000000060000
000000010000000011100000000000300000203110006600000000000000000006600200000000000000000000002000000000060050600102000000000066060100010000000000000000000600000000066000
000000000000000000000006600500200003333133303333300000003333333303333300301000060005006600533333333333333003533333130003303033303134300000003303003000000013003303030353
000000000000000000000006600000000000000000000000000000000000000000000000000000000001200000000000000000010030000000060000010000400000000100000000000000000000000000600000
000000000000000000000006600000000000000000000100000000006000000000000100000000001000000400000000002013000000000000060000000003000010000000000000000000000000000000000000
000411000000020011100006600000110000000000000000000000020004110000100000000020015000000000000003000000000001010000660000000000000000000000000000311006003204000000000000
000000000000660000000006600036000063000010000000000000063000000000000000000660000000000000000000000000000000000000000060000003000000000600000000000004000630000001000000
000000000000660000000006600000030000000000000001003000000000000000000200000660000000000000000300000000000600300000160000000000000000000000000000000000006000600000060030
020000000000660000000006600200000000004000000000000000063200000000300000100651000060100000000101100000003000000000060020010000000010000000000011100000006610000000000000
333333333333333333333303333333333300000000000600003333033333333000000033333330000000000000000000000000000030333330333331000000006600530000000000000330333000000000006005
