000000000000000000000000000030330330003000003000000020000000000000000000000333131333303333300000000100033000000100000000100103303330300000000200000300011000000000300001
000000000000000000000000000301000000000000000000000100001011100000000000000500000010000003000000006000000011111000030010000100000000060300000000000000000000000000000003
000000000000000000000000000000003330000000000003000000003000000000100000010010000033000033304000000030000300000050000010300301000133300000000000000000000000000000000000
000000000000000000000000000000000000100000003001003000000000000030000500000000000003000000000001000000000000030000000000010000000000000000000000000300000000000000000010
000000000000002000000000000003300000000000000000000300003100000000000000000000300000300000000000000001030030000000006000100000033000000000000000000200000020010000001006
000000000030000000000000000000000000001001100300000000000003300000300000000000100000005000000005010000000000030000300000000000000000000000000100000001000000030000000000
000000000000000000200000000000000100000333000000000000000000000000000000000100000000000001000033030000000000300001333030000000000000000002030000500000020000000400000000
000000000000333033333000000000001305000000000000000000010000000000000010000010000000003000000000000010000000000001030000030000000011050000000000003003003300363330000000
111111000000000000000000000000100000000003101101001000000000003030000000000000000010000000000000400300003000001503410100000001000000303100000000000000000000000001111110
300000000000000000333000000000000100000000300000000003000000000500000000000000000000000300000000000000000000000030000000030000000003300000000030000000000000003333000000
000000000000000000000000000000000003000000000300001000000000000300000000000000000000000000000000300000000010000000030000000000002000000000000000000000040000000000003000
000000000000000330000000000000030000000000000010020000000000000000000000300002000000000000020000100000001000000000000003300000000000600000000003500000100003300000004000
000330000000000000000000000003033300000000000030000000030000000000000005000000000003300000000030000000000000300000003000000000000000000030300001300000000000000000003300
000000000000000000000000333300000000000500000000300000000000000000303300000000000200000100000000000000000003000000000003000000000000000000000003303000000000100000000000
