000000000000000000000000000000000000000000003000000120000000000000000000000000000006003332000000300000000000000000000000003000000000000000000030000000000000000000033300
000000000000000000000000000000000000000100000000000000000000000000300010000000000000000101000000000000000001000500000000000000300000100000000301000000000010000000000000
000000000000000000000000000000010001000000600000000000000000000010000000000001000000000000000000000000000010000000030000100000600000000000000000002000000000000000100000
000000000000000000000000000000000000000000000000000003000000010300200000000021000000000000000030000100000000000200300010000000300000000320000001000000001000000000000013
000000000000000000000000000000000000100000000000000000000000000003600060000060000030000000000000000000000601000600000015050010000000000660000000000300010000000005001000
000000000000000000000000000000030000000000000000000000000000030000102060000660000000000000000005000000200600006600000000000000010000000060200000000000000000002200000000
000000000000000000000002300000030001000000000001000000000050000033330333330330023000000303300000003133333000303300000000000000000000031330330000000000000030333300000003
000000000000000000000003330000000000030300000000000000000000000000000000000000000300000010000000000000000000000000000000000000000000000333600000001000000000000000000000
000000000000000000000000000000300000000000000100000003000000000000000000000000000000000000000600000000050000000000000000000000000000000000000000000000000000030004000000
000000000000000000000000000000000100000000000000000000000000000100003000000000000003300000000000000000300010030000000003000000001011010000000000000000030003000000000000
000000200000000002000000000000000020010000000000000100000000000000000000000000000000000000010003000002000000000000000000000000000001200000030002000000000200000000000000
600006600000000066000000000001000360300000010600020060000006000000000000000000300000000000000000303006000000000000005000010002001016630000000066000300006000000000003000
600006600002200066020000000000000060000100000022000600201000000100000000000200010330000000300100000066020000000000002006000000601006000000000006000100046600300000000600
333333333333333333333000003333333030000033333360333333331000000000000013033300000003000000000000003333333060000033310330103000333303500000300330333033330300020000000000
