000000000000000000000000000000060030300000000000000000000000000000000300000000000300100000000000000000001000010000000000003000000100000000000510500000500000000000000003
000000000000000000000000000300000300000000000000000001000000000000003000000000003030003000000000030000100000000000000010000000000000300000000000000010000000000100000361
000000000000000000000000000000000330000000000000000000000000000030033330000000000000000000100000000000033000000000300020000000000000030000000000000000000000000000010303
000000000000000000000000000000003030000000000000200000000000000006333300000000000000030000200000000000000000000000000660000000000000000000000000000000010000000000001303
000000000000000000000000000000333030010000000006600000000000000003333300000000000004003000603000000000010000030000000660000030000000000000000000000000000000003000003333
000000000000000000000000000031313030000000000006000000000000000330333300000100000000000006000000000000030000000002000600000000300010000000000000000030000000000003233303
000000000000000000000000000003033303333333300233300004000000000333333003000000001000003030000000000000000313303303033330000000100000033033330000000000000003000333330100
000000000000000000000000000300000030001000000000100000000000000000000000000000100000000000000000030000000005000000000000005000000000000000000000000000000000000000000000
000000000000000000000000003300040003000300000000000000030000000000000300000000000000003002000000330000000000000000100330000000000500000000000050000300000000030000003000
000000000000020000000000033300000010000000100100000000000100000000030000100000000000000003000000030001000000000000003030000000000000001000000004000000306200001001001000
000000200000660000000000333300000660001304010100000000010000000000000000000020010005000000000033330000000000103600033300000030000000200000030000000001006000000000000000
003006600000660000000003333300000600000000010000000000000000000300100000300660000166003000060301031000000000000600333330050000000306600000100103000000035601000000030066
000006602000660000000333333300000601000000001100040000000000100000000130000000200066300000033303030000000060606633300300000000000406000000000000000000006000100000300000
333333333333333333333333333000333330000000010000000000001333003010000033333333333330000000033333300000000303330030033600000000330003300000000000000313003300000003330333
