000000000000000000000000000000000500000000000000000000000000000000060000000000001000000000000000000000000000000000010000000000000000000006000010003000600000000003500000
000000000000000000000000000000000000000000000001000000050000000300000006000000000000002000000000000000000003000000000000000430000000000005000000000000300000000300000201
000000000000000000000000000000000000030000000000000000000000000003333300000000003000000000030000060000000000000310030020000300000000030000000000000000000000000000000000
000000000000000000000000000000000300000000000000000001000000010000000030000300000000000000000000000000010000000000000000000000300100000000010004020000000050000000063000
020000000000000000000000000000000000000300000000000000000000000000000001000000130000000600002000002500000000000300000000000000020000002000002530000100503000000000000011
555000000000000000000000043003000000000004101040000600000000000000000001600000001000000043050510001310001000000003004300000000010000055500000000000000003055500000000010
300000033333300000000000000030333300004033000000033133033033333000000033033300300000000000030000003313000333333000030003333330000000030000003130000000003100000003030633
000000000000000000000000000005030000000000000600000000000000000000000003000000001000000001000031300000000060300000010000000000001000030000010300000000000000000020000000
000000000000000000000000000000000000000000000000000000000010000000100000000100000000000300000000000010001000000030000000000003000000000000000000010000010000300000000010
003333300000000000000000000000030000000500003333300000000000000100000000000000000000000000000333030000100000000000033333000000000000000000000000001000050000000000030333
000000000000000000000000002000003003000000000000000005000100020010001000000001000000030010000000000000000000000000000003000020000000000000000000000000000000000000000000
000000000000000000000250000025500000100000000000002000002500000020000000030030030000200000040001030000000000000000006002500000100000000000030000000000000000000000000000
000000000000000000000000000000000100000001000000055500000000000555000000000000000431000000000000000003000000000000000000300300000000000000000000000000000000001000000110
000000000000333333333333000003000000003000000000330430000300010300000000002330030000000003314000000006000303303300000003030000000003031333020000000333333000010300300000
