000000000000000000000000000000000002000000000000100600000000000010000000000000000000000001001101000000000001000000000000000030000000020001000000000000003000000000030000
000000000000000000000000000000000530000000000000000000000000000000004000000000000000000005000000100000530000000001000006000030000000000000000000000000000000000010000033
000000000000000000000000000000000000000003000000000000000000000000010010300000100011003330300500306200000000000000000000000000000000000313030000000000050000000000000300
000000000000000000000000000000000000000100000000000000000000000000000000000010000000000000000000000600000000000000000000000000303000000031000000000010000000000000000000
000000000000000000000000000000001000000000001300000000000000000001000000000000000060000021000000006000000004000003000000005000000000000000030000005000000000000010000000
550000000000000000000000003300000000000000010000005000005500000010000010010000200000000000035000006600000500003300000300000001020000000000004000000000000000001335500000
000000000033300000000000000004000000003000303333300001000011000000000000033313333033013303000000000333333000000000000030003330333033300330305000100000003100010000000000
000000000000000000000000000000000000000000000000000000000000000100000000001000000000000000000000100003000006040000000300000000000000000000000010300000010010000000000000
000000000000000000000000050000000000000000402000000005000000000000000000005000000000000000000600000000000000000000000000000600000000003000000000000000050000000010000030
003333300000000000000020000000000100033333030000000000100000040000000002000000033430000000300000000000000000000003000000000000020200000000003000000020030000000005203033
000000000000000000000660000000400000000000000030066030003000000000001066000000000001002000010000051000000000001000000060000000660000000000000500000600000000000000060000
000000000000000000000660000001000060000030000000066000000000000000000066010000000000000000000000001000000000000000000000000000660000000000000000000660000000000000110000
000000000000000200000660000000000000000000000003366000000000000000003066000030100000400000002000000000600000030000000335000000060000000000000200001660000000000000000000
003303000000333333333333333300000033030033000000033031130000030000000033333010033000000003333333300000000000330000000000000000333333000601003353333303333303003300333030
