000000000000000000000000000000030000000000000000130000000000000000003000100000000000000000000000000000000100000000000000000000000000000061000000000000000000000000060006
000000000000000000000000000000000000000000000000030000005000000000040001000000060000000000000100000003000000000000000000000000000100000000000010003000000000000000000100
111111111000050000100100000000100000020040311111003000000000000101111100110000000000000000000000000000030111111101000051000000000000000000001000000000000000000000111000
000000000000000000000000000001000000000001000100010000000000000000503000000000500000100000110000000000000020000000000000600030010000000000000000000000000600001000010000
000000000000000000000000000000000030000000030000000000000000000000000030000000000000000000060000006000000000000000000000000003000000000000000000000600000010010000000000
000000000000000000000000000000000000000000000000000000000000000030000000001000003000010000060000110000040030000000000002003000000000000000000000000600000000000000000000
000000000000000000000000000033133330333333000010033003330000003000330053333333333000333030333333333330233003000000000000001100333333333033353100000313003300000003031333
000000000000000000000000000000000000000000000000000000000000000000001000300006003000000000000003600000000000000000000030000000001000500530000300000000000000000000000000
000000000000000000000000000000300000001000000000100000000000010000000000000001000100000000050000000000000000000000000100300000000000000000000000100000000000000000000000
000000000110000000000000000010000001100005000010000000000000003000000010000001000005000100010000001500005000010000501000006330111111000100001100000101111100000000000000
100000000000000000000000000000003000000000000000000000000010000000000000000000001000000000201000030000000300000000000000010001000010000010000000100000000013003530000003
600000000000000000000000000000004000100100000000061010000000000300000000000000000000030000020000000000300010000000000006000000000050600000000000001020000000000000000000
600000000000000000000000000030000000000000001000000000000000000630000001000000000000000030600001030000000030000000000006000000000000000000000300000000000000300000000000
333333333333333333333333333300000000000000000003031033033333033033133300100003000000333333300000010000000000000003010003333030000005033036330030000000000003133330333533
