000000000000000000000000000000000000000000000003000000000000030000000000000000000000000000003000000410000000031000000000000000050030130000000000000000000000000000000000
000000000000000000000000000000010200000000000000010000000000000000100000000000000000010000000030200030000000000000000000000000000020000000000001000000000000000000001000
000000000000000000000000000011000000100000000000000333000000000000010000233000000000000000000030000000000000000000000000030000000010003000000003300000000010000000000000
000000000000000000000000000000000003000000000000000001600000000000000000001130010000000000033330000010000300000000000000000000000110030000003333300000110000000003000000
000000000000000000000000000000000000000010000000000000000000000000000100300000001000000000333330300000000005000005000000000000000000000000003333300000000000000000000000
000000000333300000000031111110000000000000000000030000000003331300000000003003000000006000000003300003330000000030000003133330000000000000000000330000015000330001000000
000000000000000555000000000030333330333303055500000300004000000000000000060000505000333030330033000000000033303333000330010000055500000303333003300000001000000000333030
000000000000000000000000000030000000000000000000013010000000000000000000000000000000000000040000000000000100000000000000000000000030000000000000600000000000000000000000
000000000000000000000000000000006000000000000000000030100016000000000000000000000000000300000360000000100000000000010000000000000000000000000000000000000000000000020000
000330000333000000000000000000000000000100000000000033000000000010000500000000003300000000000300030000310000000004333000000000000330050000000000030000000000300000100000
333330000003003000000000000000050000000000001004003303000000000000000030200003330300000000000000000000000000000000003000000000333310000000000000030000000000003500001000
333333000000000000000000000000000300000000000000133333300100000050000000000003333320010000001000010003000000000500100000000000305333000000000030000000000000000000003000
000030000000000000000200000010111000000001001033000000000300351200000001000000000100030110100004002000000001100000000000000000000000003011110000010031101100000002060000
300330000000000333333333333300000000000000000100000033000000000333030313033033003300000000005550000000006003300000000000000000301530000000300155000300000000000003030303
