000000000000000000000000000000000000050010000000033000001000010000000000000000000000000000000000000000100000000000000000000000000000000000000000000000000000000000000000
000000000000000000000000030000000000300400040000000000000200000006000000000000000000000000000000010200000000000000000000030000030003002003001000000000000000003000300000
000000000000000000000000000000000000030000000000000010006000001000010000300000003000003000000000000000000000000000000000000000000000066000000000000000000000300000030000
000000000000000000000000000010000000000000000004003000006600630050001000600000000000600000000000000000000040000000001000000000000000066633300001000030000000000000000003
000000000000000000000000000000000000000003000000000000006630000000000000000000000100000010000000000000000000000000000000000301030000066000000000000000300000000200000000
550000000000000000000000000000000000300000000000000002306000000550010001001060000003000000000000000000000500000000000005000000000001066000000000000000000000000300000000
000000333333300000000000000000031013131300333333003333003003000000003300333000000333303330000031333331333000000303303000000003200333031330003303303333030000000000333300
000000000000000000000000000004000000000005300000030000003000000000000000000000000000000000000000010000000000000000000000000000000100000020001000000000000000000001000000
000000000000000000000020000001000001200000000000000003000000000000000000000000000300100000000003000000000020000000000000000000300000001003000001000000000000000000200000
003000000000000000000660000000000006600000000000000003000000000000000010000000000600000000000000010000000060000000000000000000000000000003000000000000001000000000600000
000000000000000000000660033300030006600333000000000000001000000000000000000000000000000000000200000005000660003300000000000000000000600000000000000000000000000006600003
000000000000000000000660000030000006600000000000003030000000000000000000000000103000000000000000001000000663000300000000000001010003000000300000000000000000000000600300
000000000000000000200660000050001306600000000000003000000000100000003000000000030000000030000000000000000660000000030000040000000000000004001000000000000000000001600000
333330000033333333333333300000000030033361000000000000001330336301333000000000000000000000000300003033100330300033033333333331000000100000000000000000300305000000333030
