003330000000000000000000000000000010300000030003000100000330000000000000300000030000000000000000000300000000330000000000005000000000000000000330000000000000000000000000
000000000000000000000000000000000000300001000000000000000303000000000000000050300040100000000000000000010300000000000003000000000000001000000000000000000000000010000000
000000000000000000000000000000006000002000000020000000000000000005000000500000000200000000001002000000000000100000002000000000000000000000010000000000000000003000000000
000000000000000000000000000000020000000000000660000000000000200000000000000000000000000230000066000000000000000100060000000000003000000000000000003000000030000000000000
000000000000000000000000000000000000103000000610000000030010000000000000000000006600000000010066000000000000000000060000001000000060000000000000000000000030000010000000
000000000000011000000000444000014000000000000060000000000000000003000100000000056600000000030066000000000000060000061300000000000444000010000000000000100000044400330000
000000000000000000000000000033333333300333306333060000003333330000000000000003003330030233300030333301033000000030033303333333000000030333030000000000000000000063033333
000000000000000000000000000001000000000000003330000000000000000000000030002300000000000000001000000000000000000000330000000000100000000000500000000000000000000000000000
000000000000000000000000000000000000000000000000000000600000000000000003000000000000000000000000000000000000000003000000000001000000000000000000000600000030000000000030
000000000002000000000404444400000004044144000030000100000001300000001040444300000030404440403000000000000010000000000300000000444444400500003000300000000000002000044440
000000000066000002000000000000000000000000000400000000000000000000000000000005000000100000030000500000030000000000000000000000000000000100000502000000000000066100001000
000000000066000000000000000000000000003000003000500000000000010003000000000000005000000000000000000000000000000000000000001000010000000000000000010000005000066500300000
000000000066000000000020020000300010010250000000100044400000000000404002002001100000020001000000110004450100000600000000300011003320000000000002000100000000066000200200
333333330033333333333333333300000000333333100000001000003333333300000003131330000000301333300000650000000000000001000000000500313333300010003333330000000000033333033303
