000000000000000000000000000000000003300000000000300000000000000000000000000011300000000000000000033300000010000000000000000000001000300000000000000330000000000000000000
003000000000000000000000000000000003000000000005300000000010000000300100300003000003000000000000333100000300300000610000000000000000300100000000000330000003000330001000
000000000000000000000000000000000003300000000033300000000100000000000000000003310000000000000003233300000000000000000000000000000033100000001000000330000300003300000000
000000000000000000000000000000000303300000000030350000000000000000021000000003300000000000000033300300000000000001000010000000000332301005000000000300000030033030000000
000000000000000000000000000000010003300000000333000030003000000100000000000003300400000001000333333300030000000001000000000000003333100000000000000130000300030330000000
000000000000000000000330000001000001300000033100333000000000000000000000010003300041000000003000103030000030000000000000000000060013300000003000010331001003033330000030
000000000000000000000330000000000003303303333330033000000000000000333300000003333330300033333330000331006000000333333331000000310003000000000300000033330330333100000000
000000000000000000003330000000002000000000000000000400000001000000006000000030000000300000100000000000000000000000000000000001330000005000000000001000000000000100000030
000000000000000000033330000000300000000030000000000003000000000000000000000330000030060000000300000006020000000000000000030000330000000000000300000030000300000000030000
000000000000000000333330000000500000000000000000000000300000000000000000003330000000000000000000000000000000000000000000060000330000000000000000500001000300000060000005
000000000000000003333330000000000000000000000010000000000034000000000000003000000300000000000000000000000000500001000000000000330000000000000000000000000000000601000000
000000000000000033333330000026000000020000013000000000000050000000000000333300000000300000000000000000000000000010000060000003330000000000001010000000000000100000300000
000000000000000333333330000000000000030003000000030000000000004000001000300333300000330000000000030000003000000030000000000000030010000000000010000000000000000300000003
333333300333333333330333333300000013033303000000130001630050000033003333033000300000300000000000000033033005000033000000006100033303300330000000100003133003303030000005
