000000000000000000000000000000003100000000000000000000000000000000000300000060000303000000000000000003000000005000000000000000000000003000000000000000400000000000000000
000000000000000000000000000003000100000000000000000000003300000000000004000000000030000100000000000000020000000000000000000000000300000000000001003000000000100000000000
000000000000000000000000000000000000010000000000000000030000001000000001000010000000001003100230000000000041110003000010000000000000000000100001000000000101000000000000
000000000000000000000000000000000030000000003000000000000000000000000000000000000000001000010000000300000000030030000000000000000000000000000030000000000000000000100000
000000000000000000000000000000000000000100000000000000000000000000001000000000010000000000500000000000000000001006020000000300000000000000000000000010000003000000000000
000001111110000000000000000004130110002200000001000000000000000000000003000401101000060000200000111011030020000000000050000000000003010010000000000000000210000001111000
000000000000000000000000000000010003330333333033030333330000000333333030030333000000303533303000300000000003033003333603333333100350000000000000000303030300000000000010
000000000005500000000000000000000000000100000000030000000000064000000000005500000000000000000000000000000001000000000000000503300000000000000030000300000000005510040000
000000000000000000000000000000001001000000300000000100000000000000000000000000000000000000003000000000000000160000000000000000000000010000000010000100000000000300000000
000000114111000000000000000000100000000000001100000000003000000000000010011000000000000000000060000000000000030000000000411000000000000010000000100000030014131000000000
000000000000000000000000000000000000000010000000000000100010300001000000000000000000000000000000000000000300000000000000000000002000000000000000000000060000000000000000
000000000000000000000000000000000000000000000000100000000000000100000000000000000300000000000000000000030000000000000000020000000000000100060000000000000000000000000000
000000202000000000000000220200003034111000000000000003000002202000000002000000130111000000000000000000000000020200000020200000000301100000100000000000003002000100002202
333333333333333333333333333300000000000000003033300000003330303020000033633030000000000000030000000330330030333033033030333333000000000000003330333001000033330330333303
