000000000000000000000000000000000000000000000100000000000003000000000000000030000000001402000000000000000013000000010100300000000000000000000000000000003000000000003010
000000000000000000000000000000000003003000000000000000300000000000000000000300000000000000030000000000000000000030100030010000000001003000000005003030000000000000000001
000000000000000000000000000000000303000000000003300100000000030000000000000000010010000003030030000000000000000030000060000030000000000000000000033000000340000000000060
000000000000000000000000000000000013033000000130000000000000303000003000530000000000000000030330000000000000000030330000010333300000130000000001330000000000000300000000
000000000000000000000000000000000003030000000313300000300003330000010000000000000000000000230004000000000000000030310000003330000000310000000003300000000000000000000000
000000000000000000000000000000000003003030003303300003000033333000000300000000000000000000000030300000000000000000030005033303000003100000000133103000100000300000000000
000000000000000000000000000003333000330033300303330000003033330303000000333330000000033330000331300000000000000033333330333303333333300000003133033001000010000000330333
000000000000000000000000000060000000000000000000000000010000000000000000030000000000000000001000000006000000000000000000050000000100000000000000000000000000000000000000
000000000000000000003300000000003006000000000000100003100060000300000000001001000000000000000003000000003000000000000000000000000000000000000300400000000003000060000000
000000000000000000033300000000000002000000000000000300000000005300000030000000100000000000000000000300033000000000000000000500000000000000003000010000000030050000000000
000000000000000000333303300000030000001000000001000000000000000003000000000000050000000001000000000000333000000000000000000000000000100000000000000000000030000000000000
000000000000000003333303000000000000060000003000000001000000000303000000000000000040000030000000000003031000000000000000000000000005000000010000000400000030303000000000
000000000000000033333300303000030000000000000000000000010003400300000000000000000000000000000000000033033000000000000000000000000000000010000026000400000030030300000003
333330033333333333333333333300000001000000000010033303330000000330033300000000000000000010033033033330331030000033000000003000033300000000300000000100000003333303333300
