000000000000000000000000000000040000300103005000000000000000000030000000050010001000000020003000000000000000000030000000000000000000005000000000003000010000300000030000
000000000000000000000000000000000000000500000000000000000000030000100302013000000000000600000000000200030000000000003000000000000000000004100000000023000000003000003000
000000000000000000000000000003003000001000006000031001106000000000000003111300031100000000000003000111010100200000000003001000000001000000000030000001111000000000300000
000000000000000000000000000036336000000000000000030000300000000000000000000000000003000300033333000000050000000000000000030320000000000000000010000000000000000000030500
000000000000000000000000000033333000000064000000000000000000000000000000000000000000000006053303000000000000020000000003103030030000000000000000000000000000000013100000
000000014111100000000000000000033000000000000300000300500000000000000500000000000000000000000033000001000220000000000000000300141111300030001410110000000000000500000000
000000000000000000000000000030333333000000310010003033330000001330333330330350300000000000130033153303003303330300001000003333001003000000000000000330330300000001000000
000000000005000000000000000000000000050000000000000000000000000000000000000001000000003000000000000000006000000000000000000500020000001000003000000000000000000000050000
000000002000000000000000000000000010600000000000403000000000000000000000000000003001000000000000000000000010000000000600203000000000003000000000100000000000000000000000
000030001111100000000000000000000000000000000000000000000100000000000000000000000000000000001000300000000000000000000000101110000000000000000005313000000000003100000300
333330000000003000000000000000030001000000000005000000003333340003000000006003000000000040100000002000000300000000000000000000000000000000000303300000000000300003000000
333330000000000000000000000000000000003000000003000000003330300000000301000000000000100000000010000000000000000000000030000000000003000000003003000000000000300000000002
000330000000000000020220000000000201410110220001050000000003100140111000000000000000530040010111100001000000002022000000000000000002000000000003300000000002000000000001
303333333333333333333333333330303330030000333333300001003033333102000000000003300303000300000300050030303333303303033000313033330033000000003033300000000003333033033303
