000000000000000000000000000000000000000000000000000000000000000000000000100000100003030010000003300000000000000000000000000000000000001000000000300000300000000100000010
000000000000000000000000000000300000000050000100000000000000000000000000000010000000000010000005000000000010000000000000000000030003553000000010000001030000000000000000
000000000000000000000000000001000003040000000000000030000001000000000000000010000000001000002000000000030000000000003060003300006000040000000000000104010300000600000000
000000000000000000000000000000000000000010006000066000030000000000000003000000300000000000006000000000000060300000000000000010600000000100000000003300000000000000004003
000000000000000000000000000000000000000000000000063000000000000600000001000000000000000030036000000000300000001000000000000000660000000000001000000000003000000000000000
000000000000000000000000000000000000000300000000360000000000010000000300000000000000000000066000000010000000001010000000000000600000030022200000000203000030000000000000
000000000000000000000000000003330330000060000000033300000000000303031300403000000000000003303000000000000000000033330330333330430000033030333000020030333000000000000000
000000000000000000000000000000000000000001000000000100000001000000000000033000303002000000000001000000000031000000000000000010000000000000000000000000000000000100000000
000000000000000000000000000000000000000001031000003001000000000006000000000000000000000000000000000000000000000000000003000000000006000000000000300001000000000000000000
440000000003000200000000000044000000000300000030000005000200000000000044000000000000000030000000000000000440000003300000000021000030000000000000000000000004000000200000
000000000000006600000000000000000000000001000000020000001000000000000000000000000000000000000000000000000000000001000000000000000000000010000000001000100000000006600000
000000000000006600000000000000000000003000000000000000056000000000000000000000000000000000000010000000000000000000000000000000000000000000000000000000000000000006640000
000222020000006600000000000000022202000300000050000000006600000000000300002202000000200000000460000000000000022000300020000000000004000000000050000000000000102200600000
333333333333333330000033333333333031053303000010000000003300600000000003330330300333333333300333000000000303033030000000000000000000020000000030000003303333333333300000
