000000000000000000000000000000000300000000030000300000100000000000010000060050060000000000000000000010000000000000000000000000000000300000000000000000000000003100000003
000000000000000000000000000000000000004010000100000030000000000000000000000000010030000300000030060000000000000300004000030000300000000000000000000000000300000000003000
000000000000000000000000000000000030000010000000000041300001100300000000020000000400000000004606010302000000000003002300000000000000000020000002000030410000000000000000
000000000000000000000000000000000000000004000000000000000300000000050000660003000000000000000000010000000000000010000000000000000000000560000066000003000000062000002053
000000000000000000000000000000000000010100000000000003000110000000000000060000301100000000000000000066003000000000000000000000300000001660030006000000000000660030000000
000111100000100011100000000000000100001100000000002300000000000000000000600000001211000111100000000066036001010000011030000010000111100000060000300000220000660060000013
000000000000000000000000005500100100000000000005533330330303030001005033333003000003000000000000053333333000000000000000000000000000033030333333300033330003333300000000
000000000000000000000000000001000000000000000000000020206000010000000000100010000000000000003010000000000001000000000000000000030000000000000000003001000000001000000000
000000000000000000000000000000000000000000030000000000000000000000000000000000000000000000000010000100060000000000000600000000000000000000000000000000100000000000000010
000410000020000011100000200000000050003000000000001111000301000000000000000000000000000000000011003004100000200000000000000100000203000111000000000006000100000000011000
000000000660000000000006600000000000006000006600000000000000100000000000000000066001000000000016000000000006600000000000000000010600010000001000000000100000306001000000
000000000660000000000006600300000000000003006600100000000000000000000000300000066003000000000000000000000006610000000000010000006000001005000000000000000000000000000000
020220000660000000000006600600510110066006006600000000000100200001310000000100066006000101000000000204000100600000000010063200000600000030010011000000111100000000000000
333333333333000333333333333300000003333333303030003133333333303300601000000003333030000300000330333033333303300000003553313333333330003330330000100000000000000552133330
