000000000000000000000000000000000000000000100000000000000000000000003000000010000000000000000000000100000010000000000100606000000003000000000000040000003000000050000000
000010000000000000000000000001000100000000130033000000010003300000000010000103000000000000030000000006003000033300000000303030000010030000103000000000033000000000000003
000000000000000000000000000030000000001000000000000060001000000000300030000000000000000100000000030000050303010030000010000000000000000000000001000000000300000000050000
000000000000000000000000000033033000000300000000000000000000000000000000033000000000000000000000110000000000000001000011000000503300030133000000003000000000000000000000
000000000000000000000000000000030000000030000000000000000000000000000000000000000000000000000000000010000001000000000000000000000060000000000000000000000000000000000000
505500000000000000000000000000000000000500000000050050000000000000000100000000000000000000000000000000000000000000000000000000005500101100003000000000000050553000000000
000000333330000000000000003000000030000030000000006000033000000330300000003000000000000003000000000040000000000300000300003030000000300000030000000000300000000000030000
000000000000000000000000000000000000000000000000000030000000000000000000000000000000000100003000000300005000000000000000000400000000000030000000000000000000000000000000
030333000000033300000000001000000003000060000000300000000000003134000000001000100000000000100000100000100000000000000000000010300000433300000000000000101000000001000000
000000000000000000003300000000000006000003000000002000000560000000010000000000000000000000300000000000000000000000000001000000000001000000033000000000000300000003006000
000000000000000000003333330000000030000100000000000000030000010000000300000000000000000000000033000000000000010000000000000000000001000000000000000000000000000120335300
000000000000000000000000000000000003000000000000000060000060000000000000000000300000001000000303000000000010000000000000000000030000000000000000000000000000000100000004
000000000000000000000000000000000000000000000000000060000000000000000053500000000010000000000000005055010000000000011010000000030000000000000000000000000000000000000000
000000000000000000000000000333333000000100000430000000011000000000000001300030000030000000000000530330003300300000000003333300000000000000000000500000003033300000000002
