300000000000000000000000000000005040100000000300030000000000000300002300060000000030000000000000000300000100000300000000001000000000030000100000000000000303000003000000
000000000000000000000000000000000000000000000300000000000003300200000000000000000000020000000000001000600600000000000000600000000000000000000000000000020000000000050000
000000000000000000000000000000000000000000003030000000050001000000030000000006004000000300000300000033001100000000000000010010000000000000000000000000030600003000000030
000000000000000000000000000000000000000006000033300000000000000100033000000010000000000000000000101010333330000000000000000000030000060100000000000000033303030000030000
000000000000000000000000000000000000000000000000020030000000000000000000000000000000000006000003000000000000000000000100000100003004000000000000300000000006333000010000
000000000001300000000001111150000000011111100000010000000000000000000000601330000110000000020030000000000000002020000000000000000003000000006000000000000003303000060012
000000000000000000000000000033333300000000033300000000000000000003330300000010000000000000333330330303300063333303033330100000000000300030000333303033330030000000000500
033000000000000000000000000000000010000000033000000003403001000000000003000000000000000000303300000000000001000000310000000000000000000000000000300000000000000003000000
000000000000000000000000000000002000000000000000000006500000000000000000000000006000000300000020000000000000000000000100000000000000000000000000000000000000000000004000
000330000333000000000000000001000000000003030300000000000000000000000000033000000010000000000033000600000000000000003000000000000330000000000000003300003000000000000000
333330000003333300000000000050000000000001333330030000005000000330000033333000000000001000030030010005000000000000533000020030000013300000000000006000000033000000003000
333330000000000000000000000000000000100000300330000000000000000000000033330030000000000000003313000000000000000030333000000000000005000000000000000000000000000000000000
033330000000000000020200000000000003000130030330000000200000000000001003003000000000001011103133000000030010000003333000000100003000000111110000010000000000000206011110
300000003333000033333333333300000000000000300100000333300030030000303330000000333333006000030001000000000000000031000000000002033330000000000000000000000000333330000100
