000000000000000000000000000000010000000000000000100000050000000000000000011100000000000000001000000000000000000000000300000000010600000000000000000000001000000000000000
000000000000000000000000000301000000000000300000005000000000005000000000000005000000000000000000000030000510000000000030000000050000000000050000000000000100000005000000
000000000000000000000000000030033500000000000000010000000000000000000000023031000000000030000000000000300000000000000003000310000000000000000000000003330300000000000000
000000000000000000000000000000000000000360000000000000000000000000000000600000000000000000000010100000000503000000000000000000000010000000000030000031003000000000005000
000000000550000000000005550000000000050500010005000100300055000300030400000000000000300000000000000006050000000000500010050000000000000000000000000000000035000000000601
330000003333000000000000000000000000000000030600000000000030000030000000000000000000030000030000000000001000000050000010313300000000000000300300000000000003000001000000
000000000000000000000000000000500000000000000000000030330000000303630000003000003430333330000000300100000000303300000000000000000300033330330000033300000003333200003130
000000000000000000000000000000100300000000000000000000000000000000000000000000000000000000000000000300003000000003000000000000300000000000000000000000011000300000000000
000000000000000000005550000000000050000000000000000000000000000000060300000000000005000000000000030000005100000000000000001000003000500030000000001000131300000050000006
000000000333330000000000000000000000000000000000000000300000000300000010000000000000003333050010000003000000500000333330300000000005300000000030000000000000000300000000
000000000000000000000000000000000010000000000000000003000000500000000000000100001000000001000000000000000000000000100010000000000000000000003000000000000000000000000000
300000000000000000000000000010000000000000005000000010000000010005500000000000000000000000000550000000600000500000005000000000300003000000000050000065500030000000000000
030000000000000000000000000000000053300000033330003400000000000000000033000500000000000000000100000000400000330000030000001000030000033000000433003000001000060000000000
333330000000003333333000333303333330000000000000031033000000000000000000000003330333000000000000403333333050000030000003000000303030000000000000000000000035333300000000
