000000000000000000000000000000002010000000010000000000000100000000000000000010000000100010000000000000001003000000001000010000000000000000000000000000001005000030001000
000000000000000000000000003030001000000000000000001000600000010003000030000001000000000100000000000003030000000000303300000003030030000000000000000000010000000000000030
000000000000000000000000000000001020000000000000000000000030000000400000000000300002000000040000620000000300000000000000200002000000000000000000000000000000000000000000
000000000000000000000000000050000060000000300000000000000300000000000300000001000066000003000500660031000000000000000000000066000000001000000000066000000000100000000000
000000000000000000000000000000000660000000300000000000000000000000000000000003000066000000000000061000060000000000010000000303000003000600000300066000033300000000000000
000000000000000000000000000000000060000000000000000000000000000060000300000000000006000000000000660000030300000000000002000066000000200000000000006000600030000000000060
000000000000000000000000000333330330200000000000300030000000040033333000000003303330003000033003330000000030600000001033333333033310300000063333003330333030300000000000
000000000000000000000000000300000030000005030000000000000000000000000300000001000000030000000000000000000000002300000030000000000000010600000000000000100000100000000000
000000000000000000000000000350000000000000000003000000000000000003000000000000000033000000000000000000000000000300040500000000000000000000030000000010000000000000000300
000000000000020000000000000000050000000000000000000000000000000300000000000030000000000000000033000000004000000000001060000000000000000000000000006000000000000000000000
000000000000660000000000000000030000060000000000000000100001000000030000000000000000000000000000401000000001000000000000000000000000000000000030000000030000300000000000
000000000000660000000000000000000013000000000000000000000000300000000000300000000000040000000100000000000000000000000000000000000000000100000000000000000010000000000001
000000200000660000000300000030300000000000000000000000020000002360000060003030003030000000000000000000052300060000000000030003000000030000000000000000000200000000000000
333333333333333333330303000030000103303330000100333003300303333063000300000000000000000000003303303333330300000100000003333332000001030300000000003013336300000000000000
