000000000000000000000000000000000000000000000000000000100000000000000100000000000000000000100000000000030000003000000030410000000000000006000010003000000000000000300000
000000000000000000000000000000053000010000000200000000000000000000000000600000002000000000000305000000000000000000300050000000000000000000000000000000000000000000000000
000000000000000000000000000000010103000000006600000000000000000000000000000000066000000000010011000066000600060000101100000000000000001000000000100000000000000000000000
000000000000000000000000000001000300000000006600030010000000000000000000000000066030000000000000000066000000000040000000000300000000006000030000010000003000030001000000
000000000000000000000000000000000000000000006600000000000000000060000000000000000000000000000000000000000000050000000000000000000000040000000006000005000000660000003000
000000000000001000000000000002000000000600021330000000000000000000000040000000060000000200000013000066003100000002000100002000000003000000000002000000000000660001000000
000000000000000000000000200533333330333333333333000020000000005000200000030003333033303030333303333333330000000033333303330333000000000000050433133000000033003330000000
000000000000000000000000000000001000000000000000002000060000000100000000000003000000000000000000010000000002000000000000000030000000000004000300000000000000000000000000
000550000000000002000000200000000010006000000200000000000002000000000000006000005000000000000000000000000000000000000000002300000000000010000002000000000000051040000010
000111000000000111000006600000000000000003031100001003003010000000000000000000001010000000005110000100000001000000000000000030000000000660000050000000000000011100000000
000000000000000010000006600000000000000000001000000100000000000001000000000000000000000000000100000000060000003000000000010100000000000600000010010030000000000000000030
000000000000000000000006600000000000000000300000000000000100000000000005000540300000000000060000000000000005000000000000000000000000000660000030000000000000000000000000
020000000020000000000006600000000001000000000000000000000000000000000050000000000000000000100000000001000000000000000000000000000000001630000000000000000002000000000000
333333333333333333333333333301000030000000333303000000033300333003330300000003330331000200533033330000000000003000000003330003300000303323333333333000030003033330002015
