000000000000000000000000000000333300000030000000000000000000000000000000000000033300010001000100000000003003130300000000000000000000000000000003000030000000000000000300
000000000000000000000000000000010100000000000000030000000000000003000000000000000000001010000000000000001000000000000000000010100000000000000000000030000000000000000000
000000000000000000000000000000003000000003000000000000000000001000001000003000000300000000000000002030000000030000000000500000000000000000000000011000000000000000000000
000000000000000000000000000003333320000000000000000000000000300000000056003000033330300000000000000000000003303000000000000000000000010000000000000100000000000000001000
000000000055550000000005500000330000000001000000000000003015550005000000000000033300000030000000010005000033330000000000000000000055000000000001000006000000001100560000
000000000333330000000033333300010000000000000000001001000033303033330300000000000000030030000000000333303000000000000100030000000033000000000010000000000001000020030000
000000000000000550000000000000000000000000333030000000000000000000000000000003000000333053302000000000000300000000500000030003000000033330060550000000301033303333330030
003330000000000000000000000053000040000000000000000000000000000300000000000000000000000000000000000000000000002000000030030100000000000100000000000003030010000000000000
000000000000000000000000000000004006000100000000100000000000000000000000000000000001000000000000000000000000000000000000000000000000001000000000000000000000000000000000
000030000000000000000000000000000010000000000300000000000001000000000000000006000000000000000000000400000000000010000000000030000000000200000003000000030000000000500000
033333000000000000000000000001000000006000000100000000000000000000000001000000000000000000000300100000000000000000000000030310000003000050002000000353333000000000000000
003330000000000000000000000000000000055600000055000000003000000000002000000000000001000000000000000000000000055503000000003300100000000500000055000003330000000000005055
000000000000000000000000000000000000033330011333130000006000000000000000000000000000000000000100000100001003303300100000000000000000050303330333333000000000000500000333
300000033330033333333333003333300333100000000000006000003333000050000031304333331001133330305500000303003000000033300033000000000000000000000000000302000033330030000003
