000000000000000000000000000000000000000003000030000000000000000000000000000030000000000000000030000000000000003006000030000003000000000001000000000000000000010000000000
000000000000000000000000000000010000000003010000050000000000000000000000010000000000000000100000030000300000000000000000000003000000001000000000033000000060000000000301
000000000000000000000000000000000000300000000446000000000000106000000000000000010000000000010000100000000000000000000000330000001103000100610335003000000000110000404400
000000000000000000000000000000000300030003000000001000500000300000000003006000030000000000000660000000000000010000000003000000000030000000000331003000000000030000000000
000000000000000000000000000000000010036003000000000000000000000000000000000020000033000003000300000000000000000000060003300053000003000000003330000000000006000300000000
000000000000000000000000000230000010330003000220000000000000000000220010000000000030000000200000000000000000003001000023330000000003300000003330003030000000000333002100
000000000000000000000000005550300000330013033303300000000000000033330000000003033303003005533033030000011000000000000550300033031103310600003330333000000033333133333331
000000000000000000000000000300000000000030000000000000000000000000030300000000000000300000000000000000000000000000000100000000004000100000010000000000000000000005001400
000000000000000000000000000350000000300000000100000000000000020000000300000000000000010000000030000000010000000000003003002000000000000003000000000000000050000200000000
000440000020000011000033000300010000011000000013000000010000000030001000000000002000000000000044000330003001100000044000000005000001000020000002000006000000000000000003
000000000660000000000333000300000000000000000000000000000000030003000300000100001000000201000010003033003000000000000100300000000000000600050060000000000000000050000000
000000000660000000033333000300660000000030000000000000000000000303000200060000066000000003003000003300000000003300000000000000000000003600000166000000000000000000006100
000220000660000000033333000300660000000033000000000030020002602333001300004000016001000400000222003330003000003300022000000000000000010660000066000000001001000000010100
333333333333033333333333003330303033033333000000000000050030000013003300000000033300000000033333333330033333333333303330000000000000133333033303303030005500000003000000
