000000000000000000000000000000000000000000010100300001000000000000000000000000100000000300010400001000000000000000000003000000000000000030000000000000000002001000000000
000000000000000000000000000000500000001000000000000001000000000000100000000000050003000005000004000600000000000000200300000000000000000000000000100000000000030000000000
000000000000000000000000000000000000000000000010500000000000000004500000440000000000000000033100033000000000000000000000000000000003010000000000001300000000000010000000
000000000000000000000000000000000000000000000000000000000000000030100000000000000000010003300100000130100300000000000000000000000000000000000000000100003000000000000000
000000000000000000000000000000000000000000000000000101000005000000000000000000000000000000000000000003000000300000000100000000000000000003000000000000000000000000000000
000000144444000000000000000000000001000000020200000001000202000000000000000030030000000100004000010000000413440000000010201000044040000000100000001000000002020004440400
000000000000000000000000000003333330000000033333303333003103330000000030000030330033000000000000000000000003000000030036313330000600030300000000000300010003303300003010
000000000000000000000000000000000000030500000000000000000000000000060000000000000000004000000030000000000000006000010000000000000031003013000000000000000000033010000000
005000000000000000000000000000000000000000000000040000000000000000000000000000000000000030000000000000000000000100500000000013000000000000000050100000000010000030000000
000000044444000000000000000000003100010000444440000000000000000000060000000000001000444440000000000010001000000001000000000000000000044444100000000440450000000000000000
000000000000000000000000000001003000000300000000000100000000000000001000000000000000060000000000000000000000000000000000000000010400001050000000000010000003000000010000
000000000000000000000000000000000000000010000000000000000000100000000000003000000000010000100100000000000000010000000000000600003000000000000000000000000000000000000000
000000000000000202000000000004444000010000000000000003000000000000000100000004004400000000001000000000000020200000000000000000000000000000000000030000000000000000000001
333333330003333333333333330000003010000000300033300020000330300001300000000001000000300033033033000331333333033333333040000003000000030001033333033000033333303000000000
