000000000000000000000000000000000050001000000000000000000000000000000000030000000000000000000601000500000050000000000000000400000000000000000000000003000000030000000000
000000000000000000000000000000000000600002000050000000031000000000000000003000000000000000000000000000001000000000000000000000000000004000000000000301001000000000000000
000000000000000000000000000000030000300010500000000000000000003000000000014110000300000000010010000001001000000000000001001413110000000000010010000100141100000010000000
000000000000000000000000000010000000000000000000300000000100000000000000000000000001000000030000000000000000000000000000000003000300100000300000000000000000000000000000
000000000000000000000000000001000000000000041000000000000010000000000000000000000000330000000000000000000300000003000000000000100000000000000000104001000040010000000000
000000000000000000011100000000000010000000000000000000000000000000003000000001000000300010000000020000000000000010000000000010010000000000020000011000000000000020000000
000000000000000000000000000000000003033033000000300001003000000000030033033330000000000000030050333303333000000000030003033303000000333303300000000333303033301330000000
000000000000000000000000000000000000010000000000000000001000000000000000000000000000000000000000000000000000000000000000060000000000000000000000000000000000000000000030
000000000002000000002000000000002000000000000000030000000000000000000100002000000000000000000000220100000000020000000000000000000000000000000000000000000010000000000200
000000000066000000011100141103006001001401000000000000000000000000016100066000000000030000000003100003000000660000000000000030000000006000000000500000000001001001006000
000000000066000000000000000000306000000100000000000000000000000000000300001000010000010000000000000000400100661000000000003000000061000300000000000000000000000100006600
000000000066000000000000000000366000000000000000001000000000100000000303036000000000000000000000000100000000660000000000000000000060000000000600000010000004000601006600
000000200066000000002000000000060000000000000000200030000300001000000230066300000002000040300000020000011000000000000110000000000660000000000000000006000010000000000600
333333333333333333333333333333331333333306333333300000000000000313303333333033330003000001033333030000000433300300000000000000030033000333330033033000000000000003333333
