000000000000000000000000000000030030000000000000000000000300050000000000000300000000000010000000110000000000000000000000001130000000001001000000000000000500500000000000
003400000000000000000000000300000000000000000000000030000000000003050000000000000000000000003000000100000000010000000000000000000000005060000001100000000003001000000000
000000000000000000000000000033000000000010000000000000000000000000010000000000000000000300000000000000000000300000000000010003000000000000000000000000000000000000000001
000000000000000000000000000000001000000000000000000406000000000000000000000000000000000000000000000005000003000000000000000000000000000000000000000000100000000000000030
000000000000000000000000000000000010500000000000000000010000103000000000000000000000000000030020000101000000000300000000000000000000000000000000000000100000000000000000
000000000001110000000000000000000000022000000010120500010202100000000020020000000000000500202020000000222300010100002022000330000021200001110000222022200010002020000010
000000000000000000000000000033333030333333100000033333303330303000000003003000000000313333303333330033333000000000003303333030030303300000000033333333333131303330000030
000000000000000000000000000000001000003020000000000000000000000000000000000000000000000000300000000000300001000000000000000000000000000000000600000000000000000000000000
000000000000000000000000000000000000064000000000000000000000000000060000000100000500003410000000030006000000000000003033000633000000000340002000000003401000000000003333
000000000000000000000000000010000000000000000000000000000030003000000000000000000003000000000000000000000000000000000000000000000000000000000000000000000000300040000000
000000000000000000000000000000000000000000060200000000000000000003500000000000000000003010000000000000000000100000000000000100050000000000060000000005000000000300000000
000000000000000000000000000000000000001000000000030000000000000000000000000000000000000001300000000001000000000030000000100000000000050000000000000000000001000000000000
000020220000000000222022200000000000300000000030000002020000222000011100002000000000000030000000002000000000000012220000000000000000000000000600111030000020000001000000
333333333333300333333333333300000000000000010000003033311133003000300033330330000000000000000000003333330000000033330030000000000010000300000000000000000030030300000000
