000000000000000000000000003300100005233300000000000000030000000330330000000000000003000103033333000002000000001000001030000000300003500500000000000000012303000000333000
000000000000000000000000000305001000000000033333000000000000000000000000000000000000033033000300000000003030000000000000000000000003300100300000000000000300000000000000
000000000000000000000000000000003010100200000000000000000000000000030000000000000600000000600063000000005010001000000000000000000100000000000000000000000000000050000115
000000000000000000000000000003000000000000000000010000033000000030000000000000000000300000003002010000000000000000000000000000000003300000000000000000000000000000000000
000000000000000000000000000000000000000000000004100000000000000000000000000000000000000000100000000000000000000000000000000300000000000001000000000300000310300000000000
000500000033000000000000000000000000000000000000000000300000000000300500003000000000000000010000000003000000000000000000003306003000000050000003300000001000000001000000
000000000000000000000000000000000000000000300306000000000000001030000000000000000000000000010000000000000000033100000030000000000006000000200002000000000000200000000000
000000000000333333300000000000000000000033000000000000000000000000003000000000000000000003300000000000000000003000000000003000333330000000000000000000000060000300010000
033333000000000000000000000000000000000500000010000000000333330000000000300000001010000000100001000000000000000310000000000000000000003333330333310000000200000000000050
000000000000000000300000000000000000000000000000000000000000000000000000000000000000000000000000000000000500000000000000000003000030000000000000000000000001000000000000
000000000000000000000000000000031000100000000003020000000000000000000101000000000000000000000000400000000030000000000000000001000000300000300000000400000000000000000000
000000000000000000000000000000000000000000000000000000000300000000000000000000000000000000000000000000002000000000000000300000001000000000000000000000000030000000000000
000000000000000000000000000000333000000300000100000000000300000000000003033000005000000000000000000005000000001000000000003000000000000600000000300000000000003001005000
000000000000000000000000000000000000100000000001000000000000000000000000000000000000000000000000003003030000000000000000000000000003000001000000000000000000000000000000
