000000000000000000000000000000000000000010000030300300000000000000000300000000000000000000003300000000000000000060002000000000000300000000000000000000000000000100000000
000000000000000000000000000000004100000000000100010000000000000000000030000000000000000000000000000000030005010000000000000000000000000000004000000000000000000000000000
000000000000000000000000000003001000000010000000001020004440100000000000050000000000000000030060000005002010200143400020000030005010000000100000010004200000100400000100
000000000000000000000000000000000110300000000200000060000000001000000000000000000000000000000000000000000006000000001100002000000000000005003000000506600030000000000000
000000000000000000000000000000000010001000006600000660000001100000003000030000000600000000000001000002000016631001005010000000000000000000011000000000600000000000006000
111111100111000000000000000000000010000000000000000660020000031111131100003010000000001100011011110035000006600203020210060000000160000100033011100006640266600110003000
000000000000000000000000000000000110000000333303030303133003133000000003333000001000000000030030000333303301333333033033033300030030100000000000000333333300000000000000
000000000000000000000000000000000000000000000030000000000000006050000000010001000000000000000000000000000003000000000000000100000000000000000000000000000000100000000000
000000000000000000000000000000000000000000006000000000400000000000000000000000000000000000000000000000000000001000000000000000000030000000000000000000000000000000000000
444000000000000055000000200000500000000000010000004400000000000000200000000001030060010000000000000300000000000000000000000000000200210000000005000000000000000004440000
000000000020000000000006600000000600000006006000000010000000000006610000000000002003000000000020000500300000001003000300000000006000000000000000000000200001000030010000
000000000660000000000006600000000000000600000000000000000000000016610003000000066000000030000660000000000000000000000000000000006600000000000000000106600000000000000000
000202000660000000000006600200005000001100111110000020200000003006600200011000066000000000000300000002020000000003111106000010006000200100000010000006603000300000302020
333333333333300333333333333303033330000006010000013033330000300333303300000103333310000000031333303033300000000000000000000600333333600000000333333033333000000013003333
