000000000000000000000000000001100001000000000000000000010000000000000000000000000000000000000110002000000010000000000000000000000016000000000010000000000000000000010000
000000000000000000000000000300000000000000000000600000060000006000000010000000500000000210000000000000000010000000000030000000003000000100000005000000000000000000000200
000000000000000000000000000000020000000004000300000000000002000006000400000000000010000000000000000000004000000000000200000000000001000000000000000000000000000000006600
000000000000000000000000000000000000000010000000300000000066000000000030000000003000000000000000000000000000600000000000000000000000000000000300000000000000000000006600
000000000000000000000000000000600000000300300000000000000060100000000000100000000000000000030000000000000006600000000000000000000000000000000000000000000100000100006600
000000000000000000000000000000060000000000000000000010000006000000031000000100000000000050000000010000000016600300000000000000000000000000000000000000000000000000006600
000000000000000000000000000033313333333330300000000000003303303303333000000000600000000000033330333013333033303300000003300303000000000010003333303003000010000003333333
000000000000000000000000000000000000000000000000003000010000000030000000000000000000000100000000000000000000000000000000100000301000000000000000000000100005006000000000
000020000000000000000000000000000000000000000020000000030000000000000000000000000200000000000002100000000000000000000000000000000330000000300030000003003000000030000000
000660000000000002000000000400000000030000000000000005000000100000500000000000216600000001000060000010020000000000006000000030000000330000100000000035000000000000002000
000660000000000066000000000000000000000000000660000000000000100001000000000000206000033000050002005000000100000000006000066000000000000000100000003100000000610000066000
000660000000000066000000000030000000000000000660000000000000000000003000000000006630001000001060000000000000000000060000063000000000000000000000000500000000000000066000
000660000000000066000000000000100000000000000600000010300000000000000000030000006030000001000003000000000000000000161000066000000000000300000000000001000000000000066000
333333333333333333333333333330330030000000303300300000000100300333303010000003333333000000031033330000000000000030333330330333000000130333333053333200000000000003333033
