000000300000000000000000000000000000000000000000000030000000000000000100010000000000000000300000000100000000000000000100000003000000000000000030000000010000002100000000
000000000000000000000000000030000000000000000000000000000000030000000000000000006000000003000000000000000303000600000000000060000000100004000000000300000000000000000000
000000000000000000000000000033300000000000030000000000000000000000000000000000000003000000010001000030000333000000000000030000000000000100000000000013000000000003010000
000000000000000000000000000033000003360000000320000000000030000000003000000000000030300000000320000006000330000000102000000000000200000000003000000030000000000000013030
000000000000000000000000000030300000000000000010000000000000000060000000000600003333000000000200003000000303000000000000000100000000000000000000000333000000300000003330
000000000000000000000000000003300000000000000000000000000100000000100000000000003333003000000020000000000033000010006000000000000000600010000000000333101000000000003333
000000000000000000000000000003333330000000300333310052000003000100000100000013300300000000033333330030000003033003333030000010333103300000000000000330303300006003330010
000000000000000000000000000000300030000000000000010001000100000000000400000130003000030000000000000000006000000000000000000000010100000000001000000100000360000005000030
000000000000000000000303000000000000003041000000000000000031000003300000000002100000000000000000000000000000000030301000000000000000000001000000000000000000003000000000
000000000000000000003333000000000030000000000000310300000000000033030000000000000000000000000060000000000000000300300000000130000000000000134000300000000000000000000000
000020000020000003033333000000000000000000000303300120500000000333000000000300000000060100000000000003200000300333300000000000000000000000130000030000000030020010000000
000000000200000003333333000003030000000000400333300200500000000033003000000000020000000000000050000000000300033333300100000000000000000033330000000000000000200000010010
000000000020000003333333000000000000000000000130300000000060000333000000000030002000100000101000000000000000003360300000000003000100010033330030000000000000020010001500
333333333333333333333333333303000000000000033331333035033303333333303300000303330303040000004030000333303330333333030033001000000301000333330000001000000003333301333030
