000000000000000000000000000000000005000000010000000000000000000000000000000000000116500000000010000000000000000000000000000000000000000000000000000003000000000000000003
300000000000000000000000000030000000000000000000000000100000000002000410000001000001000000000200003000000000000030000000000001000003100000000020000000000001000000000000
000000000000000000000000000000000000000000000030210000030010000111100100000000000000000000001610000000000000000000000001000000000000000000001111000600000000000000000001
000000000000000000000000000000005000030300000020000000000000000000000000000000300000000000000000000000000000300000000000000000000500000000000000000560001000000000000100
000000000000000000000000000000000000000000003000600000000000000000000000000000000333000000000000000500333000000000030000000000000300000003000000003060000000000330000100
002000000000000001111000000000300000000000000006003030000400000000000000300000003030010000000000020003300000301100200000001110000000000031300501002063000000010300001130
000000100000000000000000000000003060003003030333000000000000100333213301000013330300000021033303333333300000000000000001000000100000003333003034333331033333300000000000
000000000000000000000000000000000000030000000001000500000000000000000000060002000000001000000000000000000000000001000000000000000000000000000000001000010000000000000040
002000000000000200000000000000000000003003302000000000000000030020000001000000000000000001002500000000000300000100000000020000020000060000000000000000000003000003000000
111100000000006600000000000200300100030000111100066000000000000660000000000020000000000000065000000000000000000300010003011000060300000000020000000000000200000000000000
000000000000006600000200006600000000000003000000066000000000000060000020000601000000050000066000002000006000000000000000000000630000020000600000000201006100000000000000
000000000003336600000000006600003300000000000000006000000030000630000004001660300000000000066000000100066000001000000301000000060000000010600000000000006600000000000000
000000200033306600000000006603003306001011000000060000000000101610000000000660000000000000066033010000066002000000000000000002660000000000600100000000056600000000320000
333333333333003333333333333333033000000000333330330323031000000330333333333036003000000000033331333133333006000100000000305003303330033000330030000330333300300000400501
