000000000000000000000000000000000000005000000000000000030000000000000000000000000000000000000000000000000000000000000000000000000000000000000000000000500000010000000000
000000000000000000000000000000030000000050000100000000330000000000000000000000001000006000000000000001000000000000000000000000000000000000000000000000100001000000000010
000000000000000000000000000000000000000000000030000003300000001000000000000000300000000000010000000000000003100000000000000000000000000001100000030300000000000000000000
000000000000000000000000000000000000000000030000000033330300000010000000000003300030000000000030003310000000000000300000000000000000000000010000000300001000400000000100
000000000000000000000000000003000000000000333000000333330011000000000100300003330000000000000000000330000030000003000000040000010313000000000050000330000001000000000000
000000000000000000000000000010000000000000330010203330300000000010000000030003300002030000000003003330001000000003000000000000000000000000000000000063000300000000000000
000000000000000000000000000001100000000000333300331033030000000000000000000003333303000000000001000030333003000000000000101000000300000330530000000033333030000000000000
000000000000000000000000000300010000000000000000100000100000000000012000000000000003000010300000000000000010000000000000000000000000300003000000000000000300230033000000
000100000000000000000000003300300000000000000000000000003000001001000000100000000000000003300060000000000000000000000000030030000000000000000000000030000500000000000000
000000000000020000110000033300000000000006000000000000520000100000030100030020000333000003300100000000002000311000000000000000000030000000020000110000033300000000000002
330000000000660000000000333300000010000010000001050000660300000000000000000660003333000333300000000000060000030060000003300000000330300000660000000000330300000000000066
333000000000660000000003333300010000000000001000000000660003600000000000000633030303000330100001000000006000000000100000000000001323305000060000000003333000003100000066
333000202000660000000033333300000000000000000000002001664000000016000002000060333333031330600030100200606000000000000000330002033340302500060110000033303300000000230006
333333333333333333333333333333033330010000005006033333003633333030000031003333330303033331300000203003330333033300000003030330330333333303333330003330000300000003536030
