000000000000000000000000000300000000000000000000300000000000303000000000020010000000000000000330010003003001000003000010000000000101000000000000300003000000000000000000
003000000000000000000000000000000000000500000050000000000000000000000003000000001030064000001100000000000000100000000000000000030000103300000030000000300000300000000003
000000000000000000000000000000000000000000000000000000000030000003130000000000000000003300000003000003000010100000010003000000000000000000000000000040000000000000000000
000000000000000000000000000000000000030000000000000000000000000000000000000000004000000000066033330100000000000000000000100005003000030000000000000661333000300000000001
000000000000000000000000000000003000000000000000000000000000000000030600000300000000000000066000010300000000000002003000000000030000000000030000000600000000000000000000
555000000000000000000000005000000000000000000005000000000000010000000000001000000010000000030003000000050000000000010000000000003000005530005330000530000000000000000000
000000333333000000000000000000000330030033000030000000000000000002000001000000000033000000033000000000000000003333330000000003333333400000060000003030003000000003333031
000000000000000000000000000000040000000000004000000000000001000040010000000000003000000005000000000000000000300000003000000000000000030000060000003000000000000000000600
000000000000000000000000000000000000000000000000000000000000000003000000000000000000000000103000000030000000000000000001003000000000005000000000000000003000003000000001
003330000000000000000020000000010000300000000000002000000000060000000002010000000000300000030000600000000000005000333000200000000000000000005000010000000000330000000001
000000000000000000000660333300000006000000600100030031330000000000000366003330000000000000000000003000600000000000000006600303000000000000000000300000000000000000000000
000000000000000000000660000000000000000000000010036000000000000100000066000000130000000000000000000000000000500000000006600006000000000300000013000000000000013000000000
000000000000000000000330000005500000000003000000030000000000000001000030000130003000000000000000305550000000000000300003300000000005000000000000050500000000000000300000
000000000000333333333330000000000033033030100000033000003333300000000303000003333033000000033333000003003033333300000003300000060010000001330000000400003300000003335300
