000000000000000000000000000000000000100000000000000000000000000000000000000050000000000000000000000000000000100000000000010000000300000000000136000000000000003000000030
000000000000000000000000000000010000000000300600020000000000000000000000000000000000000003000000000010000010000030100000000000000000000000000000000000500000000000300000
000000000000000000000000000000000000000300000000044300000000100440040040000000000000040000000000010000000000000300000001000044000000000000400000500000000000300004400000
000000000000000000000000000000000000000000000000000100000000000000000000000200000000000300001000000005000300000100000000000000000000000000000100020000050300000000000003
000000000300000000000000000000000000000000000000024000005000000000000010000000030000000001000000001000000003000000000000000000000003000000003000001303030000000003000000
000000000000000000000000000000000000000000330000020001000000000200001200000000000000101100200000000020200000300002202000000200000000010000000000000000003000000000100002
000000000000000000000000000000000000000000000000003333330300000300333333030330000030330433333333330633303000000030003033033030000000010000133333333000000000000013330030
000000000000000000000000000000060000000000005010000000000000000000000100000000000003000000030000000000000030000000000000030300000000000010000000000000000010000000000000
000000000000000000000000000000000000000001000000000110200300000000001000000000000000000002100000000000010000000000000002000000000000000000000001000000003000000000000000
000004444000000000000000000000000000000044000001100010000100044000000000000000000000000000000000000000001000000044000020000060000300000100000000000600000000000000000001
000000000000000000000000002003000000000001000000000000000000000000060000000000003030000002030001000000000200030000000000000000000002000010000000001010000000000000000003
000000020000000000000000000003303000000000020000000000030000000030000000000000003000000000002000000000000000000000000000030003000000000600400000000000000000000300000000
000000020000020220200000000000000000000011000030000203000000020000505002200000000300000000000000000000000000000020000020000000000100030000000000000022010000000000000000
333333333333333333333333333300000003300330333333330333333303303000000033303330000000333000300000000000000000020033333330000300333330100000000000000333333300000003330333
