000000000000000000000000000000001000001000000000000000001000000003000000300000000003000000000000000000000000000300000000000000000000000000000000000000000000000000000100
000000000000000000000000000000000000000000000030000000300000000600000000000000000100000000000004000000000000030005000000010300000000000000000000000000000000000000000300
000000000000000000000000000000000000000000003330002000000003000000000000001000000000000000600000000001000000000106000000030300300000000000000000000000030000000000033300
000000000000000000000000000000000050000000033030000000000000000000010000000000000030000001004000003000000000000100000000030300000000000030100000003000000000000000330300
000000000000000000000000000000000000000000333330000000000000000000000006000000300030000000000000000000000003010000000003323000305100000000000040020000660003001000333300
000000000000000000000000000040000033000003333330000000050000003000000020020500000000030200000000030000000000030000000030333300000000020000000000000010661000000003333300
000000000000000000000000000013333330000000333300000000001333033000003000033330000000330303300013330000006000000033033333330000000010033333330000030331333300000003333000
000000000000000000000000000000010000000000010000000000000000000000000003000310000100000300000000000001030000000000000000000000000100000000000000000000000000000000000005
000000000000000000000000030000000000000100000000000000000000000000030000000000000000000000000000000010000000000000000030000000000000400101000000000006000003000033000000
000000000000000000000003330000000010000000000000000000600001000003130000000000000000000000000000002033101000000010000000003000000000600000000000000000000000000000000000
000000000002000000000033330000000000000000000000000002000003000030330000000001103200000000000002610333300000000000010000000000100020000000000000000000000000000000000020
000000000066000000000333330000000000000300000000000006000000050033330004000000003600000000000066033330300000000000000001000000000660000100000000000000003500030000000010
200200000066000000003333330000020001001000200030000000100000000333030000000000006000160000000066003030300005010000000000013000000661000000003002000000000300000000000300
333333333333333333333333300000000000000000363333333330330000000303300000000301330303000000030303030333000000000000000000000001303330000000003130133033300300000011000000
