003000000000000000000000000000000000000000000000000000000000000000000000300000000000305020000000001000000000000000000000000000000030000000000030000000060303006000000002
000000000000000000000000000000000000000000000000000003000000000000000000000000001060000000000000000000000000000000001000000000000000000000000000000000000000000100000000
000000000000000000000000000000000000000000000000000000000000000003010000000000300003000000000000000000000000000000041010400000030000000000000000000001000000000000004100
000000000000000000000000000000000000000000000001000000000000000000000000000000000000000000003000000000000000000000000300100000000000000000030000100000100000000000000000
000000000000000000002000000000000010000000000333000000000000000000000000000000003000000000230003000000000010000000000000400310020000000100320000000000000300000000000000
000000000000000000111111001130000000110011003000000030001110001000010000000003000020000011100000000005010011101330000000000000110001010001110000000000001111000120030100
000000000000000000000000000033333330006000300000010005000000000333333300000003333033000100030000000000000000000003331303000000000000000010100000100000000000000003333333
000000000000000000000000000000000100001000000030300300000003000000000000000000000000000000000000000000000003300010000000000000003000000000000000000000000000000000000300
000000000000000000000000000000000000000000000000000000000000000030000200000012000000000000000000000000000030000000000000300360000000000000000000000000000000601000000000
000000300000000004141000010000000000001133100410103000000000000000000000001410001000060010000000030000101300006000000000000000000001000003000000000000030000000030030003
000000000000000000000000000000300004300000000000600000000000000000000000000000000300000003000000000000000000000000000100000000010600000600000000000000000300000000000010
000000000003300000000000000000001020000000000000000000000000000000000110000000000300000000000000000500000500000300000500000000000000000000000000000000304000000300000010
300000000000000000000000000000003110000000000000000000001000111000000001001000000000000010035004000000002000000000000100000020000000030000000000320060020000000003000000
333333330000003333333333333300000003333333333333300000000000000040000133333303000000313330333333303330333000000033333300000000050000030333330000300300313330000003333333
