000000000000000000000000003003000000000006000000000000000000003000000000000000000000000000000600000000000000000000010000000500001000000100030000000030040000000000000000
300000000000000000000000000000000000300000000000000000000000010000000000000030000000000000001100000000000000030300003300011000000030030000000000000000000030003000016333
000000000000000000055000000000000050000303333333000031303303330000001500000002000000003333000000030100000000000000000003033010000003300000003330330000000010000030000010
000000000000000000000000000000000000000000000000000100103000000000000000000000000010000000000000110000000000030000000000000000030000000000000000300000300000000000000000
000000005550000000000003333000030000000000000000000000000000000000003005000000055000000000000000000550000000000005550000001000000000060600000000000005500000000000100000
000000003333000000550000000000000200000052000000000000000000600000050000000000030300000300010000010330300000500003313003000000000000000000000006000033330000000000000000
000000000000000000000000000000000000003000000000000033010000003000000000000000000000000036000000000300000010000000000000000000000330004200000000000010000000000000060000
000000000000000000000000000000010300000000000000000000000000030000100050000000000000000000000000300000000000030000010000000000000000000010300000003000000000000000000030
030000000000000000333000000003000005000330000000030300000010000000000000010003150000330000000316000000000003000033000100000000000033300000000000000030000000000000000000
000000333333300000000000333300000036100000000000006030000000100000333300000030000000001000000000110000015330033000000000000050000000000000000003333000000300000500000000
000000000000000000000000000000000000000000020000000003000000000000003000000000010010000000000060000000000000000000000300000000000000000000000000000000000000000001100000
000000000000000000000000000010333100001010055500010000000033330000003000000000000000000005000333300000000000000000000010000000000003000103300000000000000300000000033030
000000000000000000000000000000000000000000000000000000000000000000000000030010300000000000000000030000050000000001000030100500000003001000000000000000100010000100000000
000000000000000000000000330030000000000001000000000000000000030001330000001000000040000000060200000000000000000104000600000000000000000030000000100000000000000300500000
