000000000000000000300000000000006000000000010000000000000530300000003000000000000000000000003010000600000003000000000010000000000000000003000000013300000400000000000105
000000000000000000040000000000000000300000000000000000000000030000000000000000000500000000000000000000100000000000000000000000000005000200000000040000000010000000100000
000000000000000000000000000000400000000050000000000000000000000000060000001000050000000000100000000050000000501000300000030000104000000000000000000005530300000000400000
000000000000000000000000000010000000000060000000033000000000000000000000000030000000000000000000000000000003000000020030000000000003000005000000200000000000030000000000
000000000000000000000000000000000000500061000010000000000000000000000000000000000000100020000000000000000000000000000000000000000000000000000000000000000000010000000000
011111111111000000000000000000000521101100000000001111110300000031300013110000000000111113000000260000000100000000001000111000000200200000000000000000000001101100002120
000000000000000000000000000033033030000000003300300000000000000013333300000003330330000500000333330033333033033300000000000000033333300330030000000313303300000006303033
000000000000000000000000000005000000000300300000000013300000000000000000000000010000000000002000000000000000030030000000000300000000000000000000001000000000000000030000
000000000000000000000000000000000000000040000000003000000000000000000305000000000000000000000000000000000000001000000000000100300000000015000000000000000000000000005001
044000000000000055000000000000500000000000000000000000030000001044000001000000000100000000000400000000060000000000003000000000000000000550000000000000000001000001000001
000000000000000000000000000000300000000050000000000000001000000000000030000000000000000000000000003000000000000000000000000000001000003000040000000000200000400000004000
000000000000000000000000000200100000000000330000040000020000000000000000300000010002000000000000000000000010030000000000000000300000100000000000000000000000001040000000
000202200000000000000000002600000060000000000000000000260000000000102001111010000526011011100000020000000000000001100111000101000606600000001111100000000000000000000006
333333300333333333333333333333303300000000000000033333300000000333033300003000033000000040010133330000000000002000000000000000003303303333330000000003333300000003330010
