000000000000000000000000000000413330000002000100000006000010333000000000000010000000000001000600100000000000033013000000000000000000000303000000000030000000000000000333
000000000000000000000000000000033330000000100000000000000001333000000000000000000000000030000000000000000000030300204000000000000000000300000030000500000000000000000300
000000000000000000000000000003333333000000000000000000000333303000000000014000000000000000000000003000000033303313004000000000001100000001000000000000000000000000033330
000000000000000000000000000030333330060100000000000000300033333000300000000000001000003000000000000100050330033300000000300000000000000040000000000000000010000003330303
000000000000000000000000000033310330000000000000000000003333333000000000000000300000200000000000000000000003330300000000000000000030330030300010000000500000000003303333
000000000000000000000000003333303333020030000000000000003033333000000000000000000000000030000000003000003003003300000000020000000003300000010000000000000000200003333303
000000000000000000000000003333030300333333000000000010503333063300000033013000000000000000000000000000033333301333331330330333333033300000000000000100003133333013303023
000000000000000000000000033300000000000000000001000010000000030000000030000000000000010000000030010000000000000001003030000000000000000000000000000000000000000000000001
000000000000000000000000333300000000010000000000003000000300000000000030003000200001000000000300001000000000000100033330000000000000010000000000000000500100003000000000
000140000000000011000033333300004000011000300000300000000003000000001000000100005000001000000100030000000000000003333030000003300000000000003001401000000000100000000000
000000000000000000000333333300000000013000000000000101000000000000000000000000050000000003000000006000000000005033333040000000000000000000000000000000000000000000000000
000000000000000000003333333300000020000013000304000000000000100000032000000000000003006000000000030000000000000033333036000003000000000000000000060000030000000030000000
000200000200000000033333333300000000000030000000510000330005000000303100000300000033000000000000310000000100200033033330000003000300000000000002000000000000000330000600
333333333333333333333333303333130333133330000000000000033003330000000300000003113333005000030333330330033333303333030300000030000000000000000033303000000033103030000503
