000000000000000000000000000000000000000000000000030000300000000300000001000000000060300000600200000000000000000000000102000000000010000000000000000050000000000000000000
000000000000000000000000000000000030000000003000030300000000000313000000000030000030303000000100003000000000000003000030000000003000000000400000000000000100310000000000
000000000000000000000000000000000300000000000005030003100030050000000000000300000000300000000000300000000000000000000330000000000000100000000000000000100000000003000000
000000000000000000000000000000003300000000000000030000000000000003000000003330000000300000000000000000000000000000000300000000301000000000000000000000000010000000000003
000000000000000000000000000010333330000000000000030300010020000301000000333300000000300000000001000050000003001000030304000000000000000000000000000000000000000500000000
000000000000000000000000000000033333000000030001230010003000000301012000033330062002300000000000000200000010000300036300000000300000002100000000000000000005000000000000
000000000000000000000000000033333310000000330330536030330100100333330333333333333303303033300000001333133000100033300330000000333133333333330000100000000030330330001000
000000000000000000000300000000000000000300000000000600000030000000100000000001000000000000000000000000000050000000000000000000000000000010000000000300000050300000010000
000000000000000000003303000000000100000300000001000000000410000000000000000010000000000000000005000000000000000300000000000000000000500000300000003303000060000000000000
000000000000000000033300000000000000000000030300000000000000000000000000000000500100000000000000601000000350003300000000000000100000000000100000033060000000000000000000
000000000000000000333300000000000000010000300000000000000000000000000000000000000000000000000000100000000000033300003000000000000000000000000000333300000000000000000000
000000000000000003333300000000000000000000000000000000000000130000000000000050000000003060000000000000000000333000060000000000000010000000000003333300000000100000000003
020000000020020003333300000000000000200001030000000000000000000000000302300300000000001000000000020000000000333000000031000000100000100120033000333300300003120020000000
333333333333333333333333333300001000333003000000000000000000500000060003331300001000000000033330033510000333333300000000000000000000030300033333303333333031310034100000
