000000000000000000000000000000300000000000000000004000501000000300000000000000000011000000003000000000050100000000000500000000000000000000000000000000000001000030000000
000000000000000000000000000000300000000000000000000000000000000000030001000000000000000000000000000000000001001000000000000001000010000000000600000030000000000006000000
000000000000000000000000000000000000000300000000000000000000000600000300000100000000000030000000000000000000006000001100000000003000000011000000110000000000010000000000
000000000000000000000000000033010010013330000000000000000000003000000003000000000000030330000001000000000000000000000000000000001000000010000000500000000000000003300000
000000000000000000000000000000000003300303000000000103000000003000000000000000000000033030000006000000000000000000000000030006000000000000000000030000000000000000000000
000001100111100000000000111103000200100300000511100500002200502003501100101100000000000030000011114000000000101310000000000110001110003000001000000000000100011116010060
000000000000000000000000000003033033003000000000033000000033033000010030000000000000300304000030003300000000000000000000000000000000003330033000000000000000001000303330
000000000000500000000000000000000000100000000000030000030030050000300000000000003000000000000000003030000300000000000030000000000000000000000000000000000000000000000000
000000000000000000000000000000000000000000000000330000000000000000000000000000006030000000000000000000000000000000000001000000000000000000000000000000000000000001000000
000030000001100000000000000001030000000000000000000000000000110000000000000000000300004100060000000000000030000000001500000000000100000030000000000000030000000000000030
030330000003003300000000000003000000000000000000000000000000300000003030000000303300000000000000000000000304011000000003300000000030000000100000300003330000000000000300
333330000000000000000000000000000000000000000000000000030000300300040000000010303300000000050000010010001000000000000000020000333330000000000001000333130000010100000000
000030000000000000020220000201000120011100000000022000020000000006001400000200000360220000001000000051300100002300000000000020000030000001110001110000000002000020000000
300300033000000333333333333300000000000000003000033531333300000000000003303330003000030333303000000000000033133300000000033303300000005000000005030100300533300000000000
