000000000000000000000000000030000000003000000000000000000000010000000000021031000000000000300000000000000001000030000000000030000000000000000003001001304000000000000000
000000000000000000000000000000000000006050004000000000100000310001000000000000000000000010000000000001000300350001000000000000000000000000000000000000000003000000005501
000000000000000000000000000000000000000000000110000000000000000000000000000001300000000000000300000000000030000100010000000000003000000000000000000000050000000000000300
000000000000000000000000000000000500000000000000000000000000000000030000000000000020000000000000000000020000100000000000000000000000000000010000020000005030000000000000
000000000003332000000000000000000000000000030033000030000000000000033300053000000030000000000000000000330000000000000002030060300000002003030000033400100000000000300000
000000000000000000000000011100000000300000000000000010000000111000000000100000000030030011000000000000040000000000000000000000400003000300020000000010001100000000000000
000000000000000555050000000033333330010000000500000550500000300030000000100003333303100000000000003350000033330633331330050000000000033300000330010030000000550500003333
000000000000003000000000000000000000030050003000010000000000000000000000000300000000000000500000000000000300005500000000000100000010000300000000000200000030000303000000
000000000000000000000000550000010000000100000000000000010000000000050000000100001000003000000000000300000000030003200000000000000000000055000000000000003000000000000030
000000000000000000000000000100300300000000000006000003500000000020000000000000000000000000100000000032000000000000000000000000000000000000010000000000000000100000000000
000002000000000000000000000000000000000020000000000000600000000000000003000630000003000000000030000000000000000020000000000000000100300000000000006000000000000000100300
000033330000000000000000000030000010000303010000000000103000000000001000000003000033300033130001000000000000030000000000000003000000020000003000000000300000000330000000
000000000000000000000000000000000000000000000011500000000000010000000400000000000000000000000003030000004000000000001000000000003000010000000001003000000000000000000000
333000033330333333333333333330030003330000000060033331033033003300300305550500000000000000003030330550052330033300000000000000333003303301333130030000000000000003313303
