000000000000000000000000000003000000000000000000030000003100300035000000000000001000000000003000000030000100000003000000100100000000000000001000000000000000000050000000
000000000003000000000000000000002000000000001030000000000000000000000000000000000000000030000002000000000000060006003000100000000000000000000000000000200000003000000300
000000000000000000000000000000006000066000300000000000000100002000000000000000000030000000000060000000300000000000000000000000000000000020000000000006600000000003000200
000000000000000000000000000000060000006030100000000100000360000000000300003000110000300000300060000510000006600100000000000000006100000660000000000006003000001000000000
000000000000000000000000000000006000066000000000000000300063000000000000000000000003003000000006000000000006500000000000000000006600000660000600000006600000000200000000
000000001110000000000000000000006000036000011100000000000060000000000000030000000030000000000066000000000006630001000100001000030630000660000000320006000001110010000000
000000000000000000000000000033330330300330000000000000033333333000000010011000010000000010030330300000000303303300000002000000343303330033030003000133330300050000000000
000000000000000000000000000000000000000000000000000000000000000000006000000100300000000000001000000010010000000000010003000000003000000000030060000000003000000000000000
000020000000000000000000000000000400000000000300001000000000300000003000000000010200005000005000000000000000030000600400000200000000000000000000000000000000032000000000
000660000020000066000000200000020010000000000201000000000000000000000000660000003400006600000020000000100000100000030000000600006505000000000060000000000000060000002000
000660000660000066000006600000660000000000050600000500000000000306000000660000016600005000000060000000000003003000000000016600006600000000000066000002000000060000066000
000660000660000066000006600010660000000000000610000000000050000006600003060000006600006600000660000000000000000000000000006601006630000000100066000000000000066060066000
000660000660000066000006600000060000003000006600033006000000000006600040660000056000006600100661000000000011100000000000000600006600300000000160000010003000066000066000
333333333333333333333303333333333300000005300333300000000000000300003330333333003001033333300333000000000010000000003003333330333033300000003103033000000003030333450433
