000000000000000000000000000000000000000000000000000010010200000002000000000000000005000030000300000000100000000000000000000000000000300000000300004000000000000000000000
000000000000000000000000000000000000300000000000000000000000600000000000000000000200000100000000000000003000000000000000000003150000000050000000000000000100000010000000
000000000000000000000000000000000000000000310000000130000001001000000000003000040000300000000000000000001000000000000000010033000000230000000001000210003300000003000000
000000000000000000500000000000000003000000300000003030010520000000000050000000050000301000000030000000003130300000000000000033300206630000000000030000003003030000000000
000000000000000000000000000000000000000000335000400330000000000000030003000000000000300000000000000000033000310000000300016030050006033001600000000000333003000000300000
000000000000000111100000000000000000000000310030000030000000000000000030000000000000300000010000005323330030300000000000523303300100633000010000000000333303303063300503
000000000000000000000000000000003000003000333033333333000010000000000000333333000000333033000000003333333030330303003000330030333333333333330000000333532333333303003033
000000000000000000000000000000000000000000000000400000000050030000000000000600000000000000000000000003000100000000000030000000000000003000050000000000000000003005060300
000000000000030000000000000000000000000003000000000000000000103000000000000000000001000000010000000000003000300000000000600000000000000010000000030000000500000000000000
000300001100333000000000000200000030100033300001001000020110003000000210003000003000300000000001000000000000000000030000000000000000030000604000002000000000000000000000
030300000000333000000200206600000030000033000000020000660000603201200600005000003001203006600000000000500000000003030000000000000000000005002002060001050000000000000000
033300000033333300000000006600000001003003004000000000650003333000006000000000333300350006000000000001000000000000000000000000000000000000001000060000000000000000000000
033300000233333300000000206600000000023333011110000020000023333000201001101000033000030206600000300111000000000603334000000000000000003111000002066013000000000001000000
333333333333333333333333333300000003333333000000003003333330335333303003000000301333333033300000000000000001050033333310000000000000030000003303033000010000000000000000
