000000000000000000000000000000000000060000000000000000000600003300000000000000000300033000000000003000300001000000000000000310000000030001000000000000000100000030000110
000000000000000000000000000000000003100000000000000000000000003000000001000300040000000000000000100000000010000000000004000000330000330000000000003000000003000000010000
000000000000000000000000000000000003100000000100000000000000030000000000000030000000000000000000000000100000000000000000000000000003330000000000003000000003000000000100
000000000000000000000000000000002003000000000010100000000000330000020000000000500000000000000000000030000000000000000030000000001033300000000000203003000000010053000000
000000000000000000000000000001000003000000000000200000003003333000000200000000000000100000000000020010050000030300010000000000000033330000000003303000003000003000000000
000000000000000000000000000000000000000000000000000000000033303000000100000000050000000020000000000000000000000000000000006000003033030000000033303006000000000000300001
000000000000000000000000000003001000000033333033300000003333333300333333333330050000303333333333330000000000400000000000000000300333300003033333333000000035000030000000
000000000000000000000300000000000003000500000000000000000000000001000000000000000000000000000000003000000000000003000000000000000000060000000000000000000000000000000000
000000000000000000003300000000010000000000000000300000000000000010030030000000000000006000000000033000000000000000000030000100000000000000000000000100000000001000004000
000000000000000000033300000003000000300400000000000000330000000000000030000000000000000000003000000000000000000000000000000000001000000000003000000000000000000000000000
000000000000000000333300000000000000000000000000000003333000000003000030000000000003000050000123330000000010000001000000000000000000000000000000000000000000000000000100
000000200000000003333300000001030001000030000010000030330000000000000000000000001030003000000033033000000000000000030000030001000000500000003030000000000300000000000000
000000000000000033333300000000100000010000000000000033030060003000000030000000000000000100000333300000000100000000000000000000000000000000003000106000000060000000000000
333333333333333333333000033303330030030000300000030030330030000015000300003030000000000000003333330000333000000000100003333333100000033003030000333031333001100003333033
