000000000000000000000000000000001000010000000000000000000003000002000000000000000000000000000000000010000000030010000000000000000000000000000000000000000000000000000000
000000000000000000000000000000000000000000000000000000000000000000030000400000300000000000000000000000000000000000001000000000000001000000000000001000000000000000000006
000000000000000000000000000001001000000000000000030000000000200000000000006320000103000000000000000144000000001000000000100000000404000000000044040000000001200000000000
000000000000000000000000000030003030000000066000050000000100000000000400000060000000000010000030000060000066000000131003000000000000003000000000000000000016600001000000
000000000000000000000000000000000004000000060306600000000000000000000000000060000000000000300000000000000006006600600000000000000000000000000000000000000006600660000000
000000000000000000000000000006000000000000066006000000000000000000002000300660000000600000000000000000000066006600000000000030010000000001000000000603300006600660000003
000000000000000000000000000000000000000500033303300000000000003330633303033310000000000010000003333033333333333200000000000000300003300003030033033000000000333030000030
000000000000000000000000000030010100300000000000000000000000000003000000000300300000000000000010300000030000000060000010000000000000330000030040000000000000000000000000
000000000000000000000000000000000000003000000000000000000003000000000000001000100600004000300000005010000000000000000000003100000000000000000000000000000000000000050000
002000000000020000000004404003000020000010014404000000000044040000100000200000000001000100000000000000000000020000000020010000000000000000000000002300000000000000000000
066000000000660000000000000000000060000000000000000002000000000000000036020000000000004000000000660000000000000000003666030000000000006000000000066003001000000000000000
066006600000660000000000000000000060000000000000000000000000000000000006600060000000000015000000660000000000000000000660630000000000006600660500400600000000000000000000
066006600000660000020000000000000660300003000000000010000000000300000306600660000000000100001000560000000000061000300600000020000000006100060000406000000200000000000020
333333333333333330333303333311333333000430003333301000003030333000000030333330000000000000033331330600000000000133333333000033000000003330033133333000000000000003330100
