300000000000300000003000003000000000000000000000006000030010000600000000000000000010050000030000000000030010003000000000000000400000030001000003000000000030000000110002
000000000000000000003000033030000000000000000033000000036000001000000100005530000000000000000000000000330000000000006010000050300000000000000000000300000000000000000000
000000000000000000000000000000000000000000100000000000300000000000033300000000000030003003300000000060000000000000000013000000000300010000000000300000000000000000030000
000000000000000000000000000023000000000000000000000600000003000000000000000000000000300010000003000000200100000000000000000000030000000000000000000000001000000000000000
000000000000033002000000000000000010000600000000000000000000000000001000003000000000000000000000000000000300000036020000000000000000301130001300000000000000030000000003
000000000003333000002000034300000000000000000034300000020000000000000000000100003000000000000003000000340000033330000020000000000000000000003000000000000004000000000303
300000000000000000033300000000000001000000300001000300300300000000000000010100000000000000000000003000000300001000000030000000200030130000000000010000000000000000000000
000000000000000000000000000000000000000000000000000000300000030000003030000000000303000000000000000000003000000000030000003036000003000000000000000000000001001300000000
000000000005533000000000000000000000000005100055300000300000330000000000000000000003000000000005332000000300000000000500000000060013000005000000003000000031003000101003
000033330000000000000000033000003300000030300000000000003000000000000000000000000000404033000006000000000000000000013330003000000003000003300000000000053300100000000000
000000000000000000000000000000000000000000000060000000000000000000003000000000000000000000000000000000000000000000000000010010000000000000000030010000000000000000000000
000000000000000000000000000000000000000000000300000000000000000000000030002003000000000000000000103002000000000000000000000006003000001000000002000000000000000000000000
000000000000000000000000000000000000100000030000000400330100343000330300000003000002000000000000000000000000000000000000030303000034300000113000002000000000030400000000
000000000000000000000000000000000000000000000000000000003020000100030030000000030033000000000000000000033001000000000000000000300001000000003000013000000005000000001010
