000000000000000000000000000000003300100001000000000000060000000000000000030000003000000000010000000100330000030000000010000000000000000000000000030000000000100000000000
000000000000000000000000000000001000000000000000020000000000000000060000000000000020100300000000304000330000100000000000001000000000000000000000330000000001000000000000
000000000000000000000000000000003330000010000000001000000050000000000000000000000000000000000000000001333000000002000000000000000000000000000000303000000000001000000000
000000000000000000000000000003303330003000000001036001000001300003300000000000000000000000000000000310303060000066000000000000000010000300000330030010000000330000030030
000000000000000000000000000000033300303000000000026000000310000033300200000030100000000000000000100333303000000116030000000000000000003330000333333000030000000000033300
000000000000000000000000000003333030333000000000066000000000000633300100000000030000060022000000002303303000000066000030000000040030003330002331330000000000030000333000
000000000000000000000003300033333333003350000000003033300001000303330100000000100000333333300050003333333000010033330330003000000000033010333013330500000000030003333333
000000000000000000330000000000000000000000000000001000000010330000000000100000000000000000000100000000000600000000000000010000000033000000000000004000030300000000000100
000000000000000000330000000005000000000000001000030300000001330000000000000000001000000001000000500036000000000000000015000003000000000000000000000000000000000000000000
020000000000000000333000000000500000000000010100000000006000333000000000000000200010000000000000000000000020030000000000000000003033300000000000000000050000000000000000
660000000000000330333003300000000000500030000000000000000330303000500300000006600000003000000000000000000660000050000400000000033000300000000001000000000066003000000000
660000000000000333333033300000000000000000001000000000000113333000000000000006600000031300000000010000000660000000000000000030033331300000000000000000000066000000000000
660000000002202333333033300000000000000000000100000002200303103100022000000006600000003100001000002000000660000000040000000000233303000002200000220030000061300000000000
333333333333333333333333333300330000000000000000030303303333003310333330330000333033003333300000003030000330330030000000100000000300303333333333333001000033333330000030
