000000000000000000000000000000000000000000000000550006000000000000000000000000001000000001000000000000053000600000000000000000000000010010000003000000000000000000000000
000000000030000000000000000000030000000302000000030000000600000000300000000001033000000000000100000003000000110000003020000001000600100330000033000000000000000000310042
000000000000000000000000000000000000000061000000000000000000000000000000000000000000000000000100030000300000000000000660300001000000016000000000103000030061010000003066
000000000000000000000000000003300300051066000203000000000000020000100000030000333000000310000000000000000000100000000060000000000000003030000333000603000000000000000066
000000000000000000000000000003330000000060006600001000010040000000023000000030333000000000100000000000000000600000000000066000001500003030000333000000000000000000000066
000000000000000000000000000003300000220066300600000000000000000000000030660000333000030030000000200000000006110002200660066000030000003330000333010000003010300000020066
000000000000000000000000000033333000333333330303300300300000030000000033533003330333000000033033030001000333000533340343333333000000033330033033333333333300000000313032
000300000000000000000000000013000001060000000000000001000000000000000000000000000000001000000030000000110000000000000000000006000001000000000000000000303000000000000000
003300000000020000000000000000030500000000000000000030000000002000000000000100000000000000000310000030000000030200000030000003000000000000000000000000000000000000001000
000000000000660000000000000000016000300000000000004000100000066000000000000000000000100000000004000000000000006610000000003000300000000003000000000000300000000000000000
033300000000660000000000200000000300300003000000000000000000561000400000000000000000000000000030000000010000006600001000006000000000300100000000000000000000020000000300
033300000000660000000006600001000000000000300400000000000000066000010000000000000000000000000330000000000000006000000000000010000000000000000000001040010003660000000000
033300002200660000020006600060000000000300103002000000000220066003000000000200000001000000003330000000000022066600000000000100000302030000000010300000000000660000100000
333333333333333333333333333300000000000000303313301000003303030000000033630010000000010000033330310000000333133300000000100300330333300000000000000100000003133030000060
