300030000000000000003000000000000050000003000030003330103000100000001000000000005000000000033330000000003000000000100000000000001003300000000000000000013030330000000000
000000000000000000003000000005004000000003000000000000000030000000000000000000300300000001000000000000003010303000010000300000000000300333000000000000000000000000000000
000000000000000000000000000000000000000000000000000000000000003060000030010000000000000400000000005000006000000000000000000000050000000000600010000000000000000000000050
000000000000000000000000000000000000000200000000003000100000000000000300000000000030000000000300400000030000000000000000000000003000000001000000030000000003300400000000
000000500000000000000333330033133000000000000003530000000000005333300000000030000100000000030300030000000300030003032300000000000000000000000000003000000000310103350000
000030330000000000000000000000000000001000000030300000000010303300000000000030000000300100000030050000000310000000000003000000000000000000000000000000001000000000000000
005000000000000000000000000000000000000000005000000000050050000030000333333330003310000000000000030010000000000000000000000000000000030330333333033000000000000000000000
333300000000000000000000000000000003000000010000000100000000004000003030030000000030300030000000000100000000000030003003333030000000000000000000300000101000003003060300
000000000000000333300000000000000000000000000000003030000300003000000000100000000000000001000000000333300500000000000000005000000010000000000001000000000003303000105000
000000000000000000000000000000000303000000000000000000000000000000000000010000000000210000000000000010000000000000000010000000300000000000000003030000001000000010000000
033004000000000000000000000000000000000000000000000000000000000030000003300030000000000000030000000000000000010001000000330040000000400000000000000006030000000000000000
003000000000030000000000066000000000000660000000100000000100000000030000300000000600001101503000030000000000066000303050030002060066001000030000000010066040000000000005
000000000000030000000000066600000000000060000000000000060000100300000000000000000606006030310100030000000000066600003300000003030060000000030014000030060600000000000303
000000333333330033333333333333333333033333000100100333330000000000000000010033300033000000033333030033300030333300500000000000330000330333530050000330300000303030050000
