000000000000000000000000000000000000010000000000000000000000000000030103000030000000000000000030000000000000000000000300000004000000100000001000000003004000000000000000
000000000000000000000000000030000000005000000000000000030000001000000000030000055500000000000000000000000000000000000000000000000000000000000000000000000000055000003000
000000000000000000000000000500000000000000300100000000000000300035000000000300000000000000000000000000010000000000000000000000000000500000000000001000000000000000000000
000000000000000000000000000000000000400000000000000000000000003000010500000000003000000000300010005100003000000003000000000000000040000000000000000000000000000000000000
000000000000000000000000000000000001000000060000311000300001000000000100000000000000000000000000300000040000000000000000000000000010000000330000005050003000010000000000
000000000000000000000000000000000010000000300000000000330000000000220200000000000000100000000056330000000000000010002000000003300030005000630000000000000300000000102200
000000000000000000000000000033013330000000000000033300310000000303333301000000000033000030033000330000000000101030330330100333000000030300130001000003003300000333300003
000000000000000000000000000000000000000000000000000000000030000000000000000000000000000000000000000000000030000000000030000000000010000000000000000000000000000000000000
000000000000000055500000000000001000000000005550000001000000100000000000003000000000000000000555000000000000000000000000000000000300000010000000000000000000000003600000
000000000000000000000000000000000000000000330000000000013000001000060000000050000005000000000000001000000030000000000000000000030000100000000010005000000000000030003000
000000000000000000000000000000000000200100000000000000300000000600000100000000000010000000003000100000000000000000030000000000000000000000000000000000000000003000000000
000000000000000000000000003300003000000630300000300000300000000050000000000006000530000000000300000000000000000000000000000001000000000000000000000100000000001000003000
000000000022020000000000003300000020130150100000300000000000000100000100000000100030100000000000000000001000020200004000000000200100000060000000000000000000000000010200
333333333333333000033333003330333030000000300003300010003333030000000000000001330033303333330000330000000030333000000000000003000000030000330000000000000013303030000000
