000000000000000000000000000000000000000000000000001000001000000000000000000000300000000000000000000000000000000000300000000000000010000600000000000000610000000000000050
000000000000000000000000000000400000000000000000000000000001630300000000050300000000000000000300000000000000000001050000000000000000000000000000000000000000000000000000
111111111000000000000000000000000003000000000000160303030005000300030011111000000000006000000000000000000000100010000003000000000000000000000000000000000000000000000000
000000000000000000000000000000002006000000000003000000000000200600000000000301000600100000000000000000000000200000000000500100000020000000000000000500050000000006000000
000000000000000000000000000003010050060000000000000300000016600000000000030030000600300010000010000000000006300010000000000003006010000000003006600000000000000006000000
000000000000000000000000000000060006010030000030000000003000610600001000100000000000000005000000000000000006000000000006000003001600000000000000000000300000000000000000
000000000000000000000000000031303333333333133333300000033333303033330000100000000000000000005000003333030333331130000000333333333333300001003133330000000000000033033333
000000000000000000000000000000000000000000000000000300000030000000310030000000000000300000000000030000330000000000000000003000000000000000000000000100000005003000000000
000000000000000000000000000000000000000000000003000000000000000100011000000000000000005000000000000000000003000000601000000030000000300000000000030000000003000000000010
300000000000000000000000000000000001100000111100100000100000000000000000000003100000110000030000001311111300000000000001111111000000000000001101113000000011000050000000
600000000002000002000000000000620000000000030000000030000002000000000000000000000000000000000002000000030600000000000000100000000200000000000000000000050003000000000000
600000000066000066000000000000660301033000000000000010000060000002000000000000000000000000000566000000000600000001000000501000006600000300000000000000600002000000000000
600000000066000066000000000000600000000000000005000000000466000300000000000000300000000000020066000000000000000000003000000000000660000300103000000006600300000000003000
333333333333333333333333333300331330000000000000030000000303333000000033333300000300010000033303330000500333033333303330000000000333300000000000003000333300000300053333
