000000000000000000000000000000000000100000000030000030000000000003001000000000010000000000000001000000000200003003001000300001000000000000000000000000000000000000006000
000000000000000000000000000001500000000030030000500000000000000010000000000000000000000000000500000000000100000000000000000000000000000000000000000030000000000000000000
000000000000000000000000000001100000000000000011000500000000000000010000000000000000000000011060300404100000000000000000110050000000000010000000000000000001044000000000
000000000000000000000000000000000030030000000000000000000000000000003000000000000000000000000100000500000000000000000000000000020000100000000000000000000010000000000000
000000000000000000000000000050000300000000000000000350000000000000030300000000100000001300000000000000000400000050000031000000000000000000300000000005000000000000300000
010000144400000000000000000000000000000000000002100000000000020000000001000010000202430000001000000000000000000000060000000000010000100003000000200011000100000000030300
000000000000000000000000000053333330000000333330300000003333333000000000000003033330000010033330313333033000000030630033033033100000000000003331310500000033333331500000
000000000000000000000000000000040000000000600000000000000000000000000000010000100000300100000031000000000000000000000000000000000000000000000000000000003050000000000000
005000000000000000000000000000000000010000000001000160000000000000000000500300000300300200000000000001310000006100000000000000000000000000000060000000000000533000000000
011000004044000000000000000000000000000000010040000010000000000000000001100300001510000000000000000000000000000100044000000300000000000000000000000000300000100000010000
000000000000000000000000000000000000100000000000001000000000000000000060006000000000000000005000000301000001000101000500000000000000000000000000300000000000000000000000
000000000000000000000000000000000000300010060300000000000000000000000000000000000000000000000000000000000000000000000000000000000000000003000010000101000000000000000000
000000000000000000020000020200000014040000300000000002004040000600000000000030000100000000000000200100001000020001000000000000000020200000004440000000300000000000000020
333333333333333333333333333300000300000000033330303033330300000000000033333330313030000000003333330000000303333333330030000000333502300030000000000000100033333333003303
