000000000000000000000000000001000000003000000000000000000000000000000000000000000000000000000000000400000000000000000000000003000000000000100000000000000100000600060000
000000000000000003300000000000000000000100000330000000030003300000000000000000000600001100000000000003003010000000033000000000000000001000050000000060000000000002000000
000000000000000000000000000000000000001000300000000000000030000003000000000000000000000000000000000000000060000000000000000000001000000000000000000000000000000000000000
000000000000000000000000000000000000000000000000000000000000000000000000000000000010000000000100600010000000000000000000000000000000300100000030001000000000600000000000
000000000000000000000000000000020000000000000040000003000300000000000000000000000200000000000000000000000000000000000000000000000000000000000000000001006000000000300000
001000000000000000000000002010000032022002000000000000000000000031000000100250022000202000100043000010000002002000000300020020000000000000022022002000302020020000100000
000000000000000000000000000000000003300333000000030030030000000033300310333333313300030033333030330000000333300001000003333003000000033033303330133000003033033033330330
000000000000000000000000000000000000000230300010000000000000300000104000300000000000000000000000000000000000106000000000600000000000000000000000000000000000000000030000
000000000000000000000000000016000000000000000000000000000001005100000000000000000000010300000000000000000005000000010000000000000000000000300010000000000160000000003300
000000000000000000000000000000000001010000100300030000000000000000000000000003000000000000000030000030000100000000000000000000004000100000000000000000000000300000000000
000000000000000000000000000000000000000000000001000000000000000000000000030000000000000100010000000000060000100000000000000000000000000000000000000000000000000000000001
000000000000000000000000000000000000000000000010000000010000000000000000000000040000000000100000000000003000060000000000100100000000000000000000000000000331000000000000
200200000000002022002002002000000202102000003000000000202032010101030000500110000000000000000000300000100230000000000000000000300200000100000011000000300000010000000100
333333333333333333333333333333301333333303000000000001000333033000003000000000000000000000400000300000000330333300000003533303033003000060000000000333333300000005000000
