000000000000000000000000000300000000000000000000000000000000000000000000000001010000000000000000000000000000000000000030000000000010000000000000000000000000010000100050
000000000000000000001131001005010000006000000000000000000000000010000000300000000001301001003010000000000000000104300100000000000000001000010000000000000003030000310010
000000000000100051111111111001000003000000000301002000000000000000000002000000051011111111000000000000000005011001100100000000020100000010100000000000000000000001111310
000000000000000000000000000010100000000030000000060003330000000300010066003330000000003000000000000003000060000000000000000300060003000000050010000001000000100000000030
000000000000000000000000000000100000000000000000060000000000000000000060000000000000100000000000013030000000000000000000000000600000000000000000000000000000000300000000
000000000000000000000000000000000000000000000010000000000000000000000061006000000000020000000000000000003000000001000000000000660010000000000000010000000100010000000000
000000000330000000000000000013331303030000000000033000010000000100000030501030100020000000000002000000004000000000000000033303020000330000000000000303003300000000000000
000000000000000000000000000060000000000000000000000300000000003000000001000050000000100000000000000000000100300300000000000000003000000000000000001000000000000004000010
030300000000000000000000000000000000000000030300010100101310051030000000030000000005000000000000000000000000000003000000000000000000000000000000000000000000030000000000
000000000000000000000020000001400000001110200003011010101101110030000000010000000000020000000000000000010000000000600040003000000000000000000050010005011102000000000000
000000000000000000000660033300000000000000000000000000000000000000000000000000001030060003000000000003000031000000000010000000050000000130000000000300000061003030010000
000000000000000000000660000010000000000100000000300003000000000000000000000000001000660000030000000000000000000000000100000000000000000000000000000000000066000000000000
000000000000000000000660000000100000000000000030000100005000300000000001000000000010060000000000001000001000000030000000000000000000013000005000000000000031000100000030
000000000000033333333330000300000030000000001000000301000000000000003033033330400000330010033330300530000000000010000001033000100000300400000033100100000023000030000003
