000000000000000000000000000030000000000000000000000010000050000000000060000000000006000000000000003000000000000000030300000000000000000010000000000000000000000000000000
000000000003000000000000000300000003000000000000000000000000030000000300000000000300000000300000000000000000000000013000000003300100060000300000000300000000000030000030
000000000000000000000000000011000003103333000040003000003000003000030010000000000000000000030000331000000300000000003000000000000333035000330001000300333300000003000030
000000000000000000000000000000100030023000060000000000100003003500000000000600000003000000000033330000000000060000000000000000102000000033030005000002330030000030003333
000000000000000000000000000000000000000000001000000030000003333000000300000000000000001000000330310030016000000000000000000000000000000003330000000000000000001000003033
300000000000005000000000000003000030000000033300000030000003300030300030000000000000033300000333300060003300000000000000333000000000000033335000000000100033330000035233
000000000000000000000000000030000030033320333300000100000003330336300000000000000000333300000063303000333000003000000003333010003330300130330000000003330133333000000303
300000000000000000000000000000031000000000000000000100300003000030001030000100000000000000000000000030000000200000000000000000100000030000000000000000600030300000006000
000000000000033000000000003000000000000030000000300050000000000000310301000003000000000030311000000000000000000000000010000000000000000000000034000000000000000000000300
300000000000003003333300003300000003000630000300300000000003000000000003000003000330000000000033330100000000000000000000000000000000030000000300000300000050000000000000
000000000000000023000000333300000000000300300000000000000000000000000300000000003500000000016330000000000000100000000001000000000003000000000000000000100000000000003000
000000000000000000000000333300000000003033000000000000000000000000000000061000000000030000000000000000000000000000000000000000000300000003000500000100000050000000000000
000000303330000000000003333330000000030333000000000000005000000000000000000030000003000000000000000000010500000306000005000000000000000000033000500000000000000000000000
330033333333000033303000333300000003000333000400100300000000000000000006001330000303000010000313001000000051000000000000000000000000030003330000100000000033030300000300
