000000000000000000000000000000006010000000060000000000000000000000000000300100000000000000000000000000000000010000006000000000000000000000000003000000000003000100000000
000000000000000000000000000000000000000000000000000000000001000030060000000000000000000000000001000003000000030000005000500010000000000010000000000000000000000000000000
000000000000000000000000000000006000000000000000000000003000000000000000000000000000000000000000000300000010000000000000003000000000000000000000000000000000000020000000
000000000000000000000000000000000000000300000000030001000000020000000000200000000000000000000000000000000300010000000000300000000000000000000000000001000003200030000000
500000000000000000000000000000000000000000000003000000000000000000060001100003000000000601000000305000300300040003003500000000000000050000000001030000000001100000000000
000000000000000000000000000000000002002002000000000000010000000000000001010000000000200002000003010000010010000000003003000000000000000000000060300200000206025000000000
000000000000000000000000000000000003333333333333310000004000000030030300300330000000033333300000000600000000301000000030000000001000000000003333303333033033333230000000
000000000000000000000000000000010000000000000000001000000000000000000000000000000000000000000000000000300000000000000000000000000000000300000000000004000000000000000000
000000000000000000000000000000000000000000000000000000000000000000000000000000000000000000000000005000000000100000000000000000000000000000003000000000000000000000000000
000000000000000000000000000000010010000000000060000003000000300000000000000000000000000000000000000000000000000000000030000010000000000004000100000000000000000000000030
002000000000000000030000000000000000060000000000000000300000000000000000500300000000010010000000000023000000001000000300000050000000300210000000000000000300000000000000
011000000000000000333000000050000000000000011000000003300100000000000000003300003000000000000000000110000000033300002330000000000000001000000030300000000000000000000200
010000020020220020333000000000300000000000010000000200030010000200212010403030000050000000000000000100000000032300003332002002000000001000000020333000000000030000000500
333333333333333333333333333303000000000000303333303133333030000330003333033600020000030340300000000033310333303333033333331030330300333133323333303000003000000100000000
