000000000000000000000000000000000000000000000000000000000000020300000000000000000000060000030010000000000000000000000000000030000010010000001030300000000000301000000000
000000000030000000000000000000000000003014000000000000001013000000000010000030060000000000000000000000000000000000000600003000000010000000000000000000000030000030100000
000000000000000000000000000000000000000000000100000000000000000000000001100300000000300000000030004003000000000030000000000010000310000003000000000003000001100310000000
000000000000000000000000000000000000003000000200003130000000000000003000000304002000000010000010000030000000300000020000000000033300000000000000000000000010000030001003
000000000000000000000000000031000010000000106600000301001000000000000000000300016000000050000660000003300010000000660000000000033030030000000010000000010001000330030000
000000000140000011000000001100000110014000066600033333001016000030300000260330061000100110030660000333300000001130660000014000033300004003000014000000000000030330020011
000000000000000000000000000000001300600300333300003303300000001000000003330303303330000000030330300033003001000030333003000000330333300000000000000000103030333000000000
000000000000000000000000000000001000000030000000000000030000000000000030000000000000000000000000000000000000000030000000000000060000000000000000000000000000000000100001
000000000000030000000000000000000000000000000000300000002000030300000000004000000000600050000000000003003000300300000030000000000100000000000000005000000006000000000000
000300001100330000000000000000000000000000011000300000000000150000300000000000000000000000000000000003000000013300100330000000001000000000000000000000000000030000000000
033300000000330000000000200000000000000000000003300000000400000033300000000000000000000000003000000000000000003000000000000000000000000000000032000300000003350003000000
033330000000330000000006600000000000000000000003300000000000000030333000100000006005000000000000000103000000003300000330000300000000000000000066000000000003303000000000
333330000200333000020006600030400200000050000000300100003000020303330000000000000001000000030000200010000000003300200330011000300100030000110006330030100030331003000003
333333333333333333333333333003333630000000330331300000003030333330333300053040000000000000033333300000000303303330003330000020333000300000003333300100000033303330033330
