000000000000000000000000000000000000000000000000000500000000100000000000000000000000000100000000000000000000000000000000000000000000000000000000030000000000000000000000
000000000000000000000000000000000000000000000000000000000000000030010000000000000000001000000060000000000000000001000030000000000010000000000000000000000003000000100000
531111111111111130111111111144344441001000111100100301011101100031111144440240011113000000010301101001110000001111301110300000000000000001110311110111111031000001000000
000000000000000000000000000000000000000300000030000000050000000003000000000000000000010000000000000000020000110000100060005000000000000000100000000000000000000000000000
000000000000000000001000000000000000000000000000000100010000000300000000000000010000000000000000000000000001000000000000000000000050000100000000000000000110000000000000
000000000000001000000000440006002003000030000440000000000000001000000000002000004400000006010000000004500000000010000000000500000000000000000000000000440000000000000005
000000000000000000000000000003033333330303000300033333330000002000000030333330000000333033300000000000030333330000000003333333303633033313030000000000006000000003303033
000000000000000000000000000001000000000030000000000000600000000000000331000000000000300000000000000000000000001000000000300003000000000000000000000000000000000000000000
000000000000000000000000000000000005000030000030000100000023000000030000003000001000000000000000100300000000000000000000000000000000000000003000000000000000050000000000
100000000000000000111444444453101110400500100010111101101000010300000011301510010100004444010000001110111010003144444441101111111111103010000000000040404000000110100011
000000000000000000000000000000000004000000000000000000000000000000000000030000000000030000000000000300000000100000001000000000100000000000000000000000000000000000000000
000000000000000010000000000000000000000030000000000000050000000000000000000010000000300000000003000000100000000000000001000000000000000000000000000300000000100001000001
000000000000000000000000020000000031000100000000010000000000010000000011000000000001000020503000000003600001000000001600004000000000000000000000000000020000000000000000
333333333333333333333333333300000003030303000000000000003333333313303300000003301333033030333333330000000000300033003330515000500000000005000303133333130333333030000000
