000000000000000000000000000006000000040000000000000000000000000000010000060100000000000000000000000000000000000000000000000000000000000000000000000600000000000000100000
000000000000000000000000000000020000000000000500000000000000400000020000000000600001000000000020000000100300004000000030000130000000300000000000000010501000000000000000
000000000000000000000000000000665000000000001010000020000004400000000000300000000000100000000603000001000000044000300030060000000000000044400000000000200000000000004440
000000000000000000000000000000660000000000000000000300120000000000000100300030000000000000002060000000000300000000001030006100000000603001000000000000600200000033000010
000500000000000000000000000000060660000000000000004660060000000000000000300030000000000500000660600000000000030000303030066166300000030000030000000016006600050000000000
000000000000000000000000000000660060000300000000000660660000000000103000300630000002000400300600060000000000000000100030066066000000000000000000000000006600000000000000
000000000000000000000000005333303300000000000000033030300033303000000000000300000053000000033333330030050303333200000333033033000005333303010000001033333300000003033333
000000000000000000000000000000101000000000000000000000001000000010000000100136000000000010000000000000000000000000000000000000000000000000003000000000000000000500002001
000000000000000002000000000300000000000003000000000000000002000000000000000000000000000000000001001000003003000000000003001000000001000000030000003000005010000000010000
000444000020000066000003000306000010000003000000003044400066000000000000000000000000000000000020000000000001260000020031000000001000000000000350000003000000000000006000
000000000660020066000003000300000000000003010001000000000066000000000000000300000013100300000000000030001006000000660020000000000000030300000030003000010000000000066000
000000000660660066066003000311000000000000000000000010000060015000000000050004061006000003000000000031000006606600660600100000000500000000000000003000000000100000060006
000000000660660066066003000300000000030003000000000000000066016000010000000000060066006000000000000030003000606600160360000000000060003000000030003000000000000000116066
333333333333333333333000003300000000000033000051013033030333033000000000000003003303000001000001006000031333333333303330000000000000000000000000003000005300000603333330
