000000000000000030000000000000000000030000000000000000000100000003000000000000000000000000010003000000000000000030000000000000003000000300000000000000030001301010000000
000400000000000000000000000000040000000000000000060000030004100000000000000000000200000000000040000000000000000013000011000300000030000000000000000505000000000000000000
000000000000000000000000000000000000000000200000000000000000000000000000000000000000000030300000003000000000000000000030000000000000000000000000003100600000000000000006
000000000000000000000000000000010000000000000102001020000000004000000000000000000000000000000000000000000000000000502000000000030004100000001000000000030000301000000000
000000000000000000000000000000010000000000000000500030006000000000000020020000000000000000300000000000000000000000000000000000100000000000000000000100000051061000000001
000000000000000000000000000000000000000000000500000030000000000001000000000000050300000620000000000000020000000000000020000001000010001000000000100000000000000000000000
000000000000000000000000000000000003000000600330303333330300000000020000005000000000333333000000003333331010000030303033033333000000000000000333333333333340000000200300
000000000000000000000000000000000000000000000000000000000300000000006000200000000063031000000002000000000103000000000000000500000000000001000000000005005000000000000000
505000000000000000000000000000000000000000000000000500000050000000000000000000000000505000000000000000000000010300040000000030505000000010000003000000100000000400000000
000000000000000000000000000300000000000000000000000000000000000030000320000000300000000030000000000000030100001000000000200000000000000000000000001003000040000000030000
000000000000000000000000000000500010000003000000030000100000001001000000000000000000000000000000010000005000001000000000000000000000000000000000030000000000000000000000
000000000000000000000000000000000000000000000000000000030004030000000500000000000000000000000000000000300000000000000000000000000000000000000000600000000000000030000005
000000000000000000020000022200002020000100000000000000000000100000120210000000000020000000030000000000000000000000033001000120000000000000000000000000100000000050000025
333333333333333333333333333336303330000000000000003333330333333330333033330313003333333303330333330000000000003000000003333000003331300000003033333000000000010003333033
