000000000000000000000000000000000001000000300000000000000000040010000000000000000000000000300010055000300030000000000000000000000000000000000101000000000000000000005000
000000000000000000000000000000000003010000000000000000000300000000050000000001000010000000200000300000000000000000000000000000000000040003100000000000000010000000000000
000000000000000000000000000000004000000002000000000000001000000000000000000000004410000000000003000101000000444000000030000000000000000000100000002001000100000400000003
000000000000000000000000000000000000000066003000000000005001600000030000000000000010000000000001000002000000000000000000003000000000000000010000061030003000000000000000
000500000000000000000000000000000000000066100000010000000366066000000030050000000050000000600005000006066003000000300001066066000500000000000000066000501000000010030003
000000000000000000000000000200000000300066000010000000020066066000000000000030000000000100000000000006066000000000300000000003000000000100000010066000000000000000000000
000000000000000000000000005333030333330333000000001001530033333000005300000003332333000005300000003333303333330330000033030033001400000000003030330000000033333333000603
000000000000000000000000000000000100000000000000000000001000000000000003000100000000000003000000000000000030000000000000000000000000000000000000000000000010000000000000
000000000000000000000000000001000010000000300000000600000000000000000030001000000000000010000000003000000000000000500000000000001000000000000000000010000000000000000000
000444000000020000000000000300000030000000000050000000000000000000003300000020000000000300000000000000002000000003044003001002000300000000000000000000000030000000000000
000000000000660002000000000000000000002000000000000000000000000000000003000600000000000000000000000300006000000000000000000006000000000000600002060000000000100000000000
000000000000660066066003000000301000066060000510000000000000000000000006000360000100000000030100000000060033000000300000000060000000000000000000000000000000306100000000
000000000000660066066003000000300000066066000030000000000000000000000001000660000000000000000000000000066000000000000020000066000000000000020060166000000200000000000000
333333333333333333333300000330000033333033000000010000000000000300000333303300000000000000000000303363333000000133303303333330000000000000136000303000005001000006050000
