000000000000000000000000000000004000000000000000000303000000103000000000000000300000006615300000000000000610000000000000000000000001000003000000000006000003005000000003
000000000000000000000000000000000000013000000000000000000000000000200000000000000000000600300000000000000003000300000600106000006100300020000000010000200000000000000000
000000000000000000000000000000000000000000600000000014110100000030310000034110000000003100000010001001411100000000000000000100000300000101000000100001110000100010000000
000000000000000000000000000000301000004030000000000000000000230000000100000001000000000050000000000000000000000010000000000000000000003000000000000600000000000000000000
000000000000000000200000000000002003000000000000000000000000000000000000000000000000000000000000000000000000000000000000000000000000000000000000000000000000000100000002
000000000000000011100000200000011000102000000000000000000000000000000000051003000000003000000000000000100032202000111000001000000001000060000011100000000000020000030000
000000000000000000000006600300000000166003000010033133330000000033333033303130000050300303300000003333033333130003000000000000000333330003302000000333033000000000000300
000000000000000000000006600300100000066003000000100100000000000000000000100000006003000000000000000000030000000000000000000000000110000000001066303300000010000000000000
000000000000000002000006600300000000306000000003000020000100000010000000000200000003000000000000000010000000005001000000000000000000000000000060033300000000000000000000
000141111000000011100003300000000000000000110000300110000100000000003100000000033003000000000000000001100000000000300000000000000005000014130033000110000000014100000100
000000000000000000000000000000000000000000000001000000000000000000000430000000000300000000000000000000000000000000100010000000000000000030600000000000000000030000000000
000000000000000000000000000000000000000000000400000000000000000001000003000000000000000003000002000000000000000000003000000003000033000000000000300000000000000000000000
000000000220200000000000000000000000000100002202000005000022030000000000020000000000000200000111000003000000000000000200001000000000000000000000000002202030003000100003
333333333333333333330000333300000000003333333303333333303033060030000000660030001330006600000003003300330000000003400330000000006600333300000000303331333033303330000000
