000000000000000000000000000000000000000000000000000000000003000000000000000000000000000000000000030300000300000000000000003000000004000000010000000000000300001005010000
000000000000000000000000000000200000600000000000000001000000000000010000000000000010000000000000001001000000000000000000000000000001000200000000000000000000000000000000
000000000000000000000000000011111340000000300000000000000000000111110400000000010000000000000000000000000000000000000000300000660300011111140000000000000400040000000000
000000000000000000000000000000000000001000000000000001400000000000000000000000000000001010000000000000000000300010000000000000660013000000000000000000000000001000000000
000000000000000000000000000000600000000000000000000050000000000000001000000000000000000000000031000000000030000000500000000000660000030000000000001000000030100000020000
014444400000000000000001100020000300000000000000000000000000101200000001400440013000000000300000000111000000106050030000011050060000000000000144044000000000000000011010
000000000000000000000000000033333033000500000333333503313033333303333300000000300000303303300000030000000000000000000000000000333333333303010000013033033330033310000000
000000000000000000000000000000300000000000100000000000000400003000000000000040300000000000010000100300000000000000000000000006000000400000000000000000000300000000103500
002000000000000200000000000000000000000000000000002001000000000010000000000000200000000000000203000000000020000010000000000000000000000000000000000002000002000000000000
111111400000006600000000000000000000000000000000060030010000000100000000000000600000000000001002140000000660000000000300000000000000000000000100000111111406000000000000
000000000000006600000000000000000000000000400001016000000005000000300000000006601000000000600100500000000160000000100000000000000300000000000000000000000066000000000000
000000000000006600000000000000000000000000001003066000000000000000000000000003400000000000060000300000000600000000000200000000000000000005000030000050600100001020000000
200000000000006600000000000002404000003100031102060000000000000000030000000006600000000000020000030044444060000001414440000000000000000000000000000000100016000000000000
333333330333333333333333333310000030030300000000003331312000000361333500000003333033333333330301330000000003333300000000000100333003300333030000000333333330333330000000
