300000000000000000000000000000000000000000000030030000000300000300000100000000000000000000000000000000000000000030000000001000030000000000030000000000300000000000060000
330000000003000000000000000000000033000300000030033000000000000330000000000000000001000000000000000000000000000033000000000000000000000000000000000300000000000003000000
000011111111111111111111111100500000000030111010100001110161600000001111110100000200011110100100001000001000000000001113006000101111101001000111111011110113013110003000
000000000000000000000000000000000300000000000000001000000000000000000000300001000001000000050000005000500000000003000003000000300000000010001000600000000000000000000000
000000000000000000000000000023000000000000001000000000000000000000035000000100000000000001000000000000000005002010000003000000000030000004000000000000000000000000000000
000000000000000000000000000020000000010000005000000000000000000000000000000000000000000000000001000000000200300000300000030000510000003000000200000000000000300000000300
000000000000000000000000000031003330003533000000000005000000000000000300000003330330300000033300333333003301313300003006333333000000003333300000006000000300000003333333
000000000000000000000000000000000011000000300000000000000000030000000000000301000000000000030000005000000000000000001003001001000000000310000000000000030000000003000000
000000000000000000000000000000000000100000000000000000000000300000000000400000000000001503033000010000100000000000003000000000000000000000003000000000300000001003300000
000000000000000000000000000011150011101111000000000000001111101000000000000000000000101111000000111131011000000011110111011111000000000000030000000000100000000050012101
000000000000000000000000000000000000000000000000500000300000000000000000000000000000000000001000000000000000000150000000030000000004000030000100010000003300000000000000
000000000000000000000000000000030000000000000000000000000001006000000000000000050000000001000000000000000004001000000000000003000000030000000006000000000000010000000000
200000000000000000000000000000000000000000000000000000010000000000000003000002300000000000000000000010500003100000064001000000000000000000000000000200000000003000000000
333333333333333333333333333330000000000000331333030303330030000034303333333303033303000000002000000001000333333300000400000000333303333303033331303133003333330030040000
