000000000000000000000000000000000000000000000000000000000100000000000000000000000000000000000000010000000000000000030000000300050100000000000000000000000010000000000000
000000000000000000000000000000000000000000000000000000100010000000000000000000000000000000000000000000006000000010000000030000100020000000000000000000020000000000000000
000000000000000000000000000000000000000000000010000300010400000000000001000103000000000200000000000000005000600000000100000000010660000026000000000000660000400030000000
000000000000000000000000000000663003003000000000601000001000000000000000005000000000100000000000000000000001660000003000000000000620000000000000000000610030300000000000
000000000000000000000000000000600330000060000001000000050300000000000010000030104000000000000100000000000000610000000000000000000660000000000000000000663031000303500010
000000000000000000000000000000660303000000110000300003000006000100000000000606000003002200000000000000000200660000500000030000200660102010000000000200160033300000000000
000000000000000000000000000033330340000000000000000000003333033000002000000000001000300003006000000000500333030300000000000003333100000331330000005333303133000200300000
000000000000000000000000000060000000000000000000001000000000001000000000000000000000000000000000000006000100000000000000000000030000000000030000000000000000010000000000
000020000000000000000000000000002130003000000000000000000000000003000000000000003200000000000000000000000100000000000000000000000000000000000000000000000030000000000000
000660000020000002000000000300066000000000000001000000030000000000200500000000000600100600000020000000003100000000020003000030010000000000030000300000200000003000500000
000660000000000066000333000000066000000000000000003300000300004006600001000003006000000000000660003600000030010000000000000000000000033000000000000001000000000000001000
000660000000000066033333000000060000001000000000033000003300000006603300000000036500000000000610335030000000000000060330000000600000013300000000000000600300000000000000
200660000220000066033333000020006000002006000000033000003300300003603300000002006000000000000663303330300000000000630300000000400000033000000000000000600300000000000000
333333333333333333333330000033333333633303100000033000000300000333330300000303033033000010033330303300000000000050330310000000000000033000310004310333303330034330300000
