000000000000000000000000000060000300000000000003000100000000000000000000000000000000000000000000006000000000000000000000000000000000100300000050000000000600000020000000
003000000000000000000000000000300000000000000020000033003000000000000000033000000000001000000033000000000001000000000060000000103000000300000000000000030003100000030000
000000000000000000000000000000001000000010000000000000300010000000002000000000000000000000000000000000430000000000000000000000050000000000013000000000000000000000000000
000000000000000000000000000060000001003030000000000100000000000002020010000000000000000000030000000000000000001301033030333000100003000000030000000002335000000000003000
000000000000000000000000000000000000000030000000000000000000000600004000000000000000600000000000003000000000000000033000000000000000000000000003000000330000000000003000
555000000000000000000000033050500000000000000033000000005100000001033000000605550000000033000000000000000555000000333010000000555000001003000000000003330000020000550010
000000333300000000000000033000000000000033000033000000000000000000033000003000000003000030000001000000000000000300000000000003030000300003020000000000010000000000000000
000000000000000000000000000000000000000000000004000000000000000005000000000000000000000001000030000000000000000000100003000000000000000000000000000100000000300000000000
000330000000000000000000000000130000000000000000030010000400000000000030000000000000000000600000010000000000000000033000500000000000000000000003300000000000004000030000
000000000000000000000000000000300000000000000050000000000010000300000000000000000000000000000000000000000000000400000000001000000000000000100000000000000000001000000000
000000000000000003303333333000000000013303000000000000033330330000330305030000000000000000050000000303063333333000000000000000000000000400030000000000000000000013303320
000000000000000003300000000000000000003500000000000000000000000010310000000100000000000000000000001001300504000000000000001000000000000030000000000000000000000000000300
000000000000000033300000000000000000033300000000000010000000000003330050000000000001000001000000000033001000030000000000000000000000000000000000000000003000000010000000
000000000000000000000000000300000000000000030000000000000000000000000033300020000000333000000000000000000000000300000000000000000000030300300000000003003033300000001003
