000000000000000000000000000001000303003000000350000000360000000000000000000000000000000000000000104000030000000001000000000000000013300600000000300000000000000000000033
000000000000000000000000000000000000000010000000040000010000000100000000000000000000013000000000000000323000000000003330000000000006000000001000000000000000630000000333
000000000000000000000000000000033000000000130000000000003200000001103000000000000000000000000000010000333002100000033330000001023000000000000000000000000000000000003033
000000000000000000000000000000000000003000000000600000006600010000000000000000000003000000001000000003103000000000301100000000600000000000000000010000000003000000003333
000000000000000000000000000000000040000000030000000100006000000000001000000000000000000000000000000343330000000003330330000000600000000000000000006000000300000000333003
000000000000000000000330000030000103300000330000100000030600000000000033000000000300330000000000000033033000000003333310000300060000300110000600000000003000500000303333
000000000000000000003300000000330033000000033333300000033033333000335330000001000000300000000000003333330003333313303330033333330333300000000000003003300300100000303333
000000000000000000033300000000001000000000000003300000003000001000000005000000000013000000010000000000020000001000000000000005010000000110000030000000000000000100000010
000000000000000000333300000003000000001000000003600000000000003000000000000000030003000000030005000000000000000000000000300000000600030000000000003000500000000000000000
020000000000000003333330000001000000300000300330302000163300000000000000000000003033020300003000100000000000000000000300000030000100031000200205000000000000000003001000
660000000000000033333300000000000000000000003033066000033003100000010000000010033333603000000000030000000100000000000000000003000000000000006100030000030000000003000000
660000000000000333333330000010000000000000003333366000004300000000000000003000333333660000030000000000000000000000000001000000000000130000006010000000000003000003300000
660000000000003333333330000000000000000000301333306100000300000033000000030333353303660010003000100000000100000001000000000000330000033001106600000000000033000003300000
333333300333333333333333333300000000100000033330030030330033333000001000000003333330333333333363300010000000000000003000000003300000033033130333003000000030000000333303
