000000000000000000000000000000000060000000000000000003003010000000010000000000001000000000000010000030000000000000000000031000000000000000000000000000000000000500000000
000000000000000000000000000000000000000001020000300000000000030000000000006000010000001000130600100000000000000000000000000010000000003000000000000060000000040000000000
000000000000000000000000000000000000110000000000201000000000000000000000000000004400000010000040400000300000300000000000000010000000000000000000000000144000000300000010
000000000000000000000000000000000000002000000056100000000000000000000000000000005000000200000000000000600000000006000000000000000000000020300000000300004000400150006000
000000000000000000000000000000000403006000000003600000000060000000000100001060000000006600000000000000000000000000300000300000000030000660000000100000000200000030066000
000000000000000000000000000000200000064320000006600000000000000000003100000000000000006602000000000000000010000000000300000000000300000660000000000000000000000000060020
000000000000000000000000000000000003333300033303300000000000330000000000000003330333331313033033030000000000000000000000000000000100030333300000000330333300000003330340
000000000000000000000000000000000000003000300000000001000006000000000000000000101010000000000000100000000000000000000000000000000030300003000000000000010000000000000100
000000000000000000000000000300000030300000000000000001000100000000000010010000010001000000300000000000000300000000100000000000003000000010000000003010000000000000000000
000444000000020000000000000000000000004440010000000000000000000000000100000000000001003010000000001030003000000040000060000001000000000000020003000000000000000000000002
000000000000660002000000000000000050000000000000000000030000066000000000000060002600000000000000000000060000000000000000030000000000000000660000000003000000000000000036
000000000000660066000000000030000000000300000000000000000000036000000600000000066000000030000100000000066000303003000000000000000000000000660000000000000000000100000060
000000000000660066020000000000000000000000000000000010000000066000000000000000060003000000010000000000066404030000000000000000000000000000000000000000000000000000000006
333333333333333333330000033000000303330030000000000030003333430000000000001013030330000033600000000330003020000000003300000100333331030360330000330000000000000303303033
