000000000000000000000000000000000000000000013000000003000000000000000000000000000000000000001000000000000000000000000000003000000000000000000000000000000000300000006000
000000000000000000000000000300001030000000500100000055050000003300300000000000030000000000000000030000010000000000000000001000041555550010000005500000000300000000000000
000000000000000000000000000000060000010000000000310011110001000000000000500000444066000000000000000010000001100000000000000030100011100000011001111000000600000000040000
000000000000000000000000000000000000011000000000000000000000000001010000500000000030100000000000000005015000200000000000000301100000000000001010300000000000000003001000
000000000000000000000000000000000000011000000000000000000000000001100000000000000000000000000000000000000000030000000100000001200300000300000610000000001330000000000000
000000000000011000000000000000003040001000000000000000000000000100100000000000000000100000600030000000000000100000010000003001310000300000000100000030000000000010000000
000000000000000000000000000000000003333330000303300300330010000031330300300003333333000102000000000000000330030300000000000000333033330333333032303000010000000003330303
000000000000000000000000000000000000000000000003430000000000000003000000000000000000000000030000000000000000030000000000000000000033300000000005050000003000000000000003
000555550000000000000000000000003000100000000000000000000000000000550500000005000000000001050004000005155000500000000130000000200000000000000200000503000010000000000000
100111100000000011000044400000000003003000040400000000006000000100110160000000000000344000030000001001111000000000000000010000010000054043000000000000000000300003000000
100000000000000011000000000000000000000000010000000000000300000000500010000000000000000000000000000003000000000030000000011100000500000000000011010000003006000005000000
000000000000000011000000000000000000000000000000000000000000000000000000200000000000000000000000510000000001000000300000011000000010000000000001003000000000000000000000
000000000000000001000000000000000000000000000000010000001030000000100000134010000000000000000000300000000000000103000000001000100000000000000001000000000000000010300000
333333333333333333333333333300000000000603033333300000000000000333033000010003303010323000333333333333333000000000000003333033301000033113333533333333333000000000002000
