300000000000000000000000000000000000000000000000000300000000000001000030010003060000000000030000010300000000000000022000005010100000000000000000000000000000000303003000
300000000000000000000000000030000000000000000600000010000000000000000004000000000000000000000000000000010000000000000000000000000100000000013000000000000000000003000302
000000000000000000000000000000000000000603000000030330010000000033030000000010000100303010100000000000000000033300000000000333000000030333014004000000000000005000000000
050000000000000000000000000003000000000000000000000001000000000000000005000000000000001000000000000000000300000000000000010300000000000050000000000000000000000000000000
000000000000055000000000000500000003000000000000000000303000000000000000000000000005000000000000010060005100000000000000001005000010530000000000000000000000100050000001
000000511114500000000000000000000050001000000001000000000000000000000030000050000000300100000000051010400000000000001020100000000000003001010000000000000010000000001005
000000000000000033300000300000003000233000000000000000000300000001000000300020003000000000300305000000000000000500333000003000001300000000030003000330000000200001000000
000000000000000000000000000002000300000001003000000000000450000000000000050000000000000000000000000000000000000100300000003003000000001000100000000000000000010000000000
000000000000000000000000000000000000003600001000000030000000010000000000000000000003000000000000000040000000000000000000000000300000000000000000000001000000300000500000
000000333333010000000000033330000000000000000000000000000000000000000300000000000333000000000000030000000000000000000030000000000060001000001333301000000000000000001000
000000000000000000000000000000000000000000000000000000000000100000000000000000000000001000000000001000000000000300300000000000050000000000000000100000000000000000000000
300000000000000000000000000050300000001001000000000000000030005300000010000001003000100000030000001000300050000030000000000000000000000300010000000000000050000000003000
000000000000000000000000000000010001113450000000000000001111050000000001005001000000010000000000000000000000000000000000000000010000511014300003011000000000000000000000
003300000000033300000000300000303000000000330000000003000000000000310030333000053003003630000333000003000330001100330003300000000000000000000000003000300000303000030000
