000000000000000000000000000300000000000033000000000000000000000000000003000000000000000000000001036000000000000004000003000000000030000000000000000000000000000000000000
100000000000000000033101101000050000000000000003311003001000000301010000000000110500000005310110100000000000010001000000003033000500000000020100000001300000000003000000
000000000031155000311111111100000000060000500031100000000000000100000002003000001000500001101111110003000000000000000005000311300000000031150000000001015000000005040010
000000000000000000000000000000030000000000000000000100000000000000060030030000000000050000300000000003000000000001000000000000000000000000100300000300000050000000000000
000000000000000000000000000000030500000000010000000100000000000010005000030000000100000000000000010003000010000000000000001000000000000000000000010010000003000010000000
000000000000000000000000000060100000000050000000000000000000000000000000001000000000000000003000000033100000000000000000000000000060000000000003020000001000000000300000
000000000000000000000000000030000000000000110030030333300000100003330000001003633300000000010000003000000103333333333300000000300000000000000033033303100033000330000000
000000000000000000000000000000000000000003000000000003000000000000000000000030000000000040100006030000000000000000200000000000000000001000000000000000000003000030000000
111000000000000000000000000000300001011010000000000000030300033000000300110100310500000100060000000000000111000000000100000000003000060101101110000000003310010100000000
000000000000000003300000000000000001111111000311500000001000303000000011111110003113000000000001000010000000000000000100103301000003011110010000100500031111311010003300
000000000000000003000000000040003000000000000000000006000000000000000000006000000000100000000020001001000000000000000000003000000100000000000000000000000000000000003000
000000000000000003000030000000000000000000000000300003000060000000100010000000000010030300000000000000000001000200000300000000000000000000000001000000400010000130003000
000000000000000000000000000000000030000000000200000100300000010000000000000000000000000300000000300000000000000003000030060000003010000000000000001000000000000000000000
333333000333333000000330003333000330000000000000100333330000000030003000000000000300330003000000000000000333333000333333003000330003500001003003330000000000100003000000
