000000000000000000000000000000000000000000000000050000000000300000000000000000001000000300300000000000001000000000000000000000004000000000000100000000100000000000000000
000000000000000000000000000000100000000000000000030000000000000000005000000000000050003010000600500000030000000000000000300000000000001030000000000000000100000000000000
000000000000000000000000000000000000444440011010130000000003000000000000000000000000000000010053001000000000000000000003030000000000000010100000000011000104442030000500
000000000000000000000000000000000020060000003000005000000000000000006000100060000050060000000000000100000000000000060000000000000000160000040010000001000000000000000000
000000000000000000000000000010000000000000000000000030000000000100000000000000000000000300000000000000000030001010000000030030000000000000000010000020000000000000000000
010000144444000000000000000003000000003000000000000002120000202000000001300014444400000320501000010000003000000000000000000000000030044441000000000000000000000300000203
000000000000000000000000000000000000333330003333003330030333335000000000000000100000030333310300000000000003330033033300002000000000004000000000001333363303333330333333
000000000000000000000000000000000000000066000300033000000000630000000000030600000000000000000300000000000001000100000030000000000000000000000000000000000030000010000030
000000000000000000000000000000000006000000000030000000000000000000000010000000000000200000000000303000000000000000000000000010300000000000000000000003000000000000000000
011000104444400000000000000000000000003000030000000000000110001000000004443030000000000100031100010344040003003001100010001000044444000000000000000000001000050000000000
000000000000000000000000000000003000000000000000000000000200000000000000110031000600000000000000000001000000000000000000000000000000000001000000001000000015000000010000
000000000000000000000000000000000010300501300001600000000001300000010000000000000000000000500100000000000000000000000000000000000000000000000060500300000000000000000000
000000000000000000000000020200000100444400000300100005001000040000000005000060003010444440001000000000000000000300000000000201000000101000010100000001000044404000000000
333333333333333333330033333300000003000000000000033333303303333000000003300333030330001000030333333303303000000033000300030353000303300000000000000303333000600000500000
