000000000000000000000000000300000300000000000000100000000000000000000300000030000000000000001000000000000000002300000000100000000200000005000000003010000000000010000000
000000000000000000000000000030000001000000000000100030000000000000000100000000000000000000000000000010000000000001000000000100000050000000000000000000004000000000001000
000000000000000000000000000004000000000000000000000000000300000000000200010000000000000000000000000000010000000000000000000000000000200443400000000004440300000000000000
000000000000000000000000000004000000000000000000000000000300000000000000000000000000000000000000000000000100000000000000000000000050000000000030000000000000000000000000
000000000000000000000000000000000000000000000000000000000003003000030000001000000010000000000000000000000000000000000000000000000000200000510030000000000000000000000500
000000000444000000000000000000000000000000014346000000000000000030000000030000000000000000010000000000003000000000000000003000004440030000000000000200000000004000000000
000000000000000000000000000033003300300333000000000000000003130000000000000000000010000000033333330003333000000000060003330302000050033333030100000013330300000000300000
000000000000000000000000000000000030100000000400000100000000100000000300300000000000000000000500000100000000001010000030000300000000000000000000000000000000000600500000
000000000000000000000000000000030000300000500000030000000000000300000000000000000000000000000000100010000000000000004000000000000603000000000000000003003000000030000100
000000000444440400000030000000000000004441000000003000003000000600444401000000000000303001000440400400000000000000000010000000000000003000000300000000000000000000400001
000000000000000000000000000000000000000000000001000000000000000000000000000000000001000000000000060303000000000000000000000010000000003031030000000000010100003000000000
000000000000000000000000000300000002000000000000003000030100000000000010000000010000000000000000000001000300000050000000000000300010000000030000003000000000000000000100
000000020000000000000000000300003000300000000000000001030000000000000000000000010400000000020100000000000000440000000000000000000000100030030000003000000000000000000000
333333333333333330333000333300000003333333000000000033303333313303303333303360000000030000030333313330333000000000000000000100033033300030330003333034333300000003332333
