000000000000000000000000000000000000000000000006000000000000000000001000000050000000000000000003000300000000000300000000000000001000000000000000000000000030000000000000
000000000000000000000000000000003000000000020000000000000000400003000000000000000200000020300000000000006000000000200000000000000000000000000100000000000000000000000000
000000000000000000000000000000000050002000030030000000000066000000000003000000001600000660100000000000000000000500060020000030000000000020000066000000000000000000100000
000000000000000000000000000000000000060000000660000000000066000000000000000000006600000660000000000000000000000000660000000000120000000000000306000000000000030000000000
000000000000000000000000000000000000006000005000500000000063000000000000000000006000000660000000000000300000000000660400000005000000000660005360000000003000500020000000
000100000000000000000000000000003000065000000100000000000000020030000600010100006600100360010000000000000000000000660200000000000000005660002066020000000000000000000000
000000000000000000000000005500003130333030000000000600000333300000010100000003330330333333300310000010055313033330300310000000000005533030033330033010000000000003020333
000000000000000000000000000010000550000000000000000000000000000000000000000000000000000010000000000000000000040000000000001000000000000000000000000000000300000001000000
000020000000000000000000000000032000000030000000000000000000000000000000000000000000300000000000000000000000000000002353000000000000000053101000001010000000002000060000
000660000020000066000000000500066000000000000600000000000000000010200000000000000000000200000660000000000000000000116000003000003000001130050102030000000003066000000003
000660000660000066000000000000066000000000006600000000010000400006600000000003000330016600000060300000000000000000000000000000000003000005000066000000000000066000000003
000660000660000066000000000010066000000006000600100000000000200006600000000000000000006620000600000003000000000030066000000000002000000000000060000000000000066000000100
000660000660000066020000000000066000000000006002000000000000000006600000040000001000006600500060000000000000130000066000001000000000001600000066000000000000066000001000
333333333333333333333303033303333311000055334330350030000000030331033300040550430013033333330303330000003000000033333330005300000000030303303303333001005500330330000000
