000000000000000000000000000300000300000003100000000000000000003000010000000000000000000000200000000000000000006000000000050000001030000000000000041000000000000030000000
000000000000000000000000000000000000000001000000000000000010100010000001000000000000000000000000000000000000000000000000020000000100000000000000000000000000000000000030
000000000000000000000000000040000300000000330000000000100000000300000000000000000003300000000060000000000000000000013000030000004000000000000000000000040400000000001000
000000000000000000000000000000060000000030000000000403400000000300000000000000000000300000000000000000000000000000010100100000010000000005000030100003003000000000000000
000000000000000000000000000023000000040000300004000000000000000001000000100300000000300060006000000030000000000030000300000000001000030005000000000000000003000000000003
000000000000004000000000000000000000200000300000300002000000000300303000000000010000000000000002004030010000000000003000000100000003020000030000200100003000000000000000
000000000000000000000000000033333030000000300000330303300000003300010050000030000000300000331303330000000000000030033303000000000000035333303313333313303300300000000000
000000000000000000000000000000000100000000000003001000000000000000200000000001001000000000000000000000000000000303000000000000000000000000030000040000000000000010000100
000000000000000000000000000000000600000000000300000000000010000001000010000030000000000000000031000000600000100000000000000000000000000000000101000000000000000000000000
000000000004044400000300000000000000003404000000000100000000000000040444100000400010000000040000000000400001030000000004400000300000000000000300000000000044000003000000
000000000000000000000300000000000000005000000000000100000001000000000000100000001001000303000000000000000004000030000000000030300000000000000000000001000000000003000000
000000000000000000000300000000100010000030000000000000000000000003003000030000000010001000000000000510000000000000000000000000300000000010000300000000000000330000000000
000020020000000000000300000003000002000030430000006000000000000200000000300000001200000000000400002300000000000000000000000000000000000000000000000400000200000000000000
333333333333333333303300000010001003333030000000000000000003000313033330303030303333000000033330033030323000000000000000330303300001000000000000000000000003003030000000
