000000000000000000000000000000000100000000000000000000100000000000000000000000000000000003011000000000000000001000000000000000000000000000000000000000001000000000000000
000000000000000000000000000000000003000000000000000000000000000000000510000000000000000000500300050000000000003000000003000000030000000300000010300003000001000000001100
000000000000000000000000000000011000000010100300000000000002000000500000010000000000000000000000000052000000000100000000000000000000000003000300000000000110000010000000
000000000000000000000000000000100000000000006000001000030060100300000000000000000003000000000000000665000000000305000000010003000000000500000000000000000000000030000000
000000000000000000000000000030000000000000000000000300330006030300100000000003001003000000000000000066000000003300000000000033000000000000000000000000300000001330000000
000000000000000000000000000000000000005000000000000001332066202000000005000000000003010000000000002060202000000300000000000033000020000000300040000001010000000000200000
000000000000000000000000000000000000333303000010034033013333333000000000000000333333000003000030003332333033330330303030033333000000501100010000000300030333333030000000
000000000000000000000000000006000000000000000000300100000000000000000000003000010010000000000000000000000000000000003100000000000000000050000000000000003000000050000500
000000000000000000000000000000000000000000000600006000000003000000001000601000000000000010000000000000000001001000000000000000500000000000000000060060000001000030000600
000000000020000000000000000000000000000000000000000000000000000000030000000000060000000000000000100030000000000000006010000000000000000320010000006000100000000100002000
000000000660000000003000000000660000000000000000000000010000000010000000000003000000000005000000000000010000000010000000000000000000303660000000003010000000100000036000
660000000660000000033000000000660000000000000010060000000000600000000006000000100000000000000000006600000000000066000000000000000000000661000300000630000000000100066000
660000020662020000033000000000362020000000000000066000000000500000000066000000000000001000000300006600000000000064310000000000030000320603020060000660000000000002066202
333333333333333333333333333313333030000300130000533330300000000000003003303330033333000000003333303003013000000030333300000000000000030303000006000303333310000003334333
