000000000000000000000000000000000000000203403000001000000000000000000000000000300000000100000000005000000000000000003000000000000000000000000000000000100000000000000000
000000000000000000000000000000600000000000000000000000000001000000000002010600010000000000000000000000000000000100000000000100000000002000003100010100000002000003000200
000000000000000000000000000000002000001000300000000000010000000001000066300000000006010000006001000000001000010000000000000000000010066001000000000300000060001000000000
000000000000000000000000000000000000100001000600001000000000000000006066000000000000030000006001060005001000006000000000000000300000006000000000000000000006000000000000
000000000000000000000000000000000000000000000000000400000006000000000060000000000000000000060000000000000000000000000000000000300000060000003000000030000066001000000000
010000000000000000000000001001000020000000000000000000002302000000300066200010001010220200006500000006010000000023020030003000000000060000000100003000001066250010000000
000000000000000000000000000000000003333333333013000010003333333331033135533100000000303333333333100000000000000033330300000100000000043000300001303000000430333000330303
000000000000000000000000000000000010000000033000100000300000000000000000000000000100000000000000000000000000000000100000000010002300000300000000000000000000000300030000
000000000000000000000020000000000010200000000600000000000000000300000000000010000000000000000000000000000000000100000000000000000000000003000000000000000000050000000000
000000000000000000000660010000000606600100000000000000004000000000000000000000000000003000000000000000000100000600000000000000000000300000000000000010000000100001000002
000000000000000000000660000000000056600000000000000000000100000000000000000000050000000000000000000000000003000000001000000000001000000000100000006000000000000050000000
000000000000000000000660000000006006600000000003000000000000000000300000000000000000000003001000000000600000000000000000000000000000000000000000000060000100000000000010
000000000000002202000662000000000106220000000000022000000000000010001000000003000000100000005000000000000000000000000000600000000101000000000000000320200000000000000000
333333333333333333333333333000003003333030000000033060000060300003000000000003333333000000000000003033033333030330330300000000000000030133333000000333033300000003330033
