000000000000000000000000000000000000030000000000000001000100000000000000000000000000000000103000030000000000000000000000000001000002030000030010000000000000000000000000
000000000000000000000000000001030000000000000000000000003040000000003500000000000003000000000000000000030000310030000000003000000300005000000010003000000000000000000000
000000000000000000000000000000000000300000000000000000003000100000000300101000000000300000000000000000000403000040200000000003000000000001000000000430000000000020000000
000000000000000000000000000010000000000100006000300000040000000000000300000000000000000000100000000010000000000000000000000050000000000000300000010010000300000010000000
000000000000000000000000000000000000000003000000300000000000000000000310000000000000000000000005000000000000000000000030000003010000000000000000000000000000001000003000
001111000000000000000000000000000060010000000003300000000300000300503300000000000030030000000311100000000300002000000200000033000060000100000000000000002000000000000300
000000000000000000000000000030303300000000003333300005003333333003303000001003333303000010001000001060000330333300303333302300000000133333310000000335310330333330000000
000000000000000000000000000000000000000000000000001111000000000000000000300000000000003000300000000000000000000010000000010000000000000000100000000000000000000100000000
000000000000000500000000000000000000000000000000000000000500000500000100000000000000000000005000000100000000000000000000000000000000000000003010060000000005000001500000
400000000000000000000000000300000000000000100010000000000000000000000000001000000100000000000033300000006000000010000000000000010000001000000000000000000300000020000000
000000000000000000000000000300000000000001000000000000000000200000000000000000000000000010000005000000000000000300100000000000000303000000000000000000000000000003000000
000000000000000000000000000300000000000000100000000030000030000000200000000000003000000000000000000000000000300000105000000000300000000300000000000000000340400000000000
000002000000000000000000003350000200000000001131000000000000000001161000000000001100000003000000000000000000003300111100300000000100000000000010100000003300100001000000
333333333333333333333333333303331003333131000100000000003303333000000000030000000000333333333303300000000333330003000000000000000000330303330000000330303000000000330333
