000000000000000000000000000030003000000000000030000000000000000001000000000000000000000000600100000000000000000000000010060000003300003000000000500000000006000000100000
000000000000000000000000000030310000200000003150000200000200010000000000050030020030060000000000000020050000000000000010000000001001000000000060000021000030000102000000
000000000000000000000000000000030406600000000100011100046000000001000030000001111100060000000000001111104000030266000000011604000000000000000000000660003000000000000000
000000000000000000000000000000000006600001003000000050000600000000000000000000000000300000200000000100000000000066000000000010000000006010000100000600000010003000000000
000000000000000000000000000000000000600000000000000000000000000000000000000000000000010000000000030000000000006066000001000000000000000300000000000660010003000000000000
011444000000000000000014100001044406600020000002020000006600000001344001410000000000053100000000001200000000100010000302000000000003000000000113440660000103000053100000
000000000000000000000000000000000003303033000000033103303330333030000000000000330303000000000000000300330000353033336333303303000000030033033000000003311330033300010000
000000000000000000000000000000300000003000000100010000001030000000000000000000000030000003300000000000000000000000000030000050500000000000300000000000001000000001000100
002000000000000200000000000000000000060000000000000000000000000000000000000000000000000000000000000300000000000000000000000000000010000000000000000000000000000000020000
111110400000006600000001000000000006010000000003000000000000000001000000100000000000001000000000000060000660000000000000000000001000000000000000000000000000000001011100
000000000000006600000000000000000000000001000000000000000000300000000000000000000000010000000000000000000000000000000000000000000003000060000003000000010000000000000000
000000000000006600000000000000000060010000000100000300000010000000000000000000000010000000000000000000000660000000000000000000000000000040000000100000000000000000060000
200000000000006600000200000000000000000000001010103410000000100200000000000000000000200000001143400000000660000500030000301000200030001144400000000000000021000000001000
333333330033333333333333333300000003330133610333300000000000000333333300033330000000133333300000000000001303033300100000000000333003300000000000100000000053333303303300
