000000000000000000000000000000000000000000000010003000005005120000000000000000000000000000000013000000000000000000000000000000000403030000000000000000101050000001000000
000000000003300000000000000303000000000000000000001003100300000000030000000000010000000000034000000000100001033003000000000002000000320003000000000000000013500000001000
000000000000000000000000000000000011000000033330000000000001000000100000000000000000040000000000000333000010000000000010000043000000000000000000000033330100000000000000
000000000000000000000000000000003000000000033300003000010000000000330001030000000030000000030000000331000000000000000000000000003000000033010000610033000000000000000000
000000000000000000000000000000000000000100030300153000000000000000030310000000000000000000100000000333000000000000000010000000000000060303000010000003310000000000000000
000000000000000000000000000000600030000000330301000006000000000133330000000000100300000000000000003333000000300000000100000000000010003330000000036333000300000000000010
000000000000000000000000000050000000000300031600300000000040000033331300000300000000000000000010010000003000000000000000000000300000003330030000000030000300000001000000
000000000000000000000000000000000000003000000000000000000000000030000003000000000000000000000000005050500011000000000000300000000000000000000000000000000300000000000000
000000000000000000000000030000000000004000000000000003000010330003000000000000000000000040000000030000000000000000000000003030000000003013300000000000000010000030030000
000000000000000333303000000000100600000000000000000060000000000000000003010030000000000000000000000000000000001003033030000000000300000000100000000000000000000000000000
000000000000000333000000330001000000000000026000000033000000000000000003301000000030000330030000050000000000030001330000000003003000000000000000310000000040000005000000
000000000000000333000003330000300000000000002001000331500000000000000003300000010001003350000000000000000030000000330000000050000000000000000033300000000000000000000000
000000000000003333000033330000000000000000030003003303000000000000000003530000000000033330000000400000000030000030000000000000000010300000300300300000000000000033000000
000000000333330300003033333300000000000000000333303333330000000000000003000000603333033003300000000301333000000000000030000003003333300000000333303003330300030004010000
