000000000000000000000000303000000010000000001100000000000000000000000001000300001000000000000000000000010000303000000000000000000360000000300010000030600003000000000000
300000000000000000000000003030330300030000000000000000300000000003330300003000000000060000003000030330000000003000300330000000300001003003003000001000000000001300000000
000000000000000005555000000000000000110000000010001000000000000300000000000100005555000555500030300000000000000030000300000000000000000000000000000000555500000003000033
000000000000000000000000000000300000000000300000000001000000000003000040003000000005000030000000030100600000000000000300000000000000000000000000000010000000000000000000
000002000500000000000003335500000000000000000000000530110000020000005000000000000000000100001000000000000003335500100000000000000002000000000000020000000000500000003000
333033333333300000000000003000000000000000000000033333003300303000000000000000000000000100030000000000000001003000030000000000053033301303303330333000000003333300000000
000000000000000000000000000000000001000000003100000003000000005000000000010000100000000000000100000400006000000000000000000001050000000000000030000000000000000000001000
000000000000000000000000000005000003000000000303305000000003000000000000000000000000000006000000000000000000000003030300003000000000300000000300000003003000000000300000
033000000000000033333000000000000000000000000003033000000000001000050000000000000001013030300000000000000300000000010300000000000000003300000300000000003000333330002000
000000030030333000000000000030030330005553000000000000030000000000200030030053000003330000000000000000000000000000000003010033000555500000000000000010001030050020000000
000000000000000000000000000010000000000000000000000000001000030000100000000000000010000000600000050000030000000000000000000000000001000000001000000000000000000100010000
000000000000000000000000000000000000000000003030000000200030350000030000000000100000000000001000000053050000602000063550000000000001000000000000000003030510000000000000
000000000000000000000000000000000000000100000003030300330000000053333000000000000000000000000000003333030333033300000000100000000000000000000003000000003000100000000100
000000000000000000000000000000000000000000000000000020000000000000000100000030003001000000000000000000000000000000000000000000000000000000000300000000000000000000000000
