000000000000000000000000000300000000000000000000000000030000003000000000000003000010000030000003010000310000000000010030350000000000000000000000000330010000000000003000
000000000000000000000000013000010000000000000000000000300000030010330001000000030000000050000000000600040000330000001300100000000000300000200003300000000000005300000000
000000000000000000000000000000000000002000600100000000000000006000000001000003000000000001001000000000000000000000000000000000000000000000000000000600303000100000000000
000000000000000000000000000000000000000000000360000020000000000000000000000000000000100300000000000060000000000000000000010000300030000000000000306000000000000100100000
000000000000000000000000000000000000000000000000000000000000000000030005100000000000550000000030000000030000000100000000000000000000300000001000000000000005000004000000
005500000000000000000000000000000000000000000500010000000000000000000000000010000000001303000550000000000000000000000100000000005500000001300000000000400001000300000001
000000033333000500000000000031333000000000000000000300000000000000000033333333303010331333000000003330300001000000000000001333000300033333000000000100033033033530333300
000000000000033330000000000033300000003000000000010000030050000000000000000003010000000100300000000000300136000000000030000000000000000000000500000000000330000000000000
000330000000000000000000550000030000003300000500000001000000000000000000000000000000000000000000100000130000000000000040301500000100000030001000130000000100001000000000
000000000000000000000000000000000000100000000000000000310000000000000000600000000000100000000000000005010000000000000300006000001000000000000000000000000200000300000000
000000000000000000000000000000000000050000000000000000000000000000003000000003000000000100041000000000000000000000000000000000000000003000000000000000000000000000000000
000000000000000000000050000000000000000000050000001000000000000000000000000000000000000000030000000100000100100100003000000000000004000000013000000000000000000000305000
000000000000000000000000000000000000000000000003000000000000000000000000500000000000000000000100000000000000000100100000000500000000003000010000001000000000550000000003
000000000000000003333333333300003330000000300330310000000000000050000000000000000133000000005000000000000000330300000103033333050001000010000001000100000000300000500000
