000000000000000000000000000010000000030000300001003000000000030000010000000000000000006000000000000000000000000000040000000000000000000000000000000000000000000100000000
100000000003000000003000003300000001000000000000011000030000000000000000000000000000000000000000030010033000000310300100001030000000000000530000303000000000000330001000
000000000000000000000000000000000003000000001000000303113000000000000000033000000000000033300000000000000300000000000003000000000033310000000000000000000500000003000000
000000000000000000000000000000000005300000000000000300000000000000001000033330000000030133300000000000000000000000000300000000000300300000000000000000010000000100050000
000000000000000000000000000010000000000000000000010000000000000000000000330030000000000333300010000300000000000000000000000000103303300000006000000000000000000001133330
100011100000000000000000000000000000000000333033000000000000000000000003303003333300033303300010000000000000000010011110000300033350300000000000010333330000000000000000
000000000000000000000000000000000000030000003333000000010000000000033003333310033130033033300000000000000000000000300000000000360133000000100000003003033000000000000003
000000000000000000000000000000000000000000000000000000060000100003000000100630000000000400000000000000000000000000000000000010000000000000000000000000000000000000000000
000000000000000000000000000000000100000000000300000000000000000000600000000001000500100054000000000003000000001000003000000000000010000003001000000001000000000000001003
300000000000003000000000033300000003000000000003330000003000000000000000000000000300000000030000000000000000000030000000000000000000000000000305005300000000003330000000
000000000000000050000000333300000000050000000331300001000000000000000000000000010000005000000501000000000000010000300000000000000000000000000000000000000000010330000000
000000000000003333330003333300003503333330000333300000003333330001000000000000000000000000030333300000000000100033333300000000000010000000100200000030003000333330000000
000000033333300000000033333310001010000000003333300003600001000030000000000001000011100011000000003333300000001000000313303300000000000000001400011000000003303330500000
000000000333300000003333333301000000000003313333300000000010003000000000050100000000000300100000000033330000000030000030033330010000000010000001030000000003330630000000
