000000000000000000000000000010000000001000000000000000000000000000000630000001000000300000000000000000130000000000000000000000000000000030003000001000030000001000000000
000000000000000000000000000000000000000000030000010000500000000000000010000000000000000000000000000000030330000000050000005000100000100000030000000000000000000000300000
000000000000000000000000000030000010000000033000333000310000000000000006000000001000000060001000000001141000000000000001101100000000000000000000006033300000000001001100
000000000000000000000000000000000000000000000000030000000031003040000000000000000000300000000000000300000000000003010000000000000000000000300300000000000000000000006000
000000000000000000000000000000006000313300000003033000003000000000000000000000333300000000003033003300000000000003033000100300000000003000003000100100006003300000000010
000000000000000000001411110000000000030000300003033000000000000411111000000003003160000000100033303000000000000000000000000000401110000300000111103000000000033000000000
000000000000000000000000000000000003300000233330333333330000200000000000005003333000000000030330003331303002000033330001130000000000600010000000000330003333330003330000
000000000000000000000000000010000000600000000000000000340000000000000000603000300000300000000000000600000000000000000000000000000000000000003000000000005000000030000020
000000000000000000050000000000000000000000000000000010000000030030030000000500000000010000000000000000000000100000006500000000000000000000000000000000000000010000000000
033300000000003301141111110003000000000000111110001000000000000330303033011411111100000100311101000333000000000033011410000000003330000000003301141000000000000000000000
000000000000003300000000000030400000000030010000000000000000000000000033000000000000032000000000000000030000000033010001000000000000500000003300000001000000000000000500
000033003333003300000000000000000000000000000000000000000000000000033033000300000000000000600000000000030100000033000000000000100033000000003300003000000000000000000000
000033000333003300000000000000000004101100000000000000000000031000003033000000001000401010000000000000330000000013000000000000000033000000013000000000000000000000000000
333333333330003333333333000010000530000000300000000000000000000030033003303333300000000000030000003330330000000030303330000000333303000000000033333004000000100000000000
