000000000000000000000000000000000031000000000000000000000000000000000000030000000003000010000000000000000000000030300000000000000000000301003000000000000330000000000000
000000000000000000000000000000000033000000000000000060100000003000103000000000000000000000000000030000000000001030000010000000000000000000000000500000000300030000000000
000000000000000000000000000000000330500000000000000000000000106000000000000000001306000300000000300000000000000030000004000003000000000000000000000000001300000000000000
000000000000000000000000000000003333000000000030000001000000010000000000000103000003000000000010330000000000000000000000000000600000000000000000000003033330000000001004
000000000000000000000000000000053003000000000003000000000000503000000000000000000000000000000033130003000000010030000000000000005000000030000000000000033310000000000000
000000000000000000000000000000333333000000000000000000000000001003000003000000000000000030000333330000000000000030100000000000000030000000000000000003303330110000130306
000000000000000000000300000000333330000000000000330000003000020000000100000003003333330333030333330100000300033300040301330330000000523000000000000333030000000303333333
000000000000000000003300000000000000000000000000000000000000001000000300000003000000000300000000005001000300200030010000500010000000000000000000000000000000010000300001
000000000000000000003300000000000000030000000000000000300003030000000300000003003000000000010000600013030300200000000000002000000003300000000000000000000000000003000000
000000000000000000033300000000003010000000000300000031011030000000003000000000006030000001000000000000000300000000100003000030000000300300000000000000400010000010000000
000000000000000000333300000000000003000000000030000000000000003000033300006003000000000010020000000000000600600000000000000000000033300000000030000000000050000000000000
000000000000000003333300000000000010000010000000000000000000030000003000100003000000100010000400000000000300000000000000000000010133030000000003000000000000303030000000
000000000000000033333300000000000000000000000000000001000000000003330300010003000000000000000000030000000303000003000001000100000130000100000000300000000000000000000300
333333333333333333333000003013330300303330000103030000003330330333333400000000003031300000000000000000030000003030000000600000333330300333000000003300001000010001331333
