000000000000000000000000000000000030300000000000000000000000000000100000000000000000000300000000000000300000000000043000300000000010010000000000000000500000100000000000
000000000000000000000000000000000000000000300000000100000000000000000000000000300030000000000000000000000000010000000000000000000030000000200000000000000000000000000060
000000000000000000000000000033000000050000000000001001100000001040000000001045000230000000000000000000000000000001000000000104000000000000000000004100000000000200001000
000000000000000000000000000000000000000040000030000000500000000000000005000000030000000000330000405400000030000000000000000000000000000000000000000000000000000000000000
000000000000000000000000000010000003100010000000005000000000000000003000000000000000000000000000000000000000100030050000000303003000040000000000000003000010000101000000
111100000000000000000000000000200000020000000000000000000020000020000050000000600000002000000003001011010001000000000000000130000000003000000000000010000000000000000000
000000000000000000000000000000000000013333000000000000003333330331303313330030000100333353300000000010000003000000000003300333100000000333333330303000000000000000006000
000000000000000000000000000051030000000000000000001000000000000000100000100600000000000000000000000003001000000000000010000000000000100000000003000000000610000000030000
000000000000000000000000000000010000000003000000300006003000000060000000000035000000000010000000000000000000001050000003000000000000000000000000000000000000000000000000
444000000000040400000000000000000004400000010000000000000010000103000043400000000000540000000000140000000404001000000300000000000000044000000000000000000004000004445000
000000000000000000000000000000500000000000000000005000000000000000000005300000000000000310000000000000000000000003000000000000010000000000000000000000020000000001000030
000000000000000000000000000000000000000000000000004000000000330000000000600000000000000000030000300100000000000000000000010000000300000000000000000003000000010000300000
000222000000000200000002000000000030002000110100000000000000000000000030022001111100020000000003003000000000200051110000200000000000000020200111004002000002000000002200
333333333333333333333333333300333333033330000010033333030000000000000033033200000000330133333333330000000333333310030403333303000000003300330000000333333333030330303335
