000000000000000000000000000010000000000000000000000000000000000000000000000006000000200030000000000040000000000060000000010000000000000050000001000000000000000005000000
000000000000000000000000000300000001000003000000000000410000000000000000000000000000000000000003200000000000000000000030100000000010000000000000000000000000000000010003
000000000000000000000000000001000000000100000006030300000000000000100000330600000000000000000000000000003000300000000010000000000000001000000000000000000300010005100000
000000000000000000000000000010000000000000000000004330000000000000060003033030010000300000300000000000000330300000000000001000000030000000300000000000001000000000100000
000000000000000000000000000000000000000000000000033330000000000000003000030000000000000000000000003000000333300000000010000000000000000000000000000000000000000000000003
000000000000000000000000000000000011000000100000130030000000000000000033330000000000000000003000000030030333003000000000000000000000000000000000000000004010000000150000
000033000000000000055500000006103005000000003033333333330000330000003033331333030333000033000004550333333303303350063000000455033333333000001300335300333301103305000000
000000000000000000000000000000000000000000000003000000000000030100000000000000000000000000130000000100000003100000000000000000000100000000000000000000000000000000000000
000000000000000000000000000000000000000000000000000003100001000000400000100000000003000000303000000003000300000000010000000000000000000050000000000000000000000000000000
000000000000003033000000000000000000000000200000003005000000100000000000000000000000000000000005000000000000000006000003033600000500000000000000000005300000000100000000
000000000000003333300000000000000000000300300000000000000000000000000100000000000000000300600001000000000000000000000003303300010030000000100000000333030000000000000133
000000000000003333000000000000000000000000000000000000000000000000000000000003010000100000000000000060000000000000000003333010000030000000000000000031300000000000000000
000000000000033333000000000000000000000000000000000000000000000000000000000000100000000000000000330000000000300030000003033000000000030000000010000503300000000000000000
330000033333333333333333333300030553100600000001033330303100000000000533333005002003500000030033030000000330000003333033033033030033000000000010000330333300000000000000
