000000000000000000000000000000000000001000000003000300000000000000000000000000000000000000000000000000000000000003000000000000001300000000000000000020000030000000000000
000000000000000000000000000000000000500200000000000000000002000000030000000000000000000000001020000000030000300000000000000210000300000100000002300000100000000000000200
000000000000000000000000000030000000006600000000030000000016000300000000000000000000000001000660000000000000000000100000005600000000000000000060000000000000000030006600
000000000000000000000000000060000000006600000000000003000066000000000000000006003600000000000360000000000000000000000000006630000000000000500060000001000000000000000000
000000000000000000000000000030000000106600000000000000000066100000003000000000006000000000000650000000000000030030000300300100000000000000006160000003300000000000003500
000000000000000000000000000000000000006600000100000000030060020000000000000001300000010000000661003000000001000000220000006000030000006000001063020000000001020000100610
000000000000000000000000000500000003133303000600000000003030033000603000000003330333000000000031530000005000100000333333330033000000006000003335300000000030333333333333
000000000000000000000000000000000001001010000000500000000000000110000000000300000000010000000000003000000000000000000000000000000000000000010001000000000000000000000000
000020000000000002000000000060000000000000000000000020000000000000000030000003000000000000500000004000000000000011000000000000000000000020000000000000000000010003300000
000660000000000066000000000500000000000000000000000600000000000000000500000030000030000000500006000001000000000000301000000000000000500660000000000000030000000050000000
000660000000000066000000000000003000000000000000000660000000000000000000000000000000000000004056300000001000003000000000000000000000000600003000000000000000100001000000
000660000000000066000000000000000100000000010000000660000000003113000000000100000000000000000006000001000000000000000000000000000000000560600003000000000000000000000001
000660000220000066020000000000000020022000000000000600200000000000000000020000000000000000000006000012000000000000000030000000001000000660200003000000000000440000200000
333333333333333333333333333300000150333333333010333330030000000033303333333330000005033333333343333030333000000000000050000000334133330333330030005000000033303330030000
