000000000000000000000000000000000020000000000000000030000000000000000000000000000000000000000000300000030140001000003000003003000000010300000020000000000000000010003000
000000000000000000000000000000100003010002100000200000000000000000600000000000000000000000000001300000000000001000000000201000060000000000020300602000000000000000000002
000000000000000000000000000000000000020006003006633000000000000000010000030000300003000001000000660000000000000000000000003000000000000000660001060000000000001600000166
000000000000000000000000000033300023300066000000300000000000050000000000300000000000000001003000000000030000000006000000000000033000200000030000003000000010040000100066
000000000000000000000000000033300660000066000003000000000000100000000033000660000000000000000000300000000000001300000000000000033001600000300000130000000000000000000000
000000000000000000000000000033400660200016002000000000000000000000060133300600000000000000000200000000000001000100000000000000333006000000000020000000000000100000200066
000000000000000000000000000033333333333333303330300000000000000333330333333330000000333333330333330000000000000000000000000000333333330333003100300000000003333303333503
000000000000000000000000000003000000000001000000000000001000000000030000000000010000000000000000000000100000000000000010300000000000010000000000000001000000000010000030
000000000000020000000000000201000010000010000000030000000000000000000000000000001002000110000000120000300000400000000500000000000000000000000000001000001100000000000000
000000000000660000110000006600001100000000000000000000010000000000000630000010000000000000000030660000000060001000001100000006000000030000000000000100000000000000000000
033000200000660000000000000310000000000000000000000100300000300100000300000000000056000000000000660000000033000004000000000066000500000000000000000000000000005000330002
333006600000660000000000003000000000003000300300000000000010000000003000000000000016000000000000660000000330000000030000500066030000000030000100030000400000000001000066
333006602000660000000002000000000000030030000000000000000010003002000000000000040066000000002000000000000033006600000000200066000000000000000003000000300000000003331166
333333333333333333333333333303303030000000000000000000005000000333333300050003333003000000033330330000000003333333336333333303000000000010003300000000100000000003330033
