000000000000000000000000000000000000000000000000060000000000000030020000000004000100000000000000000000005300005003000000000001000000000000300000000000500000000000000000
300000000000000000000000000006000000300000000000032000000000000100032000000010605000300000000000000000000000000000000000000000000000001000000000000300000000000003000031
000000000000000000000000000003000003333300000003300000000000000000000030003500005333600000000003333000000333330000000030000000000001000000000333300000000000000000000000
000000000000000000000000000000010100000001001003000000000300100000000000010000000000000000000000060000000000000000000300003000000000000041000000000000000003000001000300
000000005550055000000000050505500000301010000000600001000000500500000000000006000030000000000000000000005000000000000000100505500000000550050000000000006000000000351055
030000033333000000000000003313033030000000000100003000000000030000000000000000000000100000003000030000003000000001000000000003000000034313000000000030000000000003333340
000000000000000000000003300000000000000003300000000300000053000000000000000030033300000000000063300033000060000330000000030000000000000000000101000000000033330000000000
000000000000000000000000000001000000000000000000000000000010000000000000000030020000003000000000010000000050000000000000001000000000050000001000000000010000000001000000
000000000000000000000000000000000000000060000000000000000000000000000000000003000000000000001000000000001000000000000003010000000000030000000000000000000000000000010000
000003333333000000000000033300010000000060000003300100000000000000000000000134000010000000000000033000000000000000000300000000013333000003300000000000000000003030010033
000003000000000000000000000006000100005000000000000000000000000000000000000303000000001001000100300000000000000300300000000000000000000100000010000000000000000000000030
000000000000000000000000000053000000001000000003000105001555005000030010000000000000500100500000000000000061010100004000000040005000000000005140000000050001000000000000
000000000000000000000000000000000000000000000000003000303333300000010000000000000010000000000000000000000333330000000100300000000000000000000000003000003300300000010000
300000000000033333000000330000000003333100000000000330000000000333300030000000003000000000030001003303003000000013330000000000000005300033000100000000300000033003000000
