000000000000000000000000000000000000000000300000000010000000000050000000100000001000000003000100000000000000000000000003000000003000060000001000003000000000000000000000
000000000000000000000000000030000006000000000000000300000000000000000003003000010000000000000000000000030300000000000001002300000010000000000000000000130000000000000000
000000000000000000000000000000000000000000000000000000000000013000100005000000000000000000000066000000000000000000000000000000000200010000000000103111000300000000000000
000000000000000000000000000000000000065000000000000100003003003000003030000100100000000000000006000000010000000000000000000000006600000001000000000033000000000000000000
000000000000000000000000000000000000006033000060000000003333001000000000000000100000000001000066000000000000000000000000000000000603300000000000000330030000000000000000
000000000000000000000000000000000000466033012300000000003330000000100000003000000010000000000066000000000010000030400000000000006000000000000020100333000000000000500000
000000000000000000000000000300005003333033033333300000003000000000000030000000300333000000030330330000033000401000000010000000333330000000003003310330000030000050030300
000000000000000000000000000000000000000030000000000001000000000000100000000000000000000000501000000000004000000000000000006000000034000000000000010000000000000000000000
000020000000000000000000000000000000400000000010330100000000000000000000002000000051000000000000020000000000300000200000000000000000000002000000000300020000005000003000
000660000000000002000003000300000000036600030000030300000000000010005000066000602000100100300000000000000000200000000000111030000000300066000000000000660000000000000000
000660000000000066000333300300000603000600300000133030000000000000000000066000026000360300310000000000000006600000000100000000333000001000000066100000660000000000000330
000660000000000066033333300000001000006600030000033300030000000000000000066000000013333600000000000000000000603100000000000000303000000060000003030000660000000030000000
000660000200000066033333000000000040006600001000030300000003000000000000066010011133033001000000000000000066603300000100020300333001000016000006030000600000000000000001
333333333333333333333330000000000003333333000060030000000006000000010333333333000336300000030333000000000333303130000033003030333000033000330333030333333310000000000000
