000000000000000000000000000000000000000000000000020003300400003000000000001000003000000000000000000000010000000000000010000000000333000000000000000001003000030000030030
000000000000000000000000000000000000000000010000100633303002000000000000000000000000300000000000010003000000000000000300000000000336010000000000000000130000000000000000
000000000000000000000000000000600000000013003300000003000000000003000000000000000010000000000033000000000000000010000200000010000000000330010030000000033000001000000000
000000000000000000000000000030000003000000003300300333000000002003300101600054000000100000003330000000003013060001000000000001003333003030330333300103330300010000060000
000000000000000000000000000000000000000000333300330333000003000333300006600000000000020000033330000000000000000000040000000000303003033030033333003303333000000005000000
000000000000000000000000000000000000000000333031301300300000205101330000600000400000000000013333030000006000020300400000010200330333033303033333003333303000000000000000
000000000000000000000000030000000000000000333333300330300333303330333333300300000000000030033340330000000353330300000003031330333333030303333333333303003300003000000000
000000000000000000000000333000000000000000000000003000000000000000000001033300000000000000000033100000000500000100000000100000000000000000000000000000000001000000000000
000000000000000000000000333000003030000000001000000000030000000000000000030356100000000000300030300000000030000000001000000000000000000000000000000100000000000000000000
002000000000000033000000333000000000120000000000000000000000306000000014030200000000000030000433300000000002000000003030000001000000000000001120000000000000000000000000
066000000000000333003003333000000000600000005000000000603000300000003000331003000030000000000313300020003066000000000000030500000000000000000030000000000030000000100000
066000000000003333003303333013000000660300000000000001000300000000000030330000000000000000030303300000000006000000000000000000000000006600000063000000001300006000000050
066000000002033333303333333000000000661000000020300000000000000000000033333300130003000000033300300000000061000000030000000000000000006000000630000000000100030000000000
333003333333333333333333333300030003330333333000000003000000000000030033033330000000000000033033333000300033000300000000000000000000033100333333003303332300000000000000
