000000000000000000000000000000000000000600000000006000010030000000000000000010000000000060000000000030000000300000500000000000010000000040000000000000000000010000000020
000000000000000000000000000000000000000000000000000000000000000050000000300000000000000000000001000000001001000000000006000000000000000000000000000003000000000003050000
000000000000000000000000000000000000030000000000555320000000000000000000000000400000000000500000000000100404000005000000005000300000000000000100005000000000000004400000
000000000000000000000000000000000000000000000000000000000000000000000000000000000000000000100000000100000000000000000000000000000003000000000006000400000000030000000000
000000000000000000000000000000010000300000011000500300000000000000000000000000000000000000000000000000000000000000000000000013400000000000010030000000000003000000100000
011100000000000000000000000000630000111100000000000000000050000000201000000000002020000010000000030011000000202001110000002000000001005000003000000000000001110000002030
000000000000000000000000000000000000000010333333333333330600000333033300000003333033303333300000000003000330333306530003333333000000000000033333333030303000000003333333
000000000000000000000000000000000000000000010000000100000000000000001050000000000000010000000006000000010500030001000000000000000000000000300000000000000020000000000300
000000000000000000000000000000000000000000300000000000000003000100000000000000000000030003000030000000000000000000600000000000000000000000000010000000000300000000000010
444000000000055555000000000040000001000000000000544400035500000000000500030000050000555500000000000100000000000000000010440000000000055550500000000300000010000005555000
000000000000000000000000000000000000100000000000015000000000000000000000000000000000000000000000000000000000000000000000000000010005000000000000000000010000000000000000
000000000000000000000000000060000000000100000001000000101000000000000000000000000006000000001100000000000000000000000000000003000000000000000300000000000000000300500000
000202000000000000000000200000000000000000000160000020200000000000000001110000300000000001000020000600000010000001000000002020000000000003000000000000030000000011060000
333333333333333333333333333300000000000000303333000330000033313330333100400000001000033333303033030000000000000031633003300333000000300333300000000000000100000003033013
