000000000000000000000000000000000000000000300000000000000000000000000000000000000033000000000000331000000000000000050000000000000000000001000000000000003010000000003000
000000000000000000000000000000300000000001001000000000000000000000000000005003000030000000000010300000000003000000000000000000000000000001000003030000000000300000000000
000000000000000000000000000000000000004000000000000303000000000000000200000001000033000100000033330000600006000000000000000000000000001000000004000000002030000000000002
000000000000000000000000000000000300000600000000000300000001000000006600000000333033000000003300330000000000000000000000000000000300000000000000000010000000000000000000
000000000000000000200000000000002000000000000000000000000000000000006000002003003303000020033033330000030000000030001000000200000000040000000000000003020000000000000066
000000000000000000111000000000001110000000000000000000003000000022006600061010300033000011100100330000000003000000000000000110000000000030000000000000000100000000020060
000000000000000000000000000300000001133003000300500000000000000333303000000005100333000000013003300000333000000030010000000000000100000000033333103000003000000003333330
000000000000000000000000003300100000000100000003000000000000000000000000000000000000000000010000000500000000001000000330000030100000000040000000000000003300001000000001
000000000000000000000000003300000540001000000003000600000100001300000000000000000000000000005001000000000003000000030303000000000000000000000000000000003303000060000000
000400000000020011100000333300311000000000000300300050020003000000050300040500011100100001201040000003001001100000036300000000001100000000020000000000333000111030000600
000000000000660000000033303300000000000000033003000000600010000000000000000000030000000000600000000000010000000001330330000101000000000000660020000031001000000000000000
000000000000660000000333333300000000000000303333305000660100000000000000000000000003000606600000000000000000000003330330005000000000000001660000000333333301000000001000
000000000200660000000030003301000000000000030000300000660000000000000000000000000000002001000000000000300000000000003300000000000000000210600003000030000300000000000003
333333333333333333333003033300333330000000603033333003330000013300000000303306033333303003333303330030001013331000303333330033333133333353300000000003000333330330000003
