000000000000000000000000030000003000030000000000000001000000000000000000000030000000000000000001000010000000000000010030000000000010000000000000000000000000000000000000
000000000000000000000000000000000000000000300000000000006000000002004000000000000000000000010000000000000000000000000000000100000000102000000000000000000005100000000000
000000000000000000000000000005300000004000000000300000000004500000000000000000000000000000000000000000003000000000000000004001003000000030000000000001000000000000000001
000000000000000000000000000000000000050000000000000200000000000050000000000000000000000005000000000100000000000000060000000000000000300000000000000000000010020000600000
000000000000000000000000000000000010000004000000000000200003000010000000010030000000010000000000000100000000301000000000000000000000000000030000000010300000000000000500
010000044444000000000000000000000000300004000200040444000000000000000000000000000000005000000000004444400020200003033000000010000035000000000100000000000000200004404000
000000000000000000000000000000000003330333330333000000000330003030001030333330013100000000033303300006000003330300000003030330313333300003000000030006000033333330003030
000000000000000000000000000010605000000000000000300000100000000000300006100000000001000100040003010000600100000000000000000000000000000003100000000000000000000000000300
000000000000000000000000000000100000000000300000000000000100000000000440010100000000000000000010000000000000006000100000100000000000000000000000000000000030000100000000
000000000044000000000000000003000000000003000000000000000000000001000000000000001000000440000001300000003000000001003000000000000000000000000010005004000000004000000000
000000000000000000000000000000000010000000000000001100000000000030000000040000000003000000000000000000000010000100000000000000000000000000000000000100100000000610000000
000000000000000000000000000000000004010000000000050010006030000500000000000000500000000000000100000000000000000000100100020100101000000001000000000000000000030000000301
000225000000000202000002000000200030100003000000500020500000000441441000023000200000000000000000000002255010000044440000020000020200030000000006250020200000000000000000
333333333303333333333333333303333030000000000000030303330000000000300030333033333303033133300000063303333000000000000003333330333333100100003330333031333303003300100000
