000000000000000000000000000000000000000002000000000000400000000000030100000000000000000500000000000000000000000000000030000000000000000500000000000000000000000000000000
000000000000000000000000000000000030300000000000000000000000000010000000000000003003000000140300350300000000000000010000010000000000000003020100006000000000000000000000
000000000000000000000000111100400100000366000000000000000000130000000300000000000000000000000000005000000111010003001000000000000000000000161110100000112100051110000000
000000000000000000000000100100030002000066000000003000000000100000000000000000000000000300000000000000000011100000110000000046300000001100600101001063100550000000000000
000000000000000000000001110103300000000006000000010000000000002333300005000000000000000300030000003100000001100005010000000000000000000000660011000001010000000000000000
000000000000000000001111111100300020000006000000100000000020000033010230000001000005030300200000010000000221000020110000000000000000000010660211000001110100000200000000
000100000000000000000000000033333313330333000100000000003330030330333300000000005000333331300000000006000333333330330330000000010150033300330303303000000033001110001000
000000000000000000000000000000000300000030000000000000000001001000000000001000000001000000000000003000040000000000000000000000000000000000002000000000000000000000000000
000000000000020000000000000003003600000000000000000000300000002000000000000000000000000000000000000000000000000300000004006000000005000000000000000006001001000000000012
000000000000660000111111110000001111101000000111000000000000066000000010011000001011000000000000061001011000011000000301060000000111100001110000000000000010000000000066
000300000000660000000011100000000000001000000100100300000000060000000001100010001001003000000000660001001000000000000000003500000100110010000003000003600000000000000006
033300000000660000000001100000000000001000005110100100000010060000000000110000010101000000300040660011101010300000001000313000001110100001000100000000600000000000000066
033300200000660000020221100000000202211000111101100000100000066010030020110001006101011000003000601110011000001000060010030000110101106000200000001033300200050000010006
333333333303333330333333333331303333333033000000000060030330033003000033330320000000030100033003330000000033033300000003003033000300030303100000000330333300000003030033
