000000000000000000000000000000330000300100000000000000000000000000000000000330000000000000000000000030000100000000000300000000000000030000000000000000001000000000000000
000000000003000000000000000300000100000000000000000200000000000000000000000600000000000000000000000000000000100000050200000015000030030000600000300000000000000000000100
000000000000000000000000000000010003000000000000010000000000000300000000003330000100300000100000000000000300000000000000030000000000000006000000003000300000000003030000
000000000000000000000000000000003000000000000000000000000000000000000000000010000000001000000000600003000000110000000000000000000001000002000300100000000000000000000000
000000000000000000000000000000000000000000000000000000000401005000000000000010000000000000000000000000000000000200000000000100100000000010003000005000000100000000000100
335003000000005000000000000003304000000003335003000000005000060001000303000000330000330003003300005000000000000300000000000000100000003300030000000000030603300000001003
000000000000000000000000000000300000000000300000000000000000000000000000030000030000000001000300000003010000000500033330000000000000005306000000000000333300300000000000
000000000000000000033000000000000330035000000200000001000000000000000000000000000000000000000010100000033000000000000003010000000000000000300300000030000000000000000033
000000000000003000000000002030000001000003001000000100000000103003000001003000000120000001000003203000000020000330000000300010000001000000000000000000000001000033000000
300000000000000000333000000000003330000000000000000000000000000010000000610000000000000000000001000000333000000040300300000000300000001003300000000000000000100000000303
000000000000000000000000000000000000001300000000000000000000003500000000000000000000000000000000000000000001100000000000000000000000000000000000000000000000000000000000
000000000000000000000000000000000000002000000010000000000000000000000000000000000000001000100001000000000000000000000000000000000000000000000000000000000000000000001000
000000303300000000000000300000001000000000000300050000000000000035000040020200003000000000000000000000000000000050000003350030000300300030103350030000000000010000010016
000000000300000000000000333300000000000000000333000000000000000003000003000000000333000000000603330030000000000000000000000000000000000000002000003330000000003060000000
