000000000000000000000000000000000060000000000000000000000000000000000000000000000000000000000000000000000000100000000003000600003000000000100000000500000000000000000000
000000000000000000000000000000000000000000100010000030000100000100000030000000000000000030010030000000001003200000000001000000000000010000000000000000000000000400050000
000000000000000000000000000000000100200010000000000000000000000030000000000001000000000000000000000000030000000000000000000000000000000000000010000000000000000000000000
000000000000000000000000000000000000000000000000000000000000000100000000050000000000500001100000000000001000000000530000000000000011000000000020010000000000000000000000
000000000000000000000000000000100000000000000000000000000000000000000000000000003100000000000000000000000000000000001000006000000000030010000001000000000000000000000000
000000000000000000000000000000300213000000000000000000000300000000000000000002042010201001200000000000000000002000000200000001204200300000000000300013000000010002022002
000000000000000000000000000003303305303330333330300000010000000001000033333303303330333033300000300000003030033330333030000000330303301030000000000003330300000003303033
000000000000000000000000000000000000010000000000000300100000000000010000000000000000000000000000000000000100000000000000301000001000000000000000400000000000010100000001
000000000000000000000000000000000000003000000000000000000000000000000000000100000001600000000000030000000000000000000000000000000000000000000500000100000000000000350000
000000000000000000000000000000000000000020000000000010000000000000000000000000001000000000000000000000000000003000000000000000000000000030000000000000006000000001000000
000000000000000000000000000001000000000000000003000000000000000000000300000000000000000000000100003000000000000000000000000000000000000000000000000000000000003000003000
000000000000000000000000000000000000000000000000003000000000000000000000000000000013000000001000000000000000000030000315000000000001000000000000000000000000000000300000
000000020220020000020000002000000002322002000001000001000000000000010000000200000020000002000600000001000000000000000000000000000000000000200000000000002000000000100000
333333333333333333333333333300000003333303000000600000006000000000000030030333033033303333000000000000000333330100330330000000000200033013330333333303333300000300300006
