000000000000000000000000000000000000000000100000000000000000200003000000005500000001001053000000000000000000030000000000000000000000000005500000000000000000000020000050
000000000000000000000000000000000000003030000050011100000001000000000000000000201111000000000000000000000003000000011100010050040000000100000001000000111100000006000000
000000000000000000000000000000000140010000300300110060000000100000000010110000000010101131000000340000000000000000006000000010000100010310100100010000000000003140011110
000000000000000000000000000000000000000000000000310001003010000000001000000000040000000000000000000000000010010000000000000000000000000000000000000000000000000000000600
000000000000000000000000000000000000000000000000000004000000000000600000000000000003030000000000500130000000600500300000000000020000000000000300000000000300000000000000
040001414100000000000000000000310000000000100000000100001413010000000000010000000000000030000000000000000000000000100000400014000000000000000000000000600000010001000000
000000000000000000000000000030330330000050000000013333300100300001000030333330333330303033333033331000000000001000633030000000000001034303330000000333333013333335333330
000000000005500000000000000000000000000000000000000000500010000000000000000000000000100000100000000000000000000200000000200330000000000002000000103000060000000000000000
000000000000000001111111000000000000000000000011100000000000000110000000000000000000001000000000003110005002001000000000000000111000000000000003000000006030000001010000
000001410111100000000000000000010000000000000000010111100003000000000000030000000010000000300001000000000000000000000140000000001000000000500000000000000000001000001000
000000000000000000000000000001000000000000000000010000030000000000000000000000001000000000001000000000000000000000500000000100000000000050000000000000000300301000000201
000000000000000000000000000000006000000000000000000000000000000000000000000000000000006000000000000000000000000000300000100003000000000000000000000100000500000100000000
000000000000000000000000000014000140000000000000000000000400010300000000000000003500000000410100000000010100000000000001410000000000000000001400000000000000000140000000
333333333333333333330333333301100100000010333313033333430000030132303300000033330030000000000000003330003003313030333000000000333330300000000000000000010000000003330033
