000000000000000000000000000000000000000001000000000000060020000100000000000000000000000000000000000000000000000000000000000000000000010000000000000003000000000000000000
000000000000000000000000000000000300100000000000000000001000000000000010000000000000000000000000300300001000000010010060000000000000010000000100000000000000000000000000
000000000000000000000000000000000000000000001000300000000000300000000000000003030000030001000050005000000600000000000040000000000000000000000000000000000000000003003000
000000002000000000000000000000001300000003000000000000000000000100003000000003000000300000306000500000000000030000000000000110000030002000000000000000103000000000000000
000000003333000000000000000003000100000500050330000010000010000000103000000000003000000010000000300000000000000000000000000030000003003333010000000000003303333000000001
000000000000000000000000000000000100000300003000000000000000000030003000000000000000000000000000300000001000000500022020000030000004000000004000000000003000030000000000
000000000000000000000000000003303330000500000000003100000000000333313033363330000000330333133330130000000000000003303300353333333030600000000000000330335300001003333033
000000000000000000000000000030000000000000000000000000000000000000000000000000300000000300030000000000000000000000005000000013000000000000000000000000000000003300000000
000000000000000000000000000003000001200000300000000000000000000060000000000000000000000060000000006000000000000000000000000000000000000000000000000000000000004000000010
000000000000000000000000000000403000000003000000000000000000000000000000000000000001000000000000000000000000000000000000000000000000000000000000000000000000000300000000
000000000000000000030000003000000000000000000000000010600000000300000002000000000030000000002000000000000000030000050003000000000013000100000000030005000000000000010000
000000000000000000030000003000000000000000000000000000000000001000000006333000006030000000000033000000030100000010000000010000010003000000000000002000000000000100000000
000000000022020000030000003000000000002002000000000000000002200100001000200200000030001220200000000000030000000100000000100000000003000010000000030000050000022520000000
333333333333333333333333333333333330033333603033300000003033303000000300000003033323333303300000000333330000000000000030000000103333300000000301033000000003333330030000
