000000000000300000000000000000000000000030001000000030000100030000000000000000000000000003100000000600000000000000000301000000006000000000000000030000000350000000300000
000000000000000000000000000000000400200000000003000000000000000000000000000000200001000040000000000000000000001000000100000000010002000400100000000030000000000001000115
000000000000000000000000000000103006600000306110000000000100000000000000000000600000000000010000000000000000000100000000000060030000000000000000000301000000000000300000
000000000000000000000000000000000306000050000000000000000000000000000005000006600000000000030002000000000000500001000005000000000000000100001000010000000003000000000005
000000000000000000000000000000030000600000000100000000000000400000000000000006600000000001000000000010000000000000000000000000000000000000000100000000400000000000000000
114444404000000000000001100000050020630000000000000010003400000010044000000316600000000000100000000001000030000004000000006002014444400000050400000000000000000021131044
000000000000000000000000000033333333303313030333000000001000000000000033333333133330030033300000000300000333333000003000033333000030100000000000000330300403033300030110
000000000000000000000000000030010001000001000000000000000000000000000000000000000000000000000000301000010000000000300000000050000000000000000000000010000000000000000000
000002000000000200000000000000000000000000000000000030000000000000000004000000000100003000000002000003000000000000300200214005000001300000000000000000000000000000000002
331110000000006600000000000000000000000010000000006000000000000000100033111000001001311100000000000000010660000033001006600000030000000000100000000000010063000100000300
000000000000006600000000000000000000000500001000000000000000000030000010000000000600000004000000000000000660000000000006600000000000000000000000000000000066000000000000
000000000000006600000000000000000006000010000003000000001300000000033000000000000000000000100000000000000660000000000006601000000000000000000000000301000060000000300500
000000000000006600000000000200000000400010001100031444040000010001100000000000100002000000001000001144344000010000000006601010000000000110006010000001100016000000300000
333333333333333333333333333333033330500010000001000000000000000000000033103333333033333333000000000000001033033333333333333333333033304000000000000000600033333333030335
