000000000000000000000000000030000000000000100000100000000000000003000010000001000000000000100600000000010030000000001000000000000000000000000000010001000301000000100000
000000000000000000000000000000000000000000002010000600000000000000000000200000000000006000002000000020020000020000000000100000000000002000000001000000000000000003000000
000000000000000000000000000000000000310000000010001111100000000000100000051100600430011000060000000011000000060000000000110000011111003100000000000660500010000010000000
000000000000000000000000000000000000000000203200000000000000000000000000000000100002000004500000020000053000000100000000000000000000066000022110000061030200000000000000
000000000000000000000000000000000000000000000000300300000000000000000000010006600000000000050000000000000000000000600500000000000000060000000000000664000000000500000000
000000000000000001100000000000000000001104003000000000000000000000110300000006604000000300066000000003303000000000000000003000001000060000006000006060000000150000001100
000000000000000000000000000000000000001000333033353333330001060000000033333333333334333333043000333333333000000000000003003333030133033330333333033030303300000300051000
000000000000000000000000000000010000060000000000200300600000060000000000000000010200000000000010000100000000000000010000000000003000000000000100000000000030000000000000
002000000000000200000000000002000000000000005000000000000000000000000000000000003000000000000000000010000000000000000000000030000000000010000000000000000000230000010000
011111001100006600000000000060000000000100000000001100000110000000000000000000000000300000000000000000000000000000000000000003000030000000100000000000000000115103131000
000000000000006600002200200066000000000033301030003000000000000000000520000000000000000100000000002002000000000000000000000000200200000000000000000000000010000000000000
000000000000006600000000000306000600000002000000000000030000000030000300000030000000000000001000000000003000000000000300000000000100000000031000000000000000000000300000
000000000030006600000000000666000000000000001000000000000003000000000000000060000000000110300000000000006000000000010000000010000000301010000000000000000000000000003000
333333333333333333333333333303000310000000000000003335333033303000000063110330000000000000000000003030303000000000000000000000133333003000000000000000000033033330333333
