000000000000000000000000000000000000000000000010000000000000003000000000000000100000000000000000000000000100010000000000000000000000100060000000010000001000006001000000
000000000000000000000000000000000400300000000000000000000200600000000000000010000000120000000000000000000000000600000300100000000100000003010000030000000002000060000001
000000000000000000000000000000000000000005000000000000000100000000000000000001000000003000005500000000000405000000002050000000400000000000100000000000000000003000000000
000000000000000000000000000000000000000000000000000060003200000300000000000000000000020000000000000000000000000000060000000000000000000000000000000003000500000000000000
000000000000000000000000000000000000005000000000000006006600030103000300000000000000000400000000000100000000000000666003000000030000000003000100000300000001000000000000
000000000000000000000000000000000000000000000000000066036600000000000000000000000000660000000000030000000000030000020000003000030020000001000000000000000066100000000000
000000000000055000000000000000000050001300500000003033033333030333033000000000000000330333000100005000000313063333001333331000331330102000003333303500003033033300000000
000000000000000000000000000003000005000000000000000000000300000000000000000000000100400000000000000001000000000000000001000000000000000030010000000000000100003000000000
000000000000000000000020000000000000000000000000000000000000000005000030000000060000000000000600000000000000000010300000000000020030000000000000000005000000000020000000
400000000002000000000000000000000000000000400000000000400000000000020000000006010000000000000000000000000010000000000000000300000101000000000000000400004000002010003000
000000000066000000000020000000000000230001000030000000000000000000660000000000000300000000000000000006600000000000005030000000020000000003000000000000001000066000000000
000000000066000000000660000000000006000040000300000000000000001000160000100000000000000300000000000006600000000000000300000000060000600600000000000300000000066000000000
000020000066000000000660000000000106600000020020000000000000010000600000000010000200000000000000000106600000000010000000000000660000000000000000000000000000066000300000
333333333333333333333333333000000001033330033333333333330000010330333350000003030333333303300000053330330030000000000010000000333333000000030000005333033030330330000000
