000000000000000000000000000000000000000000300000000000000000000000000000000000000003000000001000000001000000100000000310100000000000000000000000000000100400000000000000
000000000000000000000000000001000000000000000000000000000000000000000000000000000000000000100000000000000000000000000000000103000000000000032000000000000006000000000002
000000000000000000000000000000000000000000000000000000000000100010000000000000001000000003300000001000100000000000000000000003000000030033303003030001000000000000000040
000000000000000000000000000000003000000000006033000000030000000000001000000000000000000033000010000000000000000000000000000000000000000000000000000000000000000000000000
000000000555000000000550000000000000000000000000000050000050500550101000000000000000000000000000050000000305550000055001000000000003000000000000000300600055050000000005
000000003333300000000333000300000000300000030000013033000333330333000000000000000000030000000000100000000033033000000000100000000000000000100000000000000000300030000300
000000000000000000000000000001203330000000500000000000000003000000000033333330000000300010033330030000000060000000000000300000300000000040000000000000000000000003333336
000000000000000000000000000001000000000300100000000300000010000000103000000000000100000000060000000000010030010000000100000000000000006500010030000000110000000000030000
000000000000000000000000000000000000000000000000000000000000030100000000000000000000000000000000000000003000000000000003100001000000000000000100000000000010000003000000
000003330033300000000000000030006303000004010000000000000000000300330600010030000333000100000100000003330000010000000000000000000010000003000000033000000000010003000000
000033000000000000000000000000100000000000030640100000001000000000000000000030000030000000000000000000100000000000000300000000000000050000000000330000000301000000023003
000000000000000000000000000000000000000000000000000010000000000000000000030000000000000000030000000000001010000005000000000000001000600000000000000000000000550000000000
030000000000000000000000000010000000036000000000003300030000000000000001000001300000000000000000000000000333000033300030000600000000000000000301000000010500333300000000
330000000000003333333333333300000003303303000000010000000000000100000030333303000000000100000013331300000000000000020000433033333333300000003300000300030000000000303333
