300000000000000000000000000003000000000000000000000000000000000000000000000000000005000000000100000000000000000000026300000006003000010000000000000000000000000300000000
300000030003300330000000003000000300030000000030003000000000000300003000000000000000000001030103300030000000000000000000330000600000000000000000000000000000001000010000
000000000000000000000000000000111000000001000000000060000000001000000000000000006600300003000000000000000000660000000030010000000000000063000006600010000030000406000000
000000000000000000000000000000000300000032000000000066000000000000000000000000000300030000000100000000000000661000030000000000000000000006000056300003000000000000000000
000000000000000000000000000000000000000000100000000036000000000050000500000000000600000000000000000001000000060000010000000000000000000060000000600000000000000000500000
000000000000000000000000000000000000000000000000000066000003000030000000000000106600010003000001000000000000660000001030000000300000000006000006600001000030000000301000
000000000000055000000000000001000000000001000000033333303333333000000531333333331333330333300000050060000313330303030305003600330333033333333300033333331303333330003333
000000000000000000000000000001000000000000330000000000000005000003002030060000000000000000000006000000001000100000000000000000300000006000000000000000013000030000000000
000000000000000000000000000000000000000300000000000000000330000000000030000000000010035100000001003000030001000030003300000000300000000000000005030030000000100003000300
000000000066000000001300004030000400001001000000600000011001000300003000000000300100010000000000010100000000000000030003030040003033001000000300000400000000000001000000
000000000066000000000030000000000000060000000000000000010000000000000030000000300000001000005000300000000000000000010000300000000000000000000000000000000000000010000000
000000000066000000000000000000000000000000000000003000000000000000000010000000006000000000400600100000000000300000000000000000000000030000000000000000000000000000000003
000000000066000000000000000000010000000001000000001000100003000000000000000000000000000000000000030000000010000000000000500000000000000000000000000000040000000000000000
333333333333333333333333333330333333033303000000030333330000410000331300000000000000500000000333300000000003333300001003330303000000400000000000000500000000305000000005
