300000000000000000000000303306033000100000000003330010000000000000000000010000001000053000000000003000000300000000000000303300000000000000000300000000000000010000003031
000000000000000000000000003000000002000000000003000000003000000000000000000300000000000000200003000000000500000000000006000010000002000003000000000000000003000000000030
000000000000000000000000000030000010500000000001000000000000000000000300000004000100000005000000030000000000000000000003300000000000040301000000000006000030600330000000
000000000000000000000000000010000000001100000005002000000000000000000001000000000000000000001000000000000000000001005020000000000000003050003000020003000000000030000000
000000000000000000000000055500000000010050010055500010000000000030000000000000000000000000000000000000100000000000000000000000000000000000000000000000000000000000000555
030000003333000000202533033300000000000202530030603000000300000303100000000000000205000000033330000003202030000000004000000000050000003030000033300030000000000000330333
000000000000000000003333300000000100000000300300020000000600000000000000000000000100000000000000000000003000000000000000000000000000000000000000001010000000000003133100
000000000000000003300000000000060000000010000000000000000001300000003300000000000000000000000030330000000010030000050003000000000000000030531000301100000000000000000000
000030000000000000000000000000000000300000000030100000000000000500003000000000000000000600000000300000000000000030000000000000000500000000300001000000000000000000010300
000000330000333300000000000000000000000010000000330300333100100000010000300003000005000003360000000000000330000000000000000000000003000300003300003000000000040000000000
000000000000000000000000000000000000000000000000000001000000000000000000001000000010000000000030020000020000001000000000000000300060000000000600003000003000000003000000
000000000000000000000000000000000000000000000002000001000000000000005504000000000000000300000005030000000000000000060000000000000000000005050000100000000100100000003016
333300000000000000000000000000000000333300003300000000000000000533030303500000000100001003000303030303000000000000002020300600000000050003330000000000020003333000000000
000000000000000000000000000000000000001000000130001000000000000333300000000000300000000000330333000000000030000000000030000000000000033310000000300000000300000000000001
