000000000000000000000000000000030000300500000000000000000000000000010100000000000000000000000000000000000000000000000000000000000000000000000000000000000020000000000000
000000000000000000000000000000000000000000550000000000000004000000000005000000000000130000000001050000000000000000100000000000000000000200050000000000030000000000003000
000000000000000000000000000001000001111010000400000000001000001000000000000000000004100000032000000000000000000010000000000010000001400010000200000030000000000140000000
000000000000000000000000000000000000000000010000000060000000000000300000010000000000000000006000000000000000000000000000000000000000060000006600000000000001000000000000
000000000000000000000000000000000000000030030000100030000000310000000000060000060000000000006000000000000000000000000000000000000005000000000600000000000000000000000000
041004414110000000000000000004010010011000200000004101000000000041004000000000000000000000066000000000030101030004010040001000000000000060010600000000000000000300401000
000000000000000000000000000000000006003333033353300000000000000000000030333330303360030630003306330000000000000010000000000000303033313050033333330000000333333330000000
000000000005000000000000000000000000000000000000000000030000000000000000010000000000000051000000000000000000000000010000000000000000000000030000001000050000000000000000
000000000000000000005550000003000100001000000000000000050000005100100000000000000000000000050031000110000000001100000003500000000030000000000000030000005003003000500000
000001411111100200000000000030000000000114000000302000000100000000000000000001301110010101000000004000034002000110411100000000000000001000000000000111031000000000000000
000000000000006600000000000000000000000000001000066000006600000000000000000060100000000000101000200000000030000000000000033100000000103000000000000000000000000006000000
000000000000006600000000000000000000003000100000066300006600300000100000600000000000400000000000000000000060000000000300000000000040001000000000006000000000001000000000
000000000000006600000200000000000000000000300000366300006600001000000014103000000000000000020000000000000040004400000002000100100001004010000500000000000004400042000000
333333333333333333333333333300000003333333000000000303033301333000010000000003333033333333333333033303333000003003350333330333050000000003003000000300333300001033330333
