000000000000000000000000000000000000000000000000000000001000000000000001000000050300000000000000060033060000000000005000000003000000000000400600300000000000300000000000
000000000000000000000000000300000000000000000000000000030000000000000000000000000000000002000000000006003000300001300000000020000000000000030000000000000000010330600000
000000000000000005000000000030300000000331010000300000000300001000000000000000030033333000000000330000020000100000050000330000300003300050000030000000000000000000000000
000020000000000000003000000030050000005000000010010000004300200000000000000000010333000000000003300243000050000000001030000000000030300030000000003300020010000430000000
000002000000000000000000000000000000000000000002006100000000000000000000003300003330000006000003330000000000000000000000000000003003000105001001000000002000100000000330
333333333300005000001110000000300100001000300333300000000330330333000000030000033333000000000301331100000333000050000000000000003330311000003330000033303301100000000000
000000000000000000000000000000000330010000000000000000010000000000000000000000060313000003300000130000000000000000000000000003000333000000000003000000000300000000300000
000000000000000000000000000000000000000000000010000000000300000000000000000000000000000000010000000001000000000300000000001000600000000000000300000000000001000000000000
000002000000000000000000000000000000020000000000000000000020000000000000000200000003030000000000003000000000000000000000300500000100000000000000000001002000000000000030
333000000000000000333300003303000000000500010500100000330005000000030330300030006000000000000003330100000000500000000010000000000000010003040300303030000000050003000033
000000000000000000000000033300000000000000000000300003300000003050000000010000100000000000000000000000201000100300000000000040000000000000000000000000000000000030000331
000000000033300000000000333301000000003030100000000033330001000000000000030000000000030303000000003000000000300010000200203030000000000000000010000000000000000000003301
000000000000000000000003333330300000000000000000100333035000001000000000000031100010000000000000003303333000005003333300600000333050000000040000000300000003000030003330
000003333000000000000000333300003003300000000000000033331000000000000000000130000000330005300000000001000000000000000003103000000000000000000000000000003300000055000331
