000000000000000000000000000000000100000000000000000000000000000000010030000000030000010000000000000000000000000000000004003003000000030000000010000000000500000000003000
000000000000000000000000000000000000000000000000000000000505000000000003000300000000000000300000000000100000000000003304000000000000000550000000000000010000000000000000
000000000000000000000000000000000000300000000000030003600000003000000000000000000003100000000000000000000000000000000000000060000000000000000000500000000000010000015000
000000000000000000000000000000000000100000000000030000000000000000000000000000201000000000000030100000100000000000000000000000000000000000100000000000401000000000001000
000000000000000000000000000000000000000000000010000000000000000500100003000020000000000300100050000000000010030000000000000600000010000000000000660000000000000000000000
000000000000000000000000000000000030000000000000000000000100000000000000000400000000000000000006662010000030000000000000001000300000000060000000066213000000030000000001
000000000000000000000000000033203330000030000000030306300300033003000130003300000000310033303331333033030010030000000000500000100000000000043300033003003500000330000000
000000000000000000000000000000000000000000000000060000000000000003000000000000000000000000000000000000010030000000000001000010000000000000500003300010000000010000000000
000000000000000555000000000000550000000000000000000000000000000000000000300000000000015560003000000000000003060110000000000000000000000000000000000000000000000000001000
000000000000000000000000000000000000001000000500000000001000000000000000000000000000000000000000000000000000000000000000000000300000000000000000000000000000000000000050
000000000000000000000000002000000000010000000002000000000000010000002003060000000020000000000000000000000000000000000000000000000100000001200000000010000000000000000000
000000000000000000000000066000010003000300000066000000003000000000000000600000000660000000000000100000000000030000000000000000000000000006000000000000000000000000000000
000000020000000000000000066600000000000000000066000000000300000020000000000000000066000000000000003000000000030000600002003000000000060000160000000000000005000000000000
333333333333300000033333333300010530003000313333000000000000001133330000000103130033000003300000000000000000100033333363031100000000030316330000000000200033130330000000
