000000000000000000000000000000000000100014000000000000000000300000000000000000000000000300000030000000000000000000000000000000001000000000000000000000000000000002000003
000000000000000000000000000000000006000006000000000020000300000000000000000000000000000003000000000000000000000001000000000000000000000000000000000000000000000000506000
000000000000000000000000000000000000003001000000000510000000000000000000000000000300000000000000000000000040000000000000000001000000000000000000010002030000000000000000
000000002000200000000000000002000000000000000000000000000200020003000100000000000000000000050001200000300020000000010000500000000010300000200000020020000300100000000000
000000003333330000000000000001333330000000000000000000001333233000000100000000000000000000000000000000000000330330000000000000000000000000000000000031333300000000000000
000000000000000000000000000000000000000000000000000000000000000000020000000000000010000000000000100100000000000100030000000000000060303000000000000000100020100000000000
000000000000000000000000000000000000000000300000033330000000060333103333003330000000333300030333330000004000030000000003303000300000033033033033330000000033330000000030
000000000000000000000000000000000000000000000300000100000000000005000001030000000000000001010000101000000000000000000000000000000000001000000000061005000000000630000000
000000000000000000000000000000005000000000000000000000100000001000000000000000000000000303000000000000000010030010000000000003000000000000000000006000000000000000000000
000000000000000000000000000000000000000000000000000000100000000000000000000000000030004000000000000000000000000000000000050000000000006000000100000000000000000000000000
000000000000000000000000002000000200000000000000000000600000000000000000000000000000000001000000100001000010010000000010000000000000100000200000130000100100003000000000
000000000000000000000000000000050000000000000001000000000050000000000000000000000000000400000000000000000000000000000000000000000001003303330000000060000000000010000000
000000000000020020200000000000000010000000010000300202000000004000000000003000050002002020060000020006000000000000000020000000000000000000000604000000000200002000000000
333300033333333333333333333333303330000000333630335303330000000333000000000001333033333303303030033000000300000000330333333303000010000030000000000003503331100330100000
