000000000000000000000000000000000000000000000000000100000000500000060000600000000000000000000002000400000000000000000000000000000100000000100000000000001000000300000000
000000000000000000000000000000000000000000000000000000100000200005000000001000500000000000000003000000000000001000000000000000000000000002000000000000000010000000000000
000000000000000000000000000003166100000016006600000000000006303000000001000000000330000000000300030000000000030000001000000003000000000016000006600000030000000000063000
000000000000000000000000000000066000000000000600000000000006000000001000000300000000000000000000000000001000000000000000010000000000001006030000600000030000000000066000
000000000000000000000000000000000000000000206603000000000006600000000000000100000003000000000000000000000100000000000000000030000000000066030000600000000000000001066003
000000000000000000000000000000060000000100006600003000003000600000000000000000000030000000000300000000000050000000050000000000000000000566002000600060000000000000066000
000000000000000000000000000003330300060000333033000000003333000000050003360003006000000000033030000000000000000001000000300030000000003333333330030000000033000333003033
000000000000000000000000000000000000000300000000000000000000000000000000000000000010100000000001030010030000000000000000000100000000000000000001300010000100000000000000
000020000000000000000000000000000000000000300006000000000000000300000000000000000000000000000002000000100000000300000000000000000000000000000010000000000000004000000000
000660000000000066000000000300000030000001000010000000000100000000000000000000036000000000000066000036000000000000000050066003000000000300000000003006000030000300000003
000660000000000066000000000000000000000000000001001006000000000000000000300000066000000500000066000066000000000000003000006000000010030000000000000000000000000000000000
000660000000000066000000000000000000000030000000050000000060000500000000000300066000000000100066000060000000000000000000066000000010000300000000000000000000000000000000
200660000000000066000000000000303000000000000000000500000100000130000000000000066000200000000060100036000000000000000000016000000000003000000000000000000000000030000100
333333333333333333333330000033000003000000100030003033333333333001000000000003333333333003335333313033333000000033030330333303000000000000003300000000000000000000000000
