300000000000000000000000000010030000003000000000030000003000000000000000000000010003000000000000000000000000300000300000000000000000000000001000100000000000300000000003
000000000000000000000000000000000000000000020000000000000000000000000000200000000000600000000000000003006000001030000000000000000605000100000000000000000002000000000000
000000000000000000000000000000000000000101600000000001003010000000000001111100000000000000000000100010000300000000050000000003001000000000000010001000000060000000000000
000000000000000000000000000000000000000000600000000000000000010000000000000000000000000000000000000000000000000000000000000000300000030000005000000000000066000000011005
000000000000000000000000000001000000300000663000000000150000000003000000000000000000000100000000100000000000000000010000001600000400000000000000000000000006003000000000
004444410000000000000000000000000000000100600000000000000000000000000000000000500000100030000444240300000000000000000000000000000000000003000000000000000066000000003000
000000000000000000000000000000000000010333300333300000003000330100000133301330000000010004000000003000333010000100600503333030300000300000003003333000001003330003333300
000000000000000000000000000030300000001000000000000000000000000300000000000000003000000000000000000001003000004000000003000000000000000000000000000003000000000001000000
002000000000000200000000000000000000010010000000000000000200000001000000000000000000000000000203005000000020000100201000000000003000002000000000000132000000030000133000
011111000100006600000000000000000010111110100000000100006600000000000000000000000001000000003010100230000660000001011100000000030000110010001000500001111000000000300000
000000000000006600000000000000030000000000000200000000000600300000000000000000000302000000000000000300000600000060000000000000000000066000000000000000000000000000000100
000000000000006600000000000000000000000000000000000000006610000000000000033000000000000000000000004000000300000000000000000000000000030000000000000000000000000500000030
200000000000006600000000000000444402000000060000000000006600000004444010000000002000002000020100000000000660000020000000044403100300066001000000000200000030000030040440
333333330033333333333333333000000503033033301333310000003030130000000000001003033300330310003333330000000363333331030330000000110006033333330000000333033000000000000000
