000000000000000000000000000000000000000030000000000030000003000100000000000000001100000000000000000003000000000300000030000000100003000000000000000000002000000000000500
000000000000000000000000000003000000000030001000000000000000000000000000300000060000030010000000006000000000000000000100000000000000030000010010000000000030000100000000
000000000000000000000000000000003000001400000000001000000000000000010000000000000000000000000050000000000000140000000000000000000100000000060001000300610000000000000100
000000000000000000000000000000000000000000004000003020000000030300000000000000000000000001010000000000000000050050000000000000000000000030000000000000000000000303001000
000000000000000000000000000050000006000000100300000660000000000000000000000000000000000000000000000000600600000000003000000000300000050060000000100600000000000000001000
000000000010000000000000000000000006032000000000000660000000000000000000000000300003000000000003200000000010200000010000000100000000000000000300000600200000000300010000
000000000000000000000002000000000003333033002000033033330600000000000000000000020031006010033030330001000333333300001000020000333333300000003303330333333000000006300000
000000000000000000000003333000000000000000000000000300310000000000000000033300000000000000000003000300000000000005000000003330010000000000000010000003333000000000000000
000000000000000000000000000000010000000000000000000000000000000000000000016000002000000000000000000001000000001000000303000000000003000000000000000000000000000000000000
000140000010000000000000000000010200000000000300000000000001000000110000030000000000003000000000000000000500000000000000000000000000000014000000000003003003000000000000
000000000000000002000000000000000000030000000000000000000000000000000000000000054000000200000060000000100000000000000000000000000200000000000000000000050000030003000000
600000000000000066000000000000300000000300300000000600000000000000000000300000000000006600000000000003000050001130000000000000006600060000000000100000000000600000000000
600200000002200066000000000000030200001000000000000000000000023630300000000000366000006600000000006000100000030330000000000000006600000000300000000300000000660000000000
333333333333333333333300000033313000000001500060030000003330303303333330000003303330033303000000030000000000000000030003000000310003333333336000000000100030333350000000
