300000000000000000000000000030100000000000000000001000100003000000000011000000030000000000010300000000000000000000000000000000000000000000600000000000000000000000000000
000000000000000000000000000000000000000000010000000000000100000003000000000000000000000000000000000010000000000000000000000000000000000000001001000000000000000000003000
111110000000000000000400000011101000000000000000000000001011000000000030000000000000000330000010000031000000000000001500000000000000040000000001000300300000001300111000
000000000000000000000000000005000000000000003200050000100000000000000060000000000000000000000000030000000300000000000030000000000200000000000000000000000000000050000000
000000000000000000000000000000100000000000006300000000000000000000010060000000000000000000000030000000000000006000000005000000006600000000000000110000001000000000000001
000000000000000000000000000000001000000000001600503030000000000000000060000000000000000000000000000000000060000000003006000000036600000000000000000600000000000000000000
000000000000000000000000000000000000000000330333000000000000003000000033333333130030000000033300030000000331033133033300000100303330360000103333333033033300000006003000
000000000000000000000003000000100000000000500000300000000000000000030060000000030000000003030100000000100000000000006000000300000000030000000000000000000000000000030006
000000000000000000000000000000001000031000000000000000000000610000010000000031000003000000000000000000000000000003000000000000030000000000003000200600000300000003010010
300000000000000000000000000030000000000006000000000006010000000000100000001000000000300000011110000000003000000030001000000000000000011110000005000400000000000000000000
600000000000000002000000000060000000300000000000000000000000000000003000000000000000600000000000000000000000000060000003000000000000600300000000000001000000020000000000
600000000000000066000000000000000000000000000000000000000000000000000000030000006000000010003025000006000001006060600000000000000110000000000050000000000000650030000000
600000000000000066000000000060000000000001000000000300000010000000000060003000060000600000000060013066000000000000000000000000000000000000000000300000000000660000000000
333333333333333333333333333331333036000000313333333300330000100033330300000103003003003033303000003333333000000030333330004000330033301000000000000000300003333333330031
