000000000000000000000000000000000000000000000000000000000030000000000001000000000000000300000000300000000000030000000000350010000000000000000003600000004000102000000000
000000000000000000000000000000000000000000000000100500010000000000000000000000000000000000000000000000010000000000000000001000000000000000000000000300000001000000000000
000000000000000000000000000000000000004400000005644000000000000300003300044400000000400000044400000000000000000000000004010000000444000000000000000000000000000004400000
000000000000000000000000000000000000000010000000000000001000000000000000000030060000000000000500000000000500000000000000000100000000001000000000000000000300300000000000
000000000000000000000000000000000000001000000000000010000000000600000000000000000000000001000000000000100000000000000063200000000000000000000000060000400000000000300000
111000004444000000000000000000000000000003004440000020010000000044440000000000003000020200000100000040400000000304400000000000000000000006000000000044440001300000002000
000000000000000000000000000003033013333333000000033333303000003600000033330333333030333033303333300000000000000000003000303330330333000000003330330500000000000363030031
000000000000000000000000000000000005001000030000010000000105000000200000000000000000000000000000000000000010001000000000001000000000030010000000000000000000030000050000
000000000000000000000000000000000000000060000000000000000000003006000000000000000000000000000066000000100000030000003000000000000000000300100000000000000000100400000000
444000000044404400000000000044400000100000000000000100000000000440010004000000000000000000000000000000000000444000000000000002000005030000000044140444000000000000000000
000000000000000000000000000000000000001000000000001000000003000000000000000000000000000032100000000000000000000000000000000060003000000000000000000000000000000000000000
000000000000000000000000000000020030030000000002000000000300000000003000000000000001000000000400000000000300100000000000000020000001000000030000000100100000000100000000
000000000000000202000000000000000000000000101000000000000000000020200000500001110003000000011101000000000000000001100000242000000020300000000000000000000000000000000000
333333333333333333333333333033333100000000000000003000000000000003303333333330000000033330000000000000000333300300300003033303000000033333003303363300333100000400000000
