000000000000000000000000000010000000000000000000000000000000000000000000000000010300300000000000000003000000000000000000000000000000000000000000000000000000000000000003
000000000000000000000000000000400000000000000500000000000000000000000000000000000000010000100000000000000000030000010003005100000000000000010000000000000000000000000000
000000000000000000000000000000000000050001300000300000000000000000000030400000000000000303005000000500000000000000000200000030000000000000030000000000000000000000000000
000000000000000000000000000000010000000100000000000000000000000000000050000000000000000000030000000000000000010031000000000000010006000000002000000000000100000020000000
000000000000000000000000000000000000000000000000000000000000000000000000100000000000000000000000000000300000000100000000000000000100000000300000004000000000030000000030
000000000000000000000000000000000000001003000000600000000010000000000000000000000000000000000000000000000000210200100000000000000000303003030000000000010000000000022000
000000000000000000000000000030333330020000333333300000000303130000000000001000060000000000000000003000000333333300000003033333033333333330031000000000000000000000000000
000000000000000000000000000000000000003003000000000000000300001000000000000000000000000000100000000000003000000000000000000000000000000000000030100000000000000000000000
000000000000000005000000000000000000000000000000000000000005000300000010000001000000000000300000000005000000000000040000030010000000000000000000000000500002000000000000
000000000000000000000000000300001000000000000000000000000000000000000000000000000003000000003000000000000001000300000000000000001000000000000000000000000000000030000000
000000000000000000000000000000000000000000000000000000000000000031003000000000000000000000000000000000000000000000300000000100000000000000000000000000000000000030000000
000000000000000000000000003300000100000003000000000000000000003000000000006000000033000000000000500000000000003300000000000000000000000030000000000000000000000030300000
000000000022020000000000033304000300001303000000000022020010000600001100022020000333001000000010000000000000033330000000000001000200200000030000010000000000003330002102
333333333333333333333333333300030001333333000000033330103330333000000033333300333033333333320000000033003033351300000003000001333033300000003300300333033333333033333330
