000030000000000000000000000001103000000000000000000000000013000000000000000000000000000030000000000000000000000000000000030000000000000000000030100001000000053000000000
000000000000000000000000000001000000000000000000000000000000000300000000000000000000000000000000000000000000000000000000003300000000000000000000000000000000000060006200
000000000000000000000000000000000000010000000000000000000000000000001300000000000011000003000000000003000000054100000100000000030000000000000000000000000000040000000000
000000000000000000000000000000000000000010000000000000040000000000103300000100302000030000000600333000000000000003050000000060000000000003000000000000000000000330000010
000000003330000000000000000000010000000001010000003300300001000000003003030060000000000000003005000000000000000000000000000100000100000000000000040000030100000000000000
000000000000000000000000000000000003300002000000000000000000000000003310000000000002003000000003300013000000050000003000010000103010230000000031000000030000000300000000
000000000000000000550000000002000000000333030000003000010000000333333300000001303303100000003333030000001533331003331130000050033033300000000000001333033330300030000551
000000000000000000000000000000000000004000000000050000000000000000000000000300000000000000000000030500000000060000000000000000000030000000000100000306000000000000000000
000000000000000000000000000000000000000000010000000000000000000001600200000000300000050000000000000000000000000000000000000100600000000000000000000000000000002001000001
000004000000000000000000000013100400300000000000000000010000010000300000300000001000000000000000000000000000000000000400000010000000000000600000040000000000000000000200
000000000000000000000000003310005000000003000003300000000100100000000000000000000000000000000000000000000010000000000000000600000000000000330000010001000000000000000000
000000000000000000300000000000000000000000000000000000000030000000000000000000300300000030010000000000100033300000000034330000003650300000000000006033300000000000000000
000000000000020000300000003000000003000000000003000000000000006000000000000000003300000000000000020030003000000000000001003000000000000000300000100000000000010000000002
333330003333333333333333333333033000004550033313000303030000000000053003303003333033003303303330000000050030000033030000000000000000013053333303300003000000000000003333
