000000000000000000000000000000000000000300000000000100000000000000000000001010000000000000000000000000000100000000031005000000040300000200000000000000000000000000000000
000000000000000000000000000000000000364000000000006000000060000000000003000000000000000350002300000000000000000000000000203000100116000000000000000111111000000000000000
000000000000000000000000000005000000011100300000000000000300000000000000013000000101000000000111300000050000000000000050001500000000000030000300000001000000000000011100
000000000000000000000000000033000000000000000000000030003300000000100000000000000000000000000003100000000000003000000000000000000030000000003000000000000100005100031000
000000000000000000000000000000000050000000130060000000000000000000000100000000000000000000000000000300000000000000000000000000000000000000000000000000030000100000000000
000004410000000000110000000000000000000000000560000000000000300000000100000005000540100000000000000000041000011000000000000000000000000000440000050000000000060000000000
000000000000000000000000000000033333330335333333000000003003333000000030333330000000000000033033330000000000000000100013333333330333310000003000303303333300000003333333
000000000000000000000000000000000000000000000303000000000000000000000000300000060001000000000000000000000000000400000000000000000000000000000000000000003000000000000000
000000002000001111110000000000000001000000501111003000400000103000000031111100000000100000012011100000000000000000030000000000000000000000000000000000000010000000000000
030000000111000000000330000000000010000000000000000000003300000000000000000000000006000005000100000300000630003033000000000000030000000000000001000003001033003020000000
330000000000000000000000000000100000000120010000000000000000000000000001000030000000000030000000000000010330000000000000000050330001300300000000000000130000000000000000
000000000000000000000000066000000010000003000000000000000000660000000000030011000000000030000000100001060000000000006600000100000000010000000000000000000001006300000030
000030000000000000000000066600000401000000000100060001130000666000011000000001000000000000000000000000060010030001006660050010000030010000001000000000016003000400000044
300333333333333333333333333300300033000000333330300000003333303000000033330330000000000000033000333033033300303333033000006060300333300000000000000000000333333030000000
