000000000000000000000000000003000000030000000000001000000000003000000000000000001100100000300000100000000000006000000000000000000000000050000000000000000003000003000000
000000000000000000000000000000000000000000000010100000000000002000000000010000000006000000020000000000000000010000000000100000000000000000006000002000000000000000000000
000000000000000000000000000000000000000000000006000000000003060000000300000000000000000000500000000000000000060300000031000000000000000000000000060000000000000000000000
000000000000000000000000000000000000000000300001300000000000066000003300000000003000000000000000000000000000003300000330000000000000000000000003006000000040000001000000
000000000000000000000000000000000000000001000006600000000000066000013300000000010000000100000001000000000000033300003130000001000000000301000000000000000000003000030000
000000000000000001100000000000021000000000002000600300000021006000033300000000000000300200000000000000001001333300033330010010000000000000000020001000000000003000001000
000000000000000000000000000030313030000000330333100001003333000333333100000000000000303330100033330000000033333013303330030000333330300000003030333000500030133330000000
000000000000000000000000000000000040100020000000000000303060000000000000000000030000000300000000300000000000000005000000000000030000000000000000000101010000000000000000
000000000000020000000000000000500000000101006000310000060000000000000000000000000000000000000000000500002000003000600100000000000000000000000030000000000000000000000000
000000000000660000000000000300000000000003000030000000000000000001000100000000000003000500000000000030066000000000000660000300000000000000000000010000000000000000000000
000000000000660000000000003303000000041003000030000000000000000030000000000500000010000000000000000000060000400000000660300030003000200000000000030000000300303000000000
000000000000660000000000033300003000000333000000500000000000000100000000300000001010000000000000000003066200000000000660000000000000000000000000330000000000000000000000
000200000200660000000000333300001000003331100000000000300002000000010000000510000000000000001000000000000000000000200030302000000000000050000003003000100000000000102006
303333333333333333333333333300000003333331000000033333333033303000000033033300000000000000000000003303303000010030033303035033000040000300003333030000000000000003003030
