000000000000000000000000000000001000031000000300010000000003010100000000100000000010000000031000300000000000000000000000500000400000000000000000000100000000000003000000
000000000000000000000000000000000300000000000300505201003000006000300000000000010013005300130000000000000000103050000000000000010000300000000000000001000000000003000000
000000000000000000000000000003000030000000000000000000000000000000000000000000005033000000110000000001000010001000000003000000000000100000200000000000000000000001030000
000000000000000000000000000000033330000000100000000030000000001000000000000000005330000010000000030000000000000000300000000000000033330000000000350000000060000003000000
000000000000000000000000000000033030000000000003000000000030300000000002030000003033000000031000000000000000000003000000300000000330305000000000000000000000000003300000
000000000000000000000000000000330330010000000000000300000000003000000000000000032333010000000000040000400000000000000000000000003333302000000000310000000000000000000000
000000000000000000000000000030063333030333010000003133310000000000003000000003333333002000031030330000000000000010000000000000033033300000000100000033333000000000003333
000000000000000000000300000010000005003000300000030000003100000000000000060000000000000000000000000000000000000000000000000000000000000000000000000100000000005000000000
000000000000000000033300000000000300001000030000030000003000000000003000000010000000003000000000330000200000310000000003100000100000000000000000000000000000000000000033
000000000000000000033300000000000000030000000010030000003000000000000000000000000000000000000040331000000000000000001503000000005000000010000006000000000000003000000030
000000000000000003333300000000000000000001000003030000013000000000000501000000100000000100000333300010000030000030001043130000000000000000000000000001000000000000003333
000000000000000003333330000000000000000000000004030001003303003000000000000000000000000000100033330050000010000000000000000000000000000500000000000003000000030000003333
000000000000000033333300000000000000000000000000000000003000060000000000000030000060000100000330330000000000000100000003000000000000003000000000030000033000000300030133
333333333333333333333000333301000000030000000003000033430003333003303300000003106030331333033333033331300000000000000000003333033330333033330000000333013000000103331333
