000000000000000000000000000000000000000000000000002000040000000000000000000010000000100000000000000001000000000010000000000000000000000000000000000000001600000000000000
000000000030000000000000000000030000010000000000000000100003000000001000000000000000000000000030330000003000000000000000000000000000000010000000000000000000000000001000
000000000000000000000000000000000000000001000000000000000000000010000003000005000030000000000010000000000000010000000000000000000002000000100030000000000000000002000030
000000000000000000000000000000000000000000000000000000006000000000000000005000010000000000010030000000000030001000000000000000000000000000000000000000002010000005000000
500000000000000000000000000000000000000000000000300000000000000500100000000006003000000000030000000000000001003000001000101000000000300000000000003000000050000000011000
000000000000000000000000000000000000000000000203602002020000000020000000000000252202000000200300000000003001001000010000000000000200010000000002006000000000000000000000
000000000000000000000000005000000003000000031333333005330000000000000003353033033300333303000000003330333013033313332000100000033333600000000330333000000000000000000050
000000000000000000000000000000000000010000000010000000005600000000000000000010000000003000000000200100000000000010000000011000000010100000030000000030000000000000000000
000000000000000000000000000000000000000000300000000000000160000000000000000000000000000000100000000000000000000100000000100003000000000300000130000000300000000000000000
000000000000000000000000000001000000050000000300000000000000000000000000000000000000000000000000000003000000000001000100300000000000000000000330000301000000000000403000
000000000000000000000000000000001000000000000000000001001000000000000000000006001300002000000000000000010000300000000000000030000000300000000000000001000100000000000000
000000000000000000000000000300001000000600000000060000006000003000000200000000300000000000000000035000030033003000100000000000000000000000000000004000000000000010000000
020220200000000000000000200600000000000000000005000000000002006000001005006000000001030000000000000000000000001000000300000000020020200300010202202000000000000000000000
333333333333330333333033333300000333330333300005000310300333333333033000003500000000000100000333330000000000000000160000020050333030333033333333330000000033133030333033
