000000000000000000000000000000030030100003000000000000000000000000000000000000000000000000000000000030000000000000000000000000100000000000000000000000000000000000005000
000000000000000000000000000000003000000000000004000100000001000000003000000000000000000000000000010000000000000000000000000000000000000000000000000000000300000100001000
000000000000000000000000000010100003333000030000400000000000000300001400100003333000000000000001003300014333000030000001110100000000000020500000000001000033060103303000
000000000000000000000000000000010000000020100000000000000000000330000100000000010000100000000030003300000000100000000000000000000010000000000000050000000033000000000000
000000000000000000000000000000000000000000330000001010000000000330000001333030000000100000000000003000000000000300000000000000000000003000003000600000400000010000000000
000000000000000011101411110100001000101010330002001011010000000304002000333333001000030000041100013300000000000100000300030010001110110110000003060010110133000201000000
000000000000000000000000000033333333533330300003000000000000000300003330330306030333000000000000000000033003333300001003303303000000001000000000010000000050003303311333
000000000000000000000000000000000000000000000000000000500000000000000000000000000000000000300100003500000000000500030100000010000000000000000003600006000000000000000000
000000000000000000040000000000000000000006000000000000003050000000330300000300000060100000000000000000000101000000000000003000000004000000000000000000060000000000000000
333300000000003300014111000000000000000000000000000000000000000000030000000001110000001001000005000010000101000003300000000000330001400001000000000000000003300001110000
000000000000003300000000000000000000000000000000000000000000000000000000000000000000000000000000000000000000000000000000000000130000000030000000000003000000020000000100
000000000033333300000000000000000000003303000000000000530000000000000000000010000000000000000000000003333000000000000000000002330000000033300000000401330000000000000000
000000000333333300020000000000030000030030010060000110010000300210000100111010000000000000000111000000300200030000000004001101300002000333330500000010333300111010000000
333333333330333000033333333300000003333033000000000000000000300001000000000010303333000000000000033303133313033033333030030000300000333300010000000333303300003000033333
