000000000000000000000000000000000000030000000000000100000000000000000000000000000000300000006000000000000000000000000110000000000000000000000000030000000000000000000000
000000000000000000000000000300006000000003005000000000000000000000040000000000000000000000000000030006000000000010013000000500000000000000000000000000000300000000000000
000000000000000000000000000003000000100000030000010000300000000330100000010000000000000600100000000000000003300000300000000014050000033330303303030000000000001000000030
000000000000000000000000000030000000100000001010000000000000000330305003000310000000000100000030001000000330000000000000300100000000133330003033000000000000000000000060
000000000000002020000000000000001000000000000000020203030000000333300000000002020000202000000000001000600033030030602000000000202000003333003303000000000010000000000100
000000000000000000000000000000001010006000010000000000000000000303300000000000000000000500000000000001000333300000000000000000000000003336003333300000000003000030000000
000000000000000000050000000033033330001030033333300000000000000333003300000000000000000012000000000001000303033300000000333333000001033003133301333033330313033330100000
000000000000000000000000000000000000030000000010000300000400000000000000000000000000000310000000000000000300000003001000000000000000000000000100000000000000000000000010
000000000000000000000000000000000000000100000000000000300400003000000000000400000000000000000000000001010000300000000000000003000003300000005000003000300320000000000000
000000000000003333000000000000000000000000033300005300100000000000000000000000000000000010000300000000000000000000040000000001000000000000000000000000000000400000000000
000000300000003333000000000000000030010001333000000000003010000000000001000003030000000000000000000000003000000000000030000000300003000000000000000000000000103020000000
000000300000003333300000000000110030000000330300030000000000000000000600000000000003000000000000000000003100000000000030000000000000000000000120000000000000000031000000
000000303000033333000000000000000030000000333000040000000000000000000300003000000003000000000000400001003030000300003030300000000000000000010000000000000000000030000000
330000003333333330333333333333000000000000033033000000003001000033303303330331300000000000030333333000000063031333000000000000000000033333300000050000000033000000000000
