000000000000000000000000000000000000000000000300000100000000000000000000000000000000000010300000000000001000000005000000010000000000000000000000000040300000000000000000
000000000000000000000000000000000000000000000000000000000000000500000500000000000000000300000000000000050100000000300030003000000000000000005500000000000000000000000400
000000000000300000000000000000000000065003000000000000000000000003100000200300033003000003000050000000000003000005000040000000003300300000300000000003300300000006000000
000000000000000000000000000001003001000003000000000000000061000000000100000000000013100010000000000000000000000000000000000000000003330000000000000000003300000000000000
000000000000000000000000000000000000030000000000000300000000000000000000030000000033000000000000000000000100010000001000000000000300300000000100000530000000000300000000
000000000000000000000000000000060000003303010000000100000000000010003000000000303333000000000000002022000000000000000000000030000333300004000000300000330320020000000000
000000000000000000000000000000000003333333000000300000000000000003033300001003303333050100000000003030333000000031333030001000033030030000000033333333333330333333330033
000000000000000000000000000000000100000003000000000000006000000000005001000030000000000000000000060000000300000000000000000010000000000200000000000600000000000000000100
000000000000005500000000000055000000000000000000000100000000003000000000000000000000000000055100000000000000000055000000000000000000000400010000001000010000000000000000
000000000000000000000003300300003000000000000003000000000000000000010000000005000000000000005000000000000003300000000000000000000200003000360000003000003000060000000000
000000000000000000000000003300000500000000000000000000000000000060000000600002000100100050000000000000000000005300000010000000000000000000030000500000000000000000000000
000000000000000000000000003300000000000005000000000000000000000000000000000000000000000000000000000000000000003300000000100000010000000000010000000000000010000000000000
000000020220000000000000333300000002020010000100000000000000000202200300000000000110000000000000000000000000333300000100300000202200000000000010000000500001330500000000
333333333333330033333333333300033303033333000030013333330300000333303330330300000000033303300333330000000333303300330300000000333333300000000000000000100000030300010000
