000000000000000000030000000000000310000000000000000000000000000000000000300300000010000000000000000000001000000001000000000003100000000000000000000000000000000000000030
000000000000000000000000000030000000000000000000060000000000000000000000000030000000000000000000000000000000000000000000000000000000000030001000304000000000100000000000
000000000000000000000000000000000000000000000200000000000000000000000000000300000000020000000300010000003000203000060000000000000000000000000032000000000300300000000000
000000000000000000000000000000000000000030000600000001000000000000300000000000000600000000000300000000000000600000010000000000300000000000000060201000000000000000033000
000000000000000000000000000000000000000000206100000000030000000000000000000000000000000000000000030003000000600000000030000000300000000000000066060000000000000000000000
000000000000000000000000000000000000000000206600200050010000000000000000000000000000300000000030300010000600606200000000000010000300000001002066020000000000000000000000
000000000000000000000000000000000000000000300033330300000003000300000000300000300000333333300133330000000600033303060000010300303333300000003033330000001300001003033333
000000000000000000000000000000000001000000300060000000000100000003300001000002300000010000000060030000001010001000000000000000000000000000000001000000000000000300000000
000000000000000000000000000000000000001000000000000000000000013000010000600000000000000000000000000000000000000010000003000000000010000000000000300000000000000000000000
000000000020000000000003000300010001000000003000000300030000000000030000020000000003000000000000000000003000001000000000030000000300000300030000100003000300000000000000
000000000660000000000003000300000000000000000030000000032000000006000000600000030603000301000000000100003000000000000000006010000000001300000000000000000300000000500000
000000000660000000003000000300000000000000000000000000030000000000000300060000000003000000300000200000000000000000000000066000000000000003030000003040000300000000020000
000000020660220000003000303300000000000000000100001030356000000000000320660230000050000000300001000000000000000000000602006002000000000430330000003030303300001000000000
333333333333333030000003333300600033031303000001005333333333033003000033333330001333303000000000003010000000000000000000330333000003000333303030000000033300350000000000
