000000000000000000000000000000000000101000000000000000000000060000000000000000000000001000010010000000000000003000000000000301000000000000000000000600000010000000003000
000000000000000000000000001000000001000000000000000060000000001000300020000000000000500000000000000000000300000000000000000000300000000000100000000000001000000000000003
010111111111155000000000001010110150000000000000003010015030030000000001601110006000000000000000300101001500200011010155600003000100001011110000010000000000000000100101
000000000000000000000000000000000001000000000000000000020000100060000000000003300000000000006000000000000030000000000000000000600000200000000000000010000200000000000000
000000000000000000000000000000000000000000000001000000030000000000000000000000000003000030000000000000000000000000000000000003000001300001300030100000030100000000000000
000000000000000000000000000000000000000000000100300000000000006000000000000000000000000030000001000000000000005003000000000013000000100000005000303000000000003002000000
000000000000000000000000000000501000000000033003103031300000300333333300500003033030333333303333330000000030000031000100000000333333300100200333333033330330333310000000
000000000000000000000000000000000005000000000000003000000130000000030000030000000000000000000010000000000000000000000000000000000006000000000000000000000033001000000000
000000000000000000000000000000003100000003000000003000000000010000000000050000000000000000000000000000010000001000000010000000060031030000000000003000000000000010000000
000000000000000033300000000000010000000010110111100133000000010003330000000000010115111110100000000000010003331000033020000000000501000000001411105000000005333000000050
000000200000000333300000000000000000000000000000003313000000100033330000000003001000001000000000020000150033330000333005000000000000000000000005000000003000303000000000
000000300000003333000000030000001000002300000000033030060000000300300000000000000000600000000100000050000000300003330000000300010000000000000000000300000031000000000000
000000000000033333300000030000000000004300003400030333060000000300330000000000000000000000000000100000020333010033333000000340000000010000030003000000000030333001000000
333333303333333333333333333300001002333333000000033333300003000301330000313310000000000000033333010000000330333033303333333033000000003033330300000000000102333003000000
