000000000000000000000000000000000100050000000003000006000000000000000000000000000000000000100000000010000000000000000000000000000000000000000000000000000040000000000000
000000000000000000000000010000000100000000100010003000000000000000000002000000000000000010002000000006000000000000000000000300000000000000010000000000000000101000001000
000000000000000000000000000000332030030000000300060000000000000200000006003000000100000000060001000000000000000003030000000004000003000300001060010510000000000000030000
000000000000000000000000000000000000000000000000006300000000000000000036000000000000010000060000030000000000000100330001040000000000000004000000000010010100000000000000
000000000000000000000000000000000000000000003000061000000000000000000033000000000000000000006000100000006000000000100000000000100000000010003000001000130000000000000000
550000000000000000000000000000000000013001000000066000000000000030000066000000000000030000060000050100003000000000000003030000000000000010005000000000000000000100100000
000000333333000000000000000000230003333303000000033300200000000313330003300003303330010000033300000040000300303300000000000303000003110030000000103313030000000000003000
000000000000000000000000000000000000000000000100000000000000000000000000000000100000003000000030000001000000000000000000000300003000000000000000000000000000000000000000
000000000000000000000020000000000000000000013000000010000000000000000100000000000000001000100000000060004000000000100000001000000000302000000000000000000001000000225000
003300000000000000000660000000000000000300010000000000010000000000000000000000033000000000000400100003000100000000000000001000000000066050000000000000030030031000600000
000000000000000000000660000000000006000006000000000000000100000000000000000000000000000300600000000000000000000000000000000000300000006000000000000000300000000001600000
000000000000000000000660000000000000000000000000000000000000000000030000000005000000000000000000000000000000000000000000000000010000006050000000000000000030300006600001
000000000000000000000660000000000005105000550001300000005530000000000000000000000003000510000000000000000550000000000000000000550000066000050000000001000000000006000000
000300000000333333333333000030030000000000001000000000030600000000003300000000003000333333000000331003000001000331303330003006000000033300000000000001000033333330330000
