000000000000000000000000000000000000000000000000000000000000000030000000000000000000000000000000000000000000000000000001000000000000000000000000010000000000000040000000
000000000000000000000000010000000000000000001000000000010200000000000000301000000200000300000000000000100000000000000100100000030000000001000000000000000000000100200100
000000000000000000000000000000002000000000060000000000010100000000000000000000000300000001000006000000000000033000000000000000565100001030000000000600000000002006600300
000000000000000000000000000000066000000000660000000000006000000000000000000000000000000100000000000000000000000000000005000000000000000000010000000000000000006006600000
000000000000000000000000000000006000000000600000150010006000000000010000000000004000000000000000000100000000000003000000003100060500000000005000000000000050066006600010
000000000000000000000000000003306200000000060000000000006300000030000000000000000000100000000000000000000000000000500000000000060000100000000020000002000063366006000030
000000333000000000000000000010313030000003330031303033003303033330300300000000000000000300300000000010000001033300010330000000133333300000000030333400330333331033333033
000000000000000000000000000000000000300000000300000000300010000000010000000000000000500001000000000600005010001003000000030000000000000000000000000003000000000000000000
000000000000000000000020000000001000030200000000000600000000000000000000000000300000021000000000000000000003000000000000000500000000000000000000000000010000000000100000
000000000000000000200660000000030100000000000000000000000000500000020000000000000000660100000002000000000000000010030000000200000000005000030000000000000000000000000000
000000000000000006600660000000000000000005000000000000000000000002360000010010000000660000000000000000000000000000010000000000000000000000000000000000000000000000000000
000000000000000006600660000000000000000050000000000000000010000500600030500000000010600000000166000000000000030000000000000600100200001000000000000000500000000000000000
000000000000000336620660000000000000000000000030000000000100000033662005000000001000660030003366200000000000000000001001336621000030001000000000000000000000000003000000
330330000003333333333333333300000000000330000030003000000300000333303300003333000003333300333333303003300330000000000003030033030330033000003300000000000000000000000000
