000000000000000000000000000000000000000000030000000000000001000030000000000000000001000010000000000000000010000000000003000000030000020000000000000000000000000000010100
000000000000000000000000000300000000300000050000000000000000003000100000000000024010000000000000500000000000000000000300000100000000000030000000300000000030000000000000
000000000000000000000000000000000000000000000000000000000000000400000001000000000000000003003003003000000000000000000010000000000000000000000300000000000000000000010000
000000000000000000000000000000060000003000020000000001000000210000000000000000000000000000001000003040000000100000000000000000000000003000000000000000100000000000000000
000000000000000000000000000000000100000000100000000000000000000000000000060000000000000000000000000000000000000000003020000100000000000100002000000003000000010000000000
000000000011110000000000000020400000022400000150000000000000030002200000000000000003002000000000030000000002200000011130000000000000003022300000100000000050030000000000
000000000000000000000000000003233333333330000000000000000000066333333320000003133300001303303333000100000333333400000003033000000000033033333333303000000033331000000000
000000000000000000000000000000000000000000000030000000000006001000001000000000000000000000000000000000000000020000000000000000000000005000020000000003100000010000000000
000000000000000000000000000000004000000000000000000000030000000000000000000000000000010000000002000000000000000000000000000000000100000000000000000000000000000000000000
000000000000000000000000000030050100000001000100000030000010010000000100000000030000000000500030000100000000000001003100000000000030000000000000000000060300000000000006
000000000000000000000000000000000010000000000600100000000000000000000000000010000003000000000030030000000000000000000000000010000000000000000600000000000000000000300000
000000020000000000000000000010030000000000003011030000000000000000000000000000100000200000000000000000000000000050000500000000200000000000000000000001060000000000000000
000000020000000022200002200000030000010000500110100000050000000002000020000000000111260000030011110003000000300002000000012010100000000030000002000010110100020000000000
333330333333333333333333333303033333333003000000000000000000000333313333030330000000330333331000000000000000000000000003333333303333303000003330333000000033103310000001
