000000000000000000000000000000000003333300030300300000010000100000000000000000333333333010000000003000000000000000000003133333333030000000000633053000000500000000000000
000000000000000000000000000000000000000000000000000000000000000000000000000000000000000000000020000000000000006000000000030000000000000100000000000000000000000000000000
000066000000000000000000000000000003000400100000001016600000000030000300006600000000000000000003000010600300000100006600000000000000000010000000000000000100000041000000
000063000000000000300000000000030000000012000000000006300030000000330000006300500000000000200001000000600000000000316300000000000000200100000000000030000000010000000000
000066000000000000000000550000000000000000000000000006000303000000000000006600100000000000000000000000000033300000006600000000000000000055006000000000550000000000000060
333333333033330000000000000000300000100000000000033333300000000000000003333330000200000100000000003330330000000000003030010000000000000000001000000000000503000000000000
000000000000000000200000000000000003033033000000000030000000000000000000000300000001313303300002000000000000000000000000000000333003300000000000000000000000000000030000
000000000000000333333333330000005000000000000020000000003330300000000000000000030600003333300000300000000000003000300011000001000000000000000010000000000000000003333300
000000000000000000000000000000000000000000004000000000100000300000000000000000000000400000000000000300000000000000000000000000000000000000000000000000000000000000000000
000000000000000000000000000000000010000000000000000000000000000000000000000000000000000000000500000000000000030000000000001000000000020000000000000000000000306600004001
000000000000000000000000000200000000100000000000000003000000002000000000030000000000003000000100040000000000010000003000000300500003300000010030000000000030000000000002
000000003330000000000000000000330000055000000000000003000000000000000000000001005500000000000055003000000000006003030000000000003000000000000330000000000000000000000003
003000000000000000000000000000030603000000000330300050000010000060003000033330000000000000000000003303133003600000000000000000300033000300000000000000000033033330000000
000000000000000000000333333300000001000003000000000102003333530000000000000000000003000001000000000000000000000001000000010200000000000000030000000300020000101003333333
