000000000000000000000000000000000000001000000000600300000000000000000000000000000010000000000000010000000000000000030000000000000000000000000000010500000000000000000000
000000000000003000000000000000000000000003000000000000000000000000100430003003010000300000000000000000000005000000000130000000000000333000000000000000000001000000000000
000000000000000000000000000004000000011000000100000000000000000000000000000000000000010000100030000000000001101000000000000400000000000600105003000000000000000000000301
000000000000000000000000000000020000000000003000300000000002010000000000010000300010000000000000000000001000000000000000002000000000000000000000000000000000000000000000
200000000000000000000000000000660000060000000000300000005066000000000000000100000000000000000000002000000000000000000010066000000000000000000000100030000006002000000000
011110000000000000000000000000660000000000000000000020000066000100000000010030000000000200000000000010100000000000000030006001001100020000100000002000030006030000000000
000000000000000000000000005503030133003000000030030333030330330000005533333030000000303333300000050050000330313333333313000333000000000300000000000000000533333330000000
000000000000000000000000000030000000000000000000000000003000003000000030000000000000000000000030000000000000000000000000000000000000400010000000000000100003000000040000
000000000000000000000000000000500001005600300000000000000000000000000000000000000000300100003000000000000000000000000000000000000010000003000300001000000300000000010000
000000000000000011000000000000000000000000000000000000500001000000000000030003010003000000000000100000001000000000000000000000000000000000005000000000000000100001000030
000000000020000000000000000010000000000060000000000004000601000003050000000000000000003000100000000002000000100000000000030000010000001000000002001001100000600030300000
000000000660000000000000000000000000000003000000420000002000000000000000000030000000300030000000300006000000000002000006000000000000000000000066000060000000000002010000
000200000660000000000000000300000000000003000000001111000121100000000000300010000000000010000000030166000003000000000000000000060000000000000066000000001100000001111000
333333333333333333333333333300000553303004000030000000010000030000100003031333033300000300033333303330033000000033303330333333600005500000003033000333333300333300000000
