000000000000000000000000000000000000000000000000000000000000000000000000000000000000000000000000510000001000000000004000000000003000000000000000000000000000000000000000
000000000000000000000000000003000000000000300001000000000000000000000000000000000000000001000000000000000100000000020000000000500000030000000000000000500000000002001000
000000000000111100010111011100020001001000111011110000100100100000000011101110002010444400000000000100010000000000000210000000000200045000001010001100001104000003000000
000000000000000000000000000000660300000000330000030000000000000040000010030000066000000000000660000000000000000000000000000000006000300300000000000000035000000010100001
000000000000000000000000000030600000003000000000000000010001000000000000000000061010000300000660000000000000000000000006000000006601000000030000000000000000000030000000
000000000000000000000011440000610005000100000440010000100000000000000001240010006000000000000600000000000000003001000600000010006600000000000110400000000000000020001000
000000000000000000000000000030003333333333002100000000000000000333330303000000033333033033431333300130000000000003000000333333330333033333330001000333333303303300000000
000000000000000000000000000000100000000000500000000000003000000000000000000000001000160000001000000000030030000000000000000000000000000000100000000000000000100000000000
000500000000000000000000000000550001000000000000000000000000300010000000056000000000000000010000000005000000000000000000000000000000000050000000004000000001000000000000
100001110000000002000444400030000010000010444400000001000000000000001100001104404300311011110000001000011000001100101111400010010000000000101003011000210010000101000000
100000000000000066000000000010000006000000000000000000000000000000005310000000000006000000000000300000000000000000300000000000100000010000000000005000603000010000000000
000000000000000066000000000001000000030000000001000000000000000000000000000003000650000000000000000000000000000000000000000000000010000000000000000006600000000000000000
000000000000000066000000000000000000000200000000010030000000000000000001000000000000003000000000000040000000000001040000000000300000100000000000000006000000000000000000
333333333333333333333333333303333330000000330330306001000000000000001033133303333133000000033333333003033030030000000000000000010000000330330001300333333000000003113303
