000000000000000000000000000000500000000020000000130000003000000000000001000000506000030000000100000000000000000000000030000000000000000000000000000000000003000010000300
003000000000000000000000000000000060330000000000330002050000030000000000000000000300000000000000000030000000003300000330030000000000000000000000001000000000000330000000
000000000000000000000000000000000000000000000003330000000000000000000600000300000301010000000000000004000000000000000330000000000300000000000000000000000000000300000000
000000000000000000000000000000000000000000000300130000000040030000000000000000000000000000000000000001003000000000033330100000000000000000000000000000000000033330000000
000000000000000000000000000000000010000060000363330000010000000000000000001001000000000000000000000000000000000500333330000000000010000310000060000000000003303100300000
000000000000000000000000000000000100000000031333030000000000000000000000000006000000000000012000000000500000000010030310000000600000400000000300030100000003333330000000
000000030000000000000000000030000003330330303333300000330000100333333000033330000000000000033333300000000000000033330330001000000000033333000033330010000003330311000000
000000000000000000003300000000000000000000030000000000003000000000103000300030000000100000000000000000030000000300000500301300300000000000000000000000300000010000003000
000000000000000000033300000000000300000000000000000360051300000000000000001330030000300305000000000000000016000500100000000000300000003300000511000300000000000000000050
000000000000000000033300000000000000000000000000000000053000010300000000004300000000300000000000000000000000003300000000001000300000001000000000000300000000000000000000
000000000000000003333300000000000000000000100100003000003000000000000000033330000000300000000005000000000000333300000000600000000000000000000000000300000000000000010000
000000000000000033333300000000000000000000000000000000003000000000000000310330000000300000100030000000100003330300000000000000300000000000000000200300000050000000000000
000000000000000333333300000000000005000003000000400000000100000000000303330310010000300000000000050000000030300000000000000000300000010000000000000300000000000000010100
333333000333333333333000033306000000030000003333300000000300033600001033333330000000010003300323030000050333303300100000000000000333330303030000000001033300300003333006
