000000000000000000000000000000000000000000000000000000030000130000000000000000000060000000003000003000000020000000000300000000000000000000000000000000000000000000000000
000400000000000000000000000000000003000000000001000020030000000010003100000000500000300003000300100000000000000000000005550000000400600000000000000000100000000010004000
000000000000000000000000000000000005000000000000100000000000000000006000050030000000500000030000000000100001000000000030000000000001000010000000050100000000000000001000
000000000000000000000000000000000000001003003000000000000000000000000000000000000000000000000030000300000000000000000000000300000000000000000000000000000000000000000000
000000000000000000000000000000000010000000000000000000000000030030000000000000000001000000000000000000500000000000000020000000000100000000001000003000000000000000010000
000000000000000000000000000000000000030000000000000000000000300000000000001000000000003000000000000003200010000050000000000000000000000000000010000000000000300000001000
000000000000000000000000000033303300033333000000000000000000000000000033333033330333300000030030333333133000000003033333303330000000033033530010000333330300000000000005
000000000000000000000000000000000000300000000000000000000030000000000100000000000006000000000100000000000000000000030000000000000000000000300000000000303000003000000000
555000000000000000000000000000000000000010505000000040005550000000100300000000000000550000000000000000200010400000000000000000000000000300000000000550000150000000000000
000000000000000000000000000300000030300503000020000000000000001000000000000010000000000000000000000000000000000000000000000000000000000000000003000000000000000000000000
000000000000000000000000000000000000000000000000005000000000000000000000600000000010000000000030000000000000000300003000010000000000000003100000030000000000000000000000
000000000000000000000000000000000000000000000000100000000000000000000010000000000000000000000000000000000000000000100000000000500000000030006000001000400000000030100000
000000000000000000000000020000002000000000000000000000000001000000000000002006000000000300300000000000000000000000000000300000000300000000000000000000600001000001000016
333333333333333333333333333303030000000000330333000000003330033000000000000003333333033333000000003033033000000000000003303333000000010003000330320303333300000003320033
