000000000030000000030000300000000030000000000030000000000000000000000000300000003000003000000000000040000030100000031000000000000000000030000000000000000100000300003000
000000000000000000303000333000000000000000000000010000300000000000000000000000400000000000001053000000000000000030033300000000000000000010000140100000000000000030003330
000000000000000000000000000006000000000000000050000000300000001000000000100000001000000100030000006600010000000000003000001000000000000000000000300000030000000100000000
000000000000000000000000000000000000000000010000000360001000000000000000000000000000001000000000606600000000000000000000000030000000000000000000000000000000000000000000
000000000000000000000000000066000003000000000000000000000000003000000000000000001010000000000000006600000001000000000010000000000000000000000001000300000000000000000000
000000000000000000000100000006000330223100000100010000000000000000000000101000000000000001010000030600000000000010000000000000022012000000000000010000000000000001000000
000000000000000000000000000033000003033330333333000000006000000300000033333300010000330000001000000300000001320000000000000000333300300000003333033000000000000000300000
000000000000000000000000000000000000000000000000000000300003000000003000055000100000000000300000300003001030001200000003000300000003000000000000000000000000000000003100
000000000000000000000000000002000000000000000030000003030000330000030305000300000016005043000003030030000000000000000000000000010030300300100000003030000000000000000000
000000000005000000000660000030000000000000000000000000000000000000000000000006010000001000030000000000010010050006000000000100000000000000206000000000300000000000003000
000000000000000000000660000000003000000000000000000000000000003000000300010006000000000000000300000000000000400006000000000000000200000000016300000000300003100050000000
000000000000000000000660000000000100300000000000000000000000100002000000000006000000010000000000000000000000000106000000000000000000000000006110000000000000003000000000
022010000000000000000660000000000000600000000000000000001000000000000000000006000000300000000000000220000000000066000000000000000000000000000000000000000002201000000100
333333333333333300000330000000000000000000030000000000100000000000000000333303300000000300000000003333033303333333004003030030000000033000000300000330000033333330000300
