000300000000000000000000000000050000000000000000000000003010000000000000300000030000000000001020000114030000000004000000300000000000050000000000000000000000000000000003
000000000000000000000000000300000030000000000000000000000000000060003000000000030000100000000000000005010000000300000000000003000000000000000000000000000000000000000000
000000000000000000000000000060000000300006002000015000000300000000000000000000000000000110000000000020030000000000000000000000000001000000000300000000100030130000500100
000000000000000000000000000000003000000000003000300000010130003000000000000030000000000000000000000030003000000000000010000000000001300000000300300000000333300010000000
000000000000002000000000000000000000060000030000330030030660003005003000000000000000000000001030000060003100000003000000000000000000301000000000000501000033330000000000
000000000000000000000000000000000000000000033000330006035600033000300002000000300100000000000000000600033000000000040000000300020000300000000000000000000000330000000300
000000000000000000055500000050000000000000300000333330031030003000000003333300001055000003000000000130003300000003000206100000033013333033330000000001000033350330333333
000000000000000000000000000000000040303000000000000000000000000000000000030000000000000003005000000000000050000000000000000000000300000000030000000000000000000000000000
000000000000000000000000000000002000000000000000000000000000000100000300001003000000000100000000000100000000000000000000000000003000020300100000004000000000600000000003
002000000000003333000000000000000100000000303300000000000000000000000300000004313003000000000100000000000004300333330000000000002000000000000000000002000000020000000000
003000300000033333000000000030000000000300303300050000000000000000304000000000333160000000000000000000001300300030330000100000303000300000000005000010003300000030010000
066003300000033333000000000035000000003000003310020300000000000000000000000003003000210010500000000000013333300033330000000000066003320000502000000061303000000030003000
066003302000033333000000030000003000100000303300000030000000300030000000000001033000000000000003000200000330300033330000000300060000000000000000000006003300000030000000
333000333333333333033333333333300330000000333303300000550333333500000500000003330033000005533330333333033333103303330300000000333000300000550000050033000030333330000000
