000000000003000000030000000000103000000000600006000001000000300000000000000100100503000000000000000000300015000000600000000010000000000000300000660000030100000351000300
000000000000000000000000000000200000000001003000010000000300000000000003000000160000000000000400000000000000300000000000500000000000000000000000000000000000000000000000
000000000000000000000000000001030300005000000004000100000300000300000000000500003441010000030000000000000000031000000000000000000244103000003000000000000000000000000010
000000000000000000000000000006300000000000000006000000000000000004000000000000000000000000020010000000000000000000000000000050000000020000000000500000000000000000000000
000000000000000000000000000000000000000000300000000000000000000000000010000003000000000000000000000003000003010300000103300000300000000000000000000000006000000000000003
100000000000000001111111111120000001000000000000001111110000000111101010000100001001111111100303330000000000000000333330000000000003000011100033333000000000011010000003
000000000000000000000000000010000100001000003003100100000003000003000000000000030033000000030033000000000300000030133303033303003000000000003033330000000000100503000000
000000000000000000000000000000000000001000050000000040300000000000003000000000000002000033003000000000000000000000000000000010500030000000000000000000000100000000000100
000000000000000000000000000001000000030000000000000031000000000000000000000000000000000000000030000000000000020000000000060001000000000000000300000000000000000000000060
300000000000000002441000000030000000000000500000000000000000100000000000000003000000000000000000000011331003000000100000000000001000000001000006000000004351000003000013
000000000000000000000000000000000000000000000000000000000202030000300000000000000000001000000000000000000000400000000010000000600000000000000000000000000000000300000000
000003000000033000000000000000000330000012000003300000000000000000000000000000000000000000000000003000010000000000030000000000000000000000000003000030063000000000000000
003333300000000000000000000000333300600000000000000020100200000000151100100000303033000100110000300000000000000001000001000000010000011100110111010000000000000601000000
303333030000000030033333333330033303003333300000000000000000000000000033333133003330000600001002000030030303333330000000000102000000000000000000000003200033033330000000
