000000000000000000000000000010000500000000000000001000000000000000400000000000000060000000000300000000000000000000002100000030000100000000000000000000300060000001000000
000000000000000000000000000000000020005000000000000000000010000000000000000000000000000000000000000000000000500000000000000000000000500000000015000000300000300000010000
000000000000000000000000000000000030000000000000033330001001000303300000000000000000003000000000000000006000006600000000001000000000000000000100000333300000000001000000
000000000000000000000000000000000660000000000000000000000000000000400000001003000600000000000000000000000000000000000600000000000400000000000000000005100300050000000000
000000000000000000000000000000000660000000300000000003000000000000100000000001000330003000030000000000000300006630000000000030000000000300000014330010000000000000010000
000444000000000000000000000000003600000000000000005100000000000000000000002000033330000044030000000033330000006633000000033300000443000000000003031010000000044400000000
000000000000000000000000000030333330300000000000033333310000000333103100000003303000000300000003303330300333233300003333330300000000000001003033303303313300000000000000
000000000000000000000000000000000000000000000000000000000000000000000000000030000000000000000000500000000000000000001030000000000000000000000020200000000000000000000000
000000000000000000000000000200000000003000000000000000000000102060050000000001001000000001000013000000000060000500001000000000000006001000000000000000000200000000000000
333300000000000000000000006600000000003000000000000000000000060000000000000000000000333300000000000000000000000010010000000000000006331030000000010000406600000000000000
000000000000003000000000006600000603000000300000000000001000066000000000001003000000000300000040000000000000003000000000000000000006560000000120000000006630000000000000
000000000033303000000000036600001000000000000306000000100000300000001000000000002000000000000000000000000000000000000000000000000036000000000000000000000630000000000000
000000000333303000000000036600000003000000000330010044400000366000000000004003000000000000000050000000000100000000000000000000000036602000000000000000036630030000000000
333333333333000003333333333350000003000333033330000000050033003000600000000001003033303333300000000000000000000000000000300300333333300333330000000300330001033330000000
