000000000000000000000000000000000000000000000030000000030100000000100000000000000000002000000000300000001000000001000003000000000000300000010000000000012000100000000000
100000000000000000000000000000010000000000000000000000000000200030000000000500000000003006000000001000000000101000000000000000000000003010000030000000300020000000000000
000000000000000000000000000030100000200000020000000000000000000300000000000000300000000000000000000000000000000000000003300000000000002000000060000020000001000000000000
000000000000000000000000000000200000000000060300200000000000000000000000020000000000000000000000060000000000000000000000000001000000006000200100000601002000000000000500
000000000000000000000000000000000100000000660001000300000300000010000000100000000100000030000000030000000000000000000000030000000000000000000000001660000000000000000000
000000000402000000000000000000000000040200660000000000000000000000000000001300200000000000000000000000000020120032003000040000000000066000000000000060000000000000040200
000000000000300000000000000033333336000030333300000331330000030330353333333330333333000000013033330000000033333333333331000030000000013330000000000303000033033530100100
000000000000000000000000000000010000000000000000000000000000000000000000000100400043001600000300000000010001000000000010000000000000003000000000000000000000000000000000
000000000000000000000000000000000001500000000000011000000000001000000000000001000000000000000000000000000003000010000000000000100001000000000000000163000000000051000000
000000000000000000000020000000500000000000000000000000000000000000000000000030600000000000000000003000000000003000000000000000000000000000300000000000000000010000000001
000000000000000000000660002000000000000000000000300003000000000360002000000000303000000000000000000000000030002000000000010600000000000000000001000000000000000000000020
000000000000000000000660000000000000000000000000000030000000040660006003000000300000030030000000030000000660000000000000000000000000000000010000000000000000000000100000
000000000000000200200660000000000000000002000000000030000010000560000000000003000000000000000030000060200300000000000030000000000000000000000000003000000002002000300100
333333333033333333333333300000500030303033000000000000000000030333300000000000000000033330300000000000000333000000000003003331013000030333030010020010000030333333333033
