000000000000000000000000000000000000000300003000000000000000000000000000000010005000000000000000000000200010000000000001000000000000000000000000000000000000000010000000
000000000000000000000000000000000000000000030500000000000000000001000000000003000000010000000000000001000000000000000000000003001001000000000000000000000000000130000000
000000000000000000000000000003000000001000000000000000000000000030000000000000000000100000000011100000000000000000000000303000000000000010100000000000000000000005001110
000000000000000000000000000001000000000000000300000000000000504000000000000000031000000300000000000000000000000000160000000030001000000001000000004100000000000003400000
000000000000000000000000000005000000000000000000000000000000000000000000003000000600000000000000300000000000300200005000000005000000000000000000000000000000000003000000
000000000111110000000000000000300000000000000000000220002222000000000103111110000200000000000000000000000000002000001000000000220000000000000000220001011100000000000000
000000000000000000000000000000000506000000000000003333030333333000000000000000000000303330033333030000000333333000010103336303333130003333033330330000000000000003333333
000000000000000000000000000000000103000010000000000000030000040000000000000000000000000000000000000300000000030000000000310001000110000000000000330000000003000000000000
000000000000000000000000000030000000000000000000300000000000000000000000303000000000011000000000000000000000000000000000000000000000000000100100000000000000000302000001
000000000011100000000000000000000000000001000000000011100000100000000000000000030000000003003000000000000000000000003000000000000300000000003000000000000003001000000000
000300000000000000000000000000000000000000001310000010000010000000300000000000000000100000000110000000000000000000001000000000000000600000000060000000300000031000000000
000000000000000000000000000000000010000000000004000000000000000030000300000000000010000000050000000000003000000000000010100000000000000000000000000006000000000000300000
000000000000000000220222200006111100000220000000060000000000000050310000000000000221000000000111112222000000000000002000010111000000000000003010000002000012020000000000
333330333333333333333333333300000003330303333330333033330333330100330300000003310333003000000001001330130000000030333300000000000000000000000000000030030334030030000000
