300000000000000000000000000000100000000000000000000000003000005000010600000500000000000000000000001000000000000000310103001300000000050000003000000050001100030000000000
000000000000000000000000000000000000000060000010000000000000000001000310101600000001000000003000001011010021001000300600200000000000500300000000000000000000000060000000
000000000000000000000000000000000000033300300000001101000000500000010000000500033000000000000000003000010011000000000030115000000000200333000000000000000000000000001000
000000000000000000000000000000000100303300000000000003030610000000000030000060331000000000000001000600000000033003000000000333000000100063000000000000000000000000000000
000000000000000000000000000000000660003000000000000003000000000000000000000000003300000000000000010000000000130000000000000300000000600030000000003000000200000000060000
000001010000000001100000000000000000300300003000040003000000010103000100000000303300000001500100000001000000030000000103000300200006603033000000010100000000000000003500
000000000000000000000000000033033330033033000003033303300000000000000031333330031330000000000000103330000333013000000003330333330303303333330000000300000030000000000000
000000000000000000000000000000000000000030300000000030000000011000003100000000000000000000000000000000000000000000000005004000000000000000000000000000000000000000000000
000000002000001111110000000000003000000006000000511011100000000000000032000030001000000000000000000000000000000000000006000000111101000000000000000020000000000000011000
003330001110003000000000000200000000000020000000030000000000000000300200110000010000000030000000000050002000000000000000000000300000000000030030300011000000000031000030
033330000003333300000000006603000000000110000000033000000000010300006600003330000000000000003033000010066030300000300000010000330020000000000333000060033300000060300300
000330000003000000000000006600300000000100000000000000000000000000006600004000000000000020000033000000066100000000000000000000001100000000000001300000030000000660000000
030330000003000000000000006600001001000000000001000000000000100000006000000000000000000311003030000001566130000020000000001100000030000300000303300000030001030660000000
003333333333333333333333333300003010350000000000033030330000000333333330333000000000000000000133033333333600000000000000400000333333300000000033030303333330343313033133
