000000000000000000000000000000001000033000000000000000000500003000000050000010000003000000000000000000300000000000004000002000000000000000003000000000000000000000000000
000000000000003000000000000000000000000000000000300000001001000000040000001000000000000000000000000000000000000000000000000000000000100000000000000000001000000000030000
000000000000000000000000000000050000000000000000000000000000000000000000000000000000000000040000000004000000000030000000000000400000000000000000500001100000000050000000
000000000000000000000000000006005000000000000200000300000000000000003300000000000000010503000000000000003000200010000000000000000000000000050000040000000000023001000000
000000000000000000000000000000000000000000000000000000000000010010000000000000000000000000000000000000000100001000000000010000000000000000000000200000000000000000000000
111111000000000000000000000000111100000000000000000000000111010000100000010600000000300000000020001000000000000001101100000000000200000001000000500100000000000000000000
000000000000000000000000000011030003330331313331300000000000000000000000000000333330305336003336330333333033300000000000000000333333330333531001000333303303333030000030
000000000000000000000000000000000000100100000050000010000000000030000000001000000000000101000000000000300000000000000000101000000000000000010000000000000005000000000000
000000000000000000000000000030000000500000000000000000000000301000000300000000100000300030000300010000000000000000000000000000000000000100100000100000000000003030000000
400000000000050000000000000050000000000000400000000000000000150000000040000030000000000000000000000011000000000000000050000000000000000000000000000000000000000001006000
000000000020000000000000000000000000000010000000000000000010000300000010600000000000000000000000000000010000000000000000050000000000010100000000600006000000000000000000
000000000000000000000000000000000000000000000000000000000000000000001000000000000000000110000000400000003000000106000000000003000000000000000000000000000600000030000000
000200000000000000000000000000300000000030000200000000000000000000300000020000000000101011000000000000000600000000000000000000300000000000001010101000000000000000002303
333333333333333333333333333300000003333333330333300000030033333333333130331330000000000000000000000000000000000030330301005000333333300000000000000000000333333333033033
