000000000000000000000000000000000300000000000000000030000000000000000000000000000000000000000000000000000000100000063006010020000000000000000000001000000000000001000000
000000000000000000000000000000000000000300000000061111100400000000010000001000000000000000000500000000000030000000033010000000010101000000000000000600000000000100000000
000000000000000000000000000000000000000620000300000000000000010000003000030000000000000300001000000003000300001000000000100000000030050000000003000000000000000000030013
000000000000000000000000000000000000000010003000000001020000000000040000030000000000000350000000000003000003000000000000010000100000200000000001000003000000000000000000
000000000000000000200000000000000000000000030000000030000000200000000000030000000016000300000000300000300006300000006000050000000003000100000000000000000000000000300200
000000000000000011111000000000006000000000030000601000003011001000000003130000000006030300000100000000001300000001011110000000000000000000000000000000305000000000011000
000000000000000000000000000000000000000000063333333330000000000006000031333300303313530330000333000000000000000000100030000000333330300000000000060000000000000000000300
000000000000000000000000000000600000000000060000000001300003000300006000000000000000000000030000000000000000000000100000000000000000010000000001000000000000300000000000
000000000000000111110000000000000000000000000100000001000110115000000000000000000000100030001151100003000000000000000000000000501000010000000000006011111000060000000000
000300001000000000000000000000000030000000010360001000000000000000000001000000000000000000000000000000001100000002000000000210300101000030400003000000000001000000000000
000300000000000000002000000000000000000000000001100005000010005000100300150000000000005000000000020003000000000000000001000000000300000000030003000000010201000000000000
000300000000000000000000000600002000000000000300000001000000000000000000000000000000000000010000000000006000000000000000000000000300000000060003000000000010000000000000
030300000000000000000000000600100110600000000300000000005000110000003000000000000600100000000000000000006001111110000000000000000000100000060003000000000000001000000006
333333333333333333330033333351000000000000033303333330033303330000000000333330000000000000033333300333300000000030333030000003330333323333000333033303323003333330303300
