300000000000000000000000000000000000000510000300000000000006000000000000010000000010000000300000003000060000003000000000000100000000000000000001000306000300000000004000
000000000000000000000000000000000000000000000003010000000006000000000000000000100000000000000300000000000000000000000000003001000000000000000100000000000030000000000000
000000000000000000000000000040600000000000200000000000440000004000100000000010010000000000000000000300000000000000000400000000010000000000000000000000004400000001000000
000000002000200000000000000000000000000002000000300000000000000020302000000030000000011010000006000000000000302030000000000000000000000000000000000000600002000200021000
000000033333000000000000000000000000000000000000000000000000010403330000000000000002000500000000000000000000000000000000000000013000010000000000001000000030310000500000
000000000000000000000000000000000000000000000003000000004000000000000002200300000000000000000000000000001000000000003004030002130000002200000220000000000000000000030000
000000000000200000000000000000013300000000000000003033003330300013032013313030003000000000000000000000000300033303333005001133000000633331033033033303000000000200003000
000000000000000000000000000000000000000010000000000000003001000000400200030000000000000000000000000000000000000000000003000001000000000010000000000000000030300000030000
000000000000000000000000000000000000000000000300000000000000000000050000000000000000000000000000001000003000001000000000000000100000000003000000000000000000000003000000
000004440000000000000000000000000000000300000000000000300000000000000000000004000000000000400000000000000400000000000000000000000000000000004000000000000600000100000000
000000000000000000000000002000000000200020003002000006000000000000000000050200000000000100003000030000020000000302000250000000030002010000000010000000000000000000000020
000000000000000000000000000000000003333000000000000000000000005400000000000000300000000010100000303333310000000031300000000010000000000000000000000000000000000003000000
000000000000020220000000000000000010000000000000001200120000000501000000000000000000000000032200000000000000000000000000000000000001000500000000002000000000000001010000
333330000033333333333333333300000030000020333333303330330000003000300033333330003330033030031133030000120000533300000200030000333333000000000003003600010000000003303003
