000000000000000000000000000000000030001000000003000000103000006000600000000030000000000000000000000010630000000000020000000000000000000300000010001000010005101000000000
000000000000000000000000000000000010000000000000000000000000100000001000000000300000000000000000000000003400060000000000000000000000000000000000000000000002000000000000
000000000000000000000000000000000000000041000000030000000000000000000000000000000030000100000000003310000066000000000000000000301123000000000011100000000066000000050000
000000000000000000000000000000000000001000000000000000000000003030200000000010000000000000000000020030001660000000030000010000000000000000000000000000000006000000000030
000000000000000000000000000000000000000003000030000000000000300000000000000010000001010000000000660000200360040000001001000000000000000003003000200000000066003000000000
004444000000000000000001100000304100011600000000000000000003300000000000000100101000000004000000660000000660000000003000004440000000000003000000000000103066000000000060
000000000000000000000000000000000000000000033530010001003333330000000000000000050000000000003030330333333303313330333300000000333030303000003533330200100030333360000000
000000000000000000000000000000000000000000000300000000030000000000000000000000000000000000000000000000003000000000000000000060101000000000300100000000000040000000000000
000000000000000200000000000000000010200000010000100000000000000020000050000000100010000000100000000030000000000000000000000000320000000000000000000200000000000000000000
331110000000006600000000000000030006600000301110000000003111100660000000000000000000000000000000010040010005000000000100000000600000000010000000030010010000013000000000
000000000000006600000000000200000036600000000000010100000000000060010000000020000003000000000000000000000000000000104000000002660000000000000000000000010000300000000000
000020000003006600000000006600000066600001003020000003000000000600000000000060000000000036001000000000001000000006000003000066661200000000010000300000000000000630000300
000000000033006600000000006600000666600100000100043100000000000660000000000060044400000030000010000000000004444000101030100066600000000000000000100001404000000060003000
333333333333303333333333333333333333333333303003300000003333330333333033300030100000330333000000000000010000002000010003333333333330300000000000100001500030061303333340
