000000000000000000000000000001000000000000000000001600000000040006000000000003033000000000000000000010000000000003000000000000000010000000000000000000000000300000000000
303000000033300000000000003000000000000001300000000000010000000000000000000000400000000300000000001000001000000000000300000000000000000300000000000000000000000003030000
000000000000000000000000000000000000000000000000000000000000100000000000000000030000000020030000000300000010030000100000010000000020000000000000333000000002052000010000
000000000000000000000000000000006000000000000000300000000000000000000000000000000002000660000000000000000000333000000000000300000060000200000003000000000000066000000000
000000000000000000300000000030066000333000000000000003360330030000030000100000000002000000003330000000002000103000000000000000000660000000020003330065030000066000000000
000000000000000000000030000000036003000000033000000000001000000001000003000000000000000060033600030000003033363000000000100000000600100001000033330000000000006000000300
000000000000000000000000000000333330003333000000003000000051033000000000010000303300000303300033303600305003333000000000000000000303333333300000333000000000303330300000
000000000000000000000000000000030000001005000000000000000000000000000000030000030000100010000000100000000000000004000000000050001000000000000000000000000000000000000000
000000000000000000000000000000500000000300000000000300000000100001000030033300000000010000000000000000000003003000003300103000003000000000000020013000033000000300000000
000000000002000000333000000000000000000000001003300000000000033000000000000000050200000003000000010000006000000000000000000330000000000000103100000100000000000000000000
000000000066000003330000000000000000000500100333000000004003330000000000000010006000000000000000000100000000000000000000063030003000100000100000000000000003000000003600
000000200066000003330033300000000000000000000333000000000003330500000000000300106610000030000000000010000000000300000000003030000000003000000000000003000000000000000000
000000000066000333330330000010010000001001033301000000001060330000000010000000006600000000000000003300100000000010000000103330000000030000000000000000000003000000100000
333333000333333333333000333303333100010000033353300000003310333000000000000003003333000000000030001000040060000000000000033033000000000033033000330000000030000000003300
