000000000000000000000000000000000000000000300000010500000000000000000000006000030000000100000000000000000000000000000001000000000000000000100000010000000000000500000000
000000000030000000000000000000000000000000000000306060000000000021000000000000000000000000002000300000000000000000000001000000000000002030000000000020000000030000000000
000000000000000000000000000000000000111100006000000100000000000610000000100000000000000000666000000100000000000000000000000000000000106000010030100660000000000000010000
000000000000000000000000000000000000000000000000000000200000000360000010000000000010000000000000000000000003000000000000000101000000000034000000000660000500000000000000
000000000000000000000000000000300000000000000000000000040000000660000000000000000000000010036000000000000140000000000000000000000300066000000000000660000000000000010001
011110000000000000000000000000110002000000000000000000010000000360230200100000300010000010020020052000000001010001111002000003000000066000120000000660204200000000100100
000000000000000000000000000000000003303333000000013353300000000033300330300300503000000000003333331333330000000000000003013330033333000030333333330433360300000100000000
000000000000000000000000000000000000000010000030000000000000000000000100000000500000000000000000000000000000000000000000000000000000000000000000000000000000000000000010
000000000000000200000000000000030000000006010000002003000000000000320000001000000000000000000000000005000000030000000000000000010300000000300000000000000000000000000000
111110000000006600000001000000000000000000002000006000000000000000000010101000000011100000011111000000000000000000010600110000000000000000001112104000000000000003000000
000000000000006600000000000000000001001300000000063000000000000000000000000030000000000000006030000000000000000003000000000300000000000000000000000000000000000000000000
000000000000006600000000000000000000000000000030016000000000000000000600000130000000000000000000000004000000010000000000000000000000000000000000000001000005006000000000
200000020000006602002000000000300000000000000000006020010010010000000020000000111100100000020100000000000000000000000002000000000000000000002000000200000001000000000000
333333333333333333333333333000100003303300300000033333033330001100000033333300000000000000036330330000000000333000000003631333000000001000003033333003333300500001000000
