000000000000000000000000000000003000000000000000000000030000500000000000000000000000000000000000000000000000000000000005000001001000000000000001000000030000000010300000
030000000000000000000000000000000004000010000000000200000000000002000030000000000000000000000000006001000030000000000003000000030000000000000000000060000000000000100000
000000000000000000000000000000000000000000000000006600000002000060000000000000000000000000000000000000000006000000000000300000000000000000000000000100000000000000000000
000000000000000000000000000002000300000001003000000000000000000066000000000000000000000001100000000000100000000000010000000000000000000000000000000000000100000100000000
000000000000000000000000000000000300000006000000030600000000000006040000001004005000003000000000060000100000000000000000000000000002000000000000000000000000000050000000
000000000000000000000000000000000000000002002020036600030000100366000000000000000000000300000000000000000000000000000500020000000000030000000010000000000200200000000000
000050000000000000000000000003333003333030303033303030030000100330303333330330000000333053100010000000000000050003001003000300000050000000000000000033333300000430001500
000000000000000000000000000001000000000000000000300000000000000000000000000000000000000000010000030000000000000001000000000000000030000003000000040013000000000000000003
002000000000000000000000000000000000000030100000000000000000300000000003300000005000000000100000000000000002000300000000000010300000000230000000000000000000000000000000
066000000000000000000000000000000000000000000000000000000000000006000000003003000000003000000000300000000000010000000000000300000000001101005003000000000000000000660030
066000000000000000000000000000000000000020000000000000001003301000000100103000000000000000000000000000000060006100064510000000000000206600001000000000010000000000060300
366000000000000000000000000000000100000000000000000000000000000000000000000000100000000000000000000000000306000000030000000010000000036600000000300030000050000013600000
366000000000020020200000200000000060000000000000000005000020200000000200000000000000000020000520010000000366500000021000300000000000236300000000000000000000202103660000
333303333333333333333333333300000010000000100010030000003333330310333300005000000000333033030333330000001003303333303300000000303333303130030000000033333333033333303033
