000000000000000030000000000000000000000000100000000000000000300000000000000000010000000003030000030000000000010000000300002000010600000000300000000000000000300000000000
000000000000000000000000000000300000000000000000000100000000000000100000000000000000000000000500000000001000000000000000000000030061000300000000000100010000010000000000
000000000000000000000000000000000000100030100000000000000000000000001000000000000000011000100000000000000000000000000000033300000000000030001100000000000000000000000000
000000000000000000000000000000000010000000000000000000000000000150000000000100000003000000003030000001600300000000000000000003000000000000000000000101000000000000000000
000000000000000000000000000000000000000000000000030000006010000000000000010000000000010300000000060000000000051000050004000000000000000003000000000010000000060030000000
011000111110000000000000000000000000000000000020201100010000000010000110110000000000000000211110100110000000023211110000000000000000001103010000000000000100000005000000
000000000000000000000000000000000003033033303333300000000333333000001000000000000000033303100000000003600030303000000003333333630303300000003033333100010000000003303303
000000000000000000000000000000300000000000000030000100000000000001600000000000000000003000000003000000100001000000000010030010000000000010000000030000100000000500030000
000000000000000000000000000000001000000000300000000000000000000000000000000300000000000000000000000000000000000001000000000000000000000010603000060000030000000000000000
011000100000000000000000000000000000000000011000100000000110301000010000000000000000003000000000000001000000000010100010000000000010000000000000000000010100000000110001
000000000000000000000000000000003000000000060100000003000000000000000001000000000003000000000000000300000000000000000000000000000000000000000000000000000006000000000000
000000000000000000000000000000000000000303030100100000300000000000100000000003000000010000000000000000000000000000100000000000000000000000000000000100000030000310003000
000000200000000000000000020200000001111000000000200010000000000000000110000000000013000030030000300000000000000000000020000000000000200000000000100110100000002020130000
333333333333333333333333333300000006000003333033333333333333303000000133303333330333000000033033030303033000000033333300000000331333300000000000000000000003333303000333
