000000000000000000000000000001000500000000000000000300000000000000000000000000000000000000000000000000000000000000000010000030006000000003000600000000000000000000300300
000000000000000000000000000000000000000000002200000000100000000000000000000300000000010000000020000000000000000000620000060000000300000000000000000000000000000300000000
000000000000000000000000000000000300000006006600000000000000000000000000050051000000000000000630000000000000000000600000000000000000000000030000000000000003000003060000
000000000000000000000000000000100000030000006660000000000001003000000000000000000000300000000060000000000000000000060000000000006000000000000000000000000000030100000000
000000000000000000000000000000000000001060036600000000000000000000000000000000000030000000000660000300000000000000360000000000000000000030000000000000000000000100300003
000100011111111100000000000000000000030003006601030620000002000000250000000000100300200000000600000002000000100000160001011301002200000000001000000000101001011130105000
000000000000000000000000000000000103330300000310000333303332303003360000061000000000000000033003033033000000000033333000005000331300300000000500000000011000000003330303
000000000000000000000000000000000000013000000000000001000000000001000000100000010006000000000000000600000000000000000000300001000000000000000000000000000000000003010000
000000000000000000000000200006000000000000000000000000000000000000000100000000002000000001000000000000000000003000006000000000000000000000500032000000000000000000000300
000411000000000000000006600000000000010000000000000041000000110000000100000300006000000411005000030000000000000000000003000110000001000100000066000000401000000000000000
000000000000000000000006600000000006000000000000010000000000000000000000000030066000310000000000000300000010000000000300100000000000000000000063000400000006000000000000
000000000000000000000006600000000000000000003300030000000100000000000000000000000000000000000000000000000000000000000000001000100001000100000066000300000000000500000000
020200000220000002000006600011000001110611000101002020000403300010105011111103006010020234011000001111101000200000013001200000060203011001600166000020200000003000002000
333333333333030033333333333301000100003300000000003333343333031000000000000003330033303031300000300000010000333000000006333333003033300000003333333330333300310000033333
