300000000000000000000000000000000000200000000000000000100000006300000000000000000000000000000000003000100000000000000000000000000000030000003003000000000000000000000000
000000000000000000000000000000000000000000000000210101110000000000000000001010000002010000000000000000000100000200000000100050000000000000100000000000100010000000000000
000000000000000000000000000030001110000006000006611000000000001000100000000001100060000011100300500000000110006600000010000100000000000000000000000000000101001051100066
100000000000000000000000000000000100000000000006000000000000200100000000000000061166000000030001001000000000006601002000000000000000010000001100000000020000000006000066
110000200000000000000000000000000000000010000000600100000001000100010200000000000060001000000000201101000000106000000000000000003000111000021100000000000000000000000060
100001100000000000000110000000000001600000000006610010000001000130000110000300000066000000000060065000001000036630100010000000000001010000011000000300000000100000000066
110001000000000000000000000000000330000000530333303333333330013110001051000003333330000033300000001000010300330033133330000333000000011000101100010033331300003333300333
000001000000000000000000000000000000000003000000040000000000300001000000000100000000000001000003000000000001030030000000000000000001000000000300010000000053000000000000
101011100000000000000000000200000000003000000000000000000000000000000010100000000000131001103000010000000003000000000100140000101011100000021010111000000000100030000000
110000000000010000111110006600000013000100000000000010000000000000000011000000000011110000000003010300000003000000000100640050110000001000660100000000002000000000000000
000000000002000000000000006600002000300000000000000000000000000000600000030000000000000000005001000000001000000000000001000000000000000000660000000000000000000000301000
000000000000000000000000006600000000030000000000001300020000000000000000000000000000000010000033300000000000000030000000000000000000000010060000000010000000000000000000
000000000000000000000000006640000000000000000000010000010000000000000000000000000000000000300005001010000000000011000000000000000000000000660000000010000000030000000000
333333333333330000333333333333033330000000000000011000100000000000000033033300000303333330033333330000600000000000000000000005330333033333020333333000000000000000010100
