003000000000000000000000000000000000001000050000010000000000000000600000003000000000000000000000000004000003000000000000000000100001000000000000000000000000000000000000
000000000000000000000000000000000000010000010000000000000000400000150000000000000100000000000000003100000001000000000000000000000030000000000000000003000000300000000000
000000000000000000000000000000030000000000000000000000000000000003000300000000000000000333003300030000000000000000000000000000000000000033300000000003000103300030000000
000000000000000000000000000000000330000001000000000000000000030000000000000000000001000060000000000000000000000000000000000000000000000000000000000000000003000000000000
000000000000000000000555000000000020003000060000000000000000000000000100000000023000000000000050005550000000006000000000000000003010000000000060000000000000000000000000
133000003330000000000333330000000001330000000000000000000133003000000000010000000000000000000000003333300133000000000000033003000000000000000303000030010000000001330000
000000000000000000000000000000000000000002102000000100000000000333033300001000333033000060030033310000033000010030060000003000033303300000000000000033033353333330000000
000000000000000000000000000000000004000000300000000000000000000003000000000000030000000000000100006010000200000000000000033000000000400000000000000000000002000000000000
000000000000000000000000000000000000000000000000030000000000000000000000000000000000000000000000000000000000003000000006000000000010100010005000000000031000000000001000
033000300033300000000000000003300030000000010000100000000000000000000000033000000003000000000000000000000000000000000030000000006000000000003000000000000000000300100000
000000000000000000000000000000000000000000000100000000003000000000000000000000000000000000000100000000000000000300000000000000000000003000010300000000000000610000000000
000000000000000000000000000000000000000000005000000000000050000000400030000005550000000000000000000003000004000000000000002000550000000013000000000510000000030000000000
000000000000000000000000000000000000530000333030000000006000000133000000000003333300000000000000000001000033300000000001000000333330000000000000000313330000000010000000
333333300000000333333300000033333300003000000000000333030000000000000010000000000000000000003303330000103000000003333330000000000000000000000000000010003000000003000000
