000000000000000000000000000000000000000000001000000000000600000000000030000000000000000000000000000000000000000101000000000000000000000000100030000000000300000000000030
300000000000000000000000000030000003300000000000000000000000000000005330000000030030000000000003003300000020000000000003010001000000000030000000000030000000000000000033
000000000000000000055000000000001060000003000000000000000000003000000030000550000000000003000000000000030333330300000000000000000300300000003303033000303300500553000000
000000000000000000000000000000000000040100000000004000040100030000000000000000300000000301000000000000600000030000000030000000000000000000000000000000000000000000100000
000000005550055000000000040500000100000000000040500050050000000000000350001001000000500040500350000000000300060000550050000000000340500000100000000000000000000000030100
330000003330000000000000000030030100050000000006001330000000000000100000000003300000000000003331106000000000000003310003300000100000053000000000000000330000000000000300
000000000000000000000000000000010000000003000000000013500000000360000000000000006000003000010000000000000000000000000000000000000000030000000000000000000000000100000200
000000000000000000000000000000000000000000300000000000000000003010000000000000000000000000000000000000000000000000100000000000000000000030000000000000000000000000000000
000000000000000000033330000001000000000133000010000000001000000000000000000000000050000000000000030000000300003000000000300000000000300000000100100360000000300000000000
000000333333333000000000003333033333000100000000300010000330360000000300000000000000005005530030000000000010005033003330000033000000030000000003000000000000000000000103
000000000000000000000000000000100001000000000000000000000000000000000050003000000000000100000306000300003000000000000000003000000000300000000000000000000000400000000000
000000000000000000000000000000000000000000000000350000000000000000000001550050000400503000000000000000000003000000000000000300000000050000000000005060001005050050000011
000000000000000000000000000000000000000000000010000000500000000000000003330100000000001000000110010000001030000000000000300000000050000000000000000310000003330000000000
300000000000000000000000000030000000030001300000000000000000000100000000000011000000000000000001000000000000000000000000000000000001100000000000000000000000000003000030
