000000000000000000000000000000000000000000000000000000010000000000050000000000000000000600000000030000000000000000000000001000000000003000000000000000000000000000000000
000000000000000000000000000000000000000000000300000000020000000000000000100000000000000000000000000000000006000000000000000000000030100000003000000001003000000000000100
000000000000000000000000000000000000000000000300000000660000000000000000000000000000000100030001101110000000000000001300140000006210000030000100000000000000000000000110
000000000000000000000000000000000000310002000000000000660000000000030000040000000000000000000000000006000033000203300020001000000000000000000330002000300000030000013000
000000000000000000000000000000000003330006000010000050000000000000000000000000000000100000000000003000000033006033300630000000001000001000003030066000000000000000000000
000000000000000000000000000000000000030566300000002000660000000000001010000000000000000000000000000000000303306600000660020000000000000000003300060000000000000000000160
000000000000000000000000000000000103333331000000033330300000000000000000000000000000000000130303333300430330303340303333333333000000000000003333031000000000000003030303
000000000000000000000000000006006000000000000000000000000000000003000000000000010000000003000100000000000000000000000002030000003000050000000000000000000000000001000000
000000000000020000100000000000000000000003100110000004000000003000000003000000000001000000001030000000000000003000000020003300000000000000000000000000000000500000000001
000000000000660000110114000011000000000000100000000000001040000030000010001100000066000016600000001030000000050000000660000010030311000000000010000000001000000061140000
033000200000660000000000000000000001000300000000000000000000020033000200002000000006010006600000000000000000000001000660100200000000000000000006000000000000000600000000
333006600000660000000000000000000030000000000000100000000000000333006600050000000066000600000000500200000000000000300000000000000010000000000000100000000000000660001000
333006602000660000000002000000251000000000000000000000000020000303001600000000200066020006600003000000000000000002030160000000000000000000000002000000000002000660020000
333333333333333333333333333303033033003300333003000000003330033330033333000333333033333333300000000000000000000303333330500001330333300005000000000000000003333300033333
