000000000000000000000000000000000000000100000000300000000000000005000001010000500033000000000000000000000003330030000000060003300000000600000000000003330000000000001033
000000000030000000000000000000010010301035000000000000000020000003300500000100030000000000000000000030000000000000000000000000000000000110000000000000000030000050000000
000000000000000000000000000000000003000000000000000000003000000000000000000000000030000000000000000300000500000030000000000000001000000000003003000000000000000050000000
000000000000000000000000000000000000000000000000000300001000000000000000000000040000000000000000000030000000000010000200001000000000000000000000000300003100000000000000
020000000000000000200000000000002001000000040000000000130000000000000000000001003300000020503030000000000533000010000000000003000030000000600000000315000000000000000003
110010000000000006600000000000066000000000100010030030010031033000000000066003000000000610300300000000000000000050303330000000000660000000000033303000000000300000000000
000000000000000006000000000000060003333333000200005000000000000333330300060000000060000600000300000004000000500300000000000000000600000000000000000000000031003030000000
000000000000330033350000000000000000000400003005001003000033051000006000000000000000000013300000000000000000000000000000003000500305000003000001000000000000010000000000
000000000000000000000000000501003000000000000000000030000660000630330000000000000000000000000000053000300000000001010150050500300000000000030000003000300000000000000050
300000000000000002000000000010000300000000000203000000000002000100000000200000001000000060050006003000000003000000000000000100000000000000000000000000000000000000000005
000000000000000000000000000000030000000000003000005000000000000000000000000000000000100000000000001003000000000000000000000000001000000010000000000000000000000000000000
000000000000033330000000000050500000000000303000100000003300000301063002000000000000000040300300000000000020000060300300000000030000002000030000000010000002002000000000
003333330000000000000000000000333330000000000000000000000000000000000011001000000020300000010003000633333110010000000000040000000000111001000000000000010010001030006000
000000000000000000003333333300000000303000020000300000300000001000000000000000003000000000033310333000000260000031003330000000000000300000000000100000000000000000436010
