000000000000000000000000003300100030001000000003000000030000033003000000000000000000113300000000000000010010000010000306031000500000000000000000000000000000001000000300
000000000000100000000000000000000360000000000000000000000000001000000100010000000000000000000000000003030000000000000100000003003010000000300000005000000000000100000013
000000000000000000000000000000000033300001000000000000000000000000000100000003100001000000100000100000405060000030000000000000000000116000030100003310000100000000000000
000000000000000000000000000030000000000000000000000000400000000000003030000000000000000000000000100000000000000000000000200000033000003000100000000000000000030100010000
000000000000000002000000000000000000000000000200001000000000000000500000020000000000000300005000100000000000000000006000002000000030000000000000300100000000000000002000
000050000003500000002530000000000000000000000030256000005300000000030000103020003000000000400000023331000030051010000510000102000000000000000000000000000051103000000035
000000000000000000333000000001000000000005000013300000000000000001300000033330000010000000000003330330000000100000000000060333000000000000000000000000001000000000000333
000000000000000000000000000010000000000000100000000000000000000100000000100000003000500000000000330000000000030000000330010000000000600000000600000000000000030300000000
000333000000000000000000000000033300000000000000000000000003330000130000000130000300000001000000001000000010001000000000000333000000300003010003030031000005000000000000
000000033000011100003030000000000000030003000000003001010010000010100400300300302000030005000000001100033000000030000000000000330000000100001000000000500000000000360000
000000000000000000000033000000000010000000000000003300000000000010000000000000330000030000000000000000000000000000000000000000000000000000000300000003000000000000030000
000000000000000000000000000000003100000000000000001000000000100000000000000000303000000000000000000010000000000000000000000000000010000000000010000000000000000200030000
330300000000000000000000000030000000000000000005000001000303000500011000030500000000000000053100000000010030105050000003303000000000000005000302000000053053000000000000
033000000000000000000000000003000003000000000000300000000330000000100000000000000100600000000100000000000000000000030000300000300000000000000300000000100000000000050000
