000000000000000000000000000000000110000000000000000011000000500000300000000000000200300000000000000030000003000000000000000400000000000000000000000030000000000000000000
000000000000000000000000000000000000000000000000010000000000000000000000000000100000000020000000000000000000000000000000300200000000001000000000000100000030000000000003
000000000000000000000000000000001000300030100500000000000003330000001100010010000000000100000000040000000000000000000000006601000000000000000000050060000010000006000000
000000000000000000000000000000000000000000003001000010000000050020000000100000000000000660000000003000005020300000000000006000001000000510100000000000000003000100100000
000000000000000000000000000000050000000000000000000000000000000660000000300000001000030600000000000000000360000000000010006600000000000300000000030000300000000000000000
000000000000000000011110000000600000100300000000000000020003000660100000300000000010000600011000000000011660100001300110006600050000211000001100000000000000000000000102
000000000000000000000000000000000000000000333303133333300000010303333000000000000000330030000000000000000330033000000003333033033330300000000500000000000033033311330333
000000000000000000000000000010000000000000000005000000000000030000001000000000000000000000000000000000103060000000000000000000000030000000005000000010000030000000000000
000000000002000000000000000000000003000000000000100000000000200003000000000000200001001000000000000000000030000000000000000000010000000000000000000000000000000000000000
000000000066000000011100000000060000000011000000000000000006600100000000000001000030000000010060000000001010001000000001000000000000000000100000000003030000000100103000
000000000066000200000000000030066000200000000000000000000026600500003000000013000003000000000000305000100000050100000003000000000000002020000006600000000002000030001010
000000000066006600000000000030006006600030000000000000000006601000000000000000000000000000060000000030000000000000100100000000000000000000000000000030000066400000000000
000000200066006600000000000000066006630000001000000060110006600040000010000000003000040000200000000003000000000000000000000030000100066000000006400000001306300000010000
333333333333333333333333333333300330333333000000000003003333300333030300010003333303133033330333030000000000100000000000303303020500050033333333333000000033130030000000
