000000000000000000000000000000000000001000300000000000100000000000501000000000000000000000000000003001000030000050000000000300010000000000003000050010003001000000000000
300000000000000000001000000030000000303000050000000000001000000000000000050033000301303300000000010300000000500300000030600001103000000000200000000301000000000013333100
000000000000000000000000000000010000000000000000000000000000000300600000330000000000000000000000330000000003300000330000531000000000000000100000000060000001000000000000
000000000000000000000000000000000000000000000000030000000000000000000000000000000000000000100000030000000200000000000000000000300000000000130000000000010000000000000000
000002000000000000000000000000000200000000000000000000000000600000000000000100000030000000001003330003000000000000100000000000000000000000000000000000002010000003000000
303033333000555000000000000030300330050000000000400001000000000350005530000000030033000000000033330000000000000030000000000000000000000000303300055303033300000000100000
000000000000000000000000000000000000000300300003300000000000000000000030000000010001000333330003330000030300000130010000000000000003300000000000000000000000004000306330
300000000000000000000000000000000004000000001000000000000000000000000030000000000000005000000000000000000000000100000000000000300300000000000000000000300030000000000500
030000000050033333000000000000100030000101000000000000000050003033300003000000000000000000000000011000300200010030000000000000031040000000000100000000000000000000005001
000000000330000000000000003300330000003000000000100000300000001000000000000000000033000000000010000001000000300000000010000000000000000000330000000000003300000000130000
000000000000000000000000003300000000000000000000000000030006000000000000000000000630010000000000000000040000000000000000000000000000000000330000002000001300000000000000
000000000000000000000000033300006000010320000000000603030000000000000000000300000333000000000030003000020000000000000000005000000000000003330000000000530300000000000030
000000000000000000000000333305500000000000330000000003335000000000000000100000000333330005350000000000333003001030303363300155000000000033330000000000333300000001000000
000003330000000000333300033300001000000000000000030000300000000000013301000330000333000000000000000000000000000000000000000030030003330003300000000300033300000303000000
