000000000000000000000000000000010000000000000000300000300000000000000000000003000003000000000000000000000000000000000000000000000000000000000000010300000000100000000000
000000000000000000000000000000100000300000000000000000001000000000000000000000000000000000000000010000000000000000000000010000000000000000000000000030000000000010000000
000000000000000000000000000050000000000000000060000600000000000000200000000000360010000000050000000104440006000000000000002000000000000000010004440001000000660010000100
000000000000000000000000000000660000000000600000301300000000000000000000000000060000000000001000000000000006600000000300066000000100000000000010000016000000360300000300
000500000000000000000000000000630000000003000010000660000000000106000000000000066000050100000200000000000006600000100003066000000000000000000000001306600000660000010003
000000000000000000000000000000600000000000003001000600200000300006600000000000060020000000000000000002200000603000000000006000000000000000000002200000600003000003000000
000000000000000000000000005500333030000000000000033033300040000333303300000550333033010000000000003333033333306300003550030030100000000000003330033003003300333030000055
000000000000000000000000000000000000030000000004000000000000003000010003000000000000300000000000000001000000000000000000000000000000000000000000010000000000000000000000
000000000000000000000000000000000000000300000000000100300000000600000000000000006000000000000000010030000000000000000000000000000000110000000000000000000000000000000000
000444000020000066000000200000020000301000000444000000000302000200000000044400010000000000000001000302000000000001004400066000000100100020000000003000000000000000002000
000000000660000066000006600001600000000001000001100000030006000000000000000000000000000600000000000063000000000000000000066000000040000660000000000000000003000000060005
000000000660000066000006600000660000030600060100010050000006000000510000000000001000006600003000000066000000000000000002006000000500310660100000600000000000050000060000
000220000660200066020006600030600600000000000200000000000006000000000000322010000003006600000150000066020000000000020000066000000000000060206000000000000000000000566000
333333333333333333333003333333330300000065333003000000000030333030000033330330000000003133000000553333333000000000303333332333000000030030330000000100000000050033003333
