000000000000000000000000000000000000000000000000000000000000000006003030000000000000000000000000010000000000000300000010112013300600020000000000000000000000000000000000
000000000000000000000000000030000000000000000000060000300000001000000000000000000000000000000000000004000300000000020000100003000000000000010000033030200000040001000000
000000000000000000000000000000000100000000000010000011110000300000000030000000031010000000000001100000000000000001011000033003000000000011100001010000110000030003000000
000000000000000000000000000000000000000000000000100304000000004030000000000000030006000500000000000000000000000000000003333000000000000000000000000000003000000100000000
000000000000000000200000000000000000033200301000000000000000210000000000000000001100001000000000500000500000000006000003003000000000000000000000000000006300012003000000
000000000000000011110000000330020000011000000000000610000011110000000000000000035500002310000000060000030000000300000060300003002200020030000000000000006000101000000010
000000000000000000000000003330003000000000010006003303330000013000000000010003033300333333303333330000000000000300033023301030303030333333333333333330003300201000000000
000000000000000000000000203300000000000000000000000000330600000000000001020330000000000000000000000002033000000000000000000000003000000000000001030000000100000000000000
000000000000000002000000000330000000000000000210030000000004000000200001000030000000000000000000000001010000200003000600000000300000000000000060003000000030100000000000
000111000000000011100003300300000000000000001110013330030100000010111040030010000000400000000050000503003001110000000000000000000000000000000103003000001000000000300000
000000000000000000000333300300000000000000000000003310000300001000001003100030100000000000000000003333000020000000000000000000000100001000003003000000000030000000000000
000000000000000000066333300300000010000000000000633330030400000000006033330330000000000000000060003333001000006600000000010000000000000000003333003000000000000000000000
000000000220000000066330000300000000006000000006610000030022060000006631000000000003300000000111100300003000006000101100000003060000030100003300003001200000300000000000
333333333333333333333330003300000030300000330333313000033333330030313333000330000033004000000000003300133333303000000000000033000300003000103300003033000000000300100003
