000000000000000000000000000001004000000000000000000000000000000000000000000300030000000000000000000000010000000300000100000000000000000060000000000001000000000000000000
000000000000000000000000000000000000000000300000000000000000030004000000001000000000000000000000300361000030000000430000300000000030000001000000000000000000000000000000
300000000000000000000000000000000000300000000200000000000000000000331000400000000000000100000300000000010000000000000000503300302000000000000000000300331000000005000040
000000000000000000000000000000000003000000000000000000001300000000000000000000000010010000300020000000000000000000000000000000000530033300000100030000000000000100000000
000000000000000000000000000030000000300000000000000000000300000000100000030000000000063000000000000000000000500000000300000000000000403100000000000000110000000030000000
044004414110000000000014110004400440300000141100000000000363500000000030000021401000000000000000000000000104010020000020000400304004403000000040004000000020000021411000
000000000000000000000000000000000053330333000000000002000333030000003333303320300000010000003333330000003003000030333330030003000003133333330000000000000333303330000000
000000000000000000000000000003000000000000010000000000000000000000000000000000000030000002000300000000000003000040000000300000000000000000000000013000000000000000000000
000000000000000000000000000000106010030002000000000000000000000030300000000000000000000000000000000000100000000000000000000000000000000000000000000003005000000000010003
033000000033100300000000000063300030060030000000002033113500000003000000030000000000000000000000000000000000000030000000300000000000000000000300100033000000000000001310
000000000000003300000000000000000000000000010000000000003000000000000000000001000000330000000000003000000000000030000000003000000000000010000300000000000000000000010000
000000000000000300000000000001001000000030003000000000030001000000000000030000000000030000000060005000000000300300000100000000000000006000000300000000000000000000000000
000000000000000300000200000200000000101500300000200000000140044000000001461000000000030030010110002000002304004430411000000003101100000000000300000003000000000000140102
333333300000333333333333333303333030000000330333301030000000000303330000000000000000333303300000000333303000000000002013333333000000000003001303330300333300000000005000
