000000000000000000000000000000000000000000600000001000000000000000000000003302000000000000030000000000000000000000000000000000030000000000130000000100060000000000000000
000000000000000000000000000000000000000000000100000000000000000000000000000050000000000000005000000000000000003000000000000000000000000101000000000000000020350000300000
000000000000000000000000000000000000000303000000030000003010000000000000000000003000300001000060000000010000000001001500000000000010000000000000001001060000300000000000
000000000000000000000000000000000000000300000000200010000000000000000000000300100000000000001301000000000000000000000000003000003000000003310000000000000000303000000000
000000000000000000000000000000000000003033000000600000010000066000010000033330000000000000000000000000000010000000500000000030000100000030330000000000000000300300001000
000000000000000000000000000000000000003333022006600000030220066000000000030300000003000030000000000000001000000000000000000000000000030033330000000000000000300000000000
000000000000000000000000000000013103330333033333300600003303033000000003333030000000000000030500000000000000100000000003133333001000033303330333330300000000330330001000
000300000000000000000000000000000000000006000300000000000000000040000000000000000000000300603000030003030002000000060000003010000000000030000000000000003000030000000100
203300000000000000000000000010000000000000203000000000000033000000000000400000000000000000000060100033000200000000000002333003000000000000000000003000000000000000020300
003000000000000000000000000300000000000100003003006000100030003000100000000000003000100300300000001030000000000000000003001000000030100003000000000000000000000000000000
003000000000020000000000033310000000000000003000000000000030000100000000003000000000000033300000020030000000000000000020030100000000000000300000100000030003000000001000
003000000000660000000000333300600000000000003500000000000030000000000000000000000000500330306000660030000000003000000060030000000000000000000000000000133330003060000000
003000002200660000000000333300000000000000003000000000000030000000000000000000000000000333302200160030000000000000000661030000000000000000000000010500130312200660001000
303333333333333333333333333300000103330233303333300030000200333033333300000030000000300333303333333033333333333133303303033333000000000000010000000033333335333330000100
