000000000000000000000000000000003000001000300000000300000000000000000000000000000001030000010000000000000000000000000030000105000020000001000000000000000004000000300000
000000000000000000000000000005500000000000000000000000000550000000000000000000000210003011010000000000000000000000000000000000000000000000000000000000010000000000000000
000000000000000000000000000000000000000000000000000011000000000000000000000000003000000000030000000330000000000000000003000000000000000000000000000300000030000003330000
000000000000000000000000000000000010000000003000000000000010000020000000000030100000000000030500003000051000000000100003030000130000300010000100000000000310500003101000
000000000000002020000000000000000000000000202000000000000000000000000030000030000000000000003333003000000000003020200003333300301030300000000000300300100033303003130000
300000000000000000000000000000600000100000100000030000000000100000030133000333000000000000000000003300003000000000000000000000030003300000003000000030304330000003300053
000000000000000000000000000033330300000000010000000000003333303001000000333330000000000000000300303330000000000000030000030033000003300000000000000010330000300333330000
030000000000000000000000000000000000010000010003000000000300310000000000000130000000000000500010000000001000000000000000300000000000000000000000000000000000000010001200
000000000000000000000055000500000030000000000000500000000000000000000000000000000000000000000000000550005000000300000000000000000000500000000000300056000500005010000000
333000000000003000000000000000000000300000000000000100003000000000000000101000000001000000000500000300000000030100000000330000000000003000000000000000000000000301000001
330000000000033050000000000000000203300000035000004000030300000000000030000000000000060030300000005000000000000000000001300000000000000000000000000000000000000000033000
333000030000033333300000000000000003330030333330030030033330000000000033301002010000303000300000000003000000000000000003030000100010000000002020010006000000000000000000
333000333000333000000000000000000003330003030003033000333020013000000030000060000000330003302001000000006300000000000000330006000000031000001000000000005040000000000000
333000000333330030033333333300030003330300003000300333330330000000000000300300000001003303310000003333333040000000000003300000333333300000000003300333333100050000000000
