000000000000000000000000000010000000000001000000000000000006000003000000010000000003000030010000000000300000110000000000600000000000000000000000300000000000000010005000
000000000000000000000000000000000000000100010000003003000000300110111000000000200000113100000000000000003000200000000000100000110000000000000000030000010002000001100000
000000000000000000000000000000000000000000010000030030000000000000000010000001011010001000000000000000000000110000000001141100300100000000000030000000000001111000000000
000000000000000000000000000000000000000003000000000000000301000001000000000000000000000000000000000000000000000000000000000000000000000001000000000000000000006000000001
000000000000000000000000000033000000000000000000100001000000000000000000004000000000001000003000000000000000011000000000000000003000000000000000000000000000000030000300
000001414000000000000000000000000141000000004030000000000003300000000000000000000000060000000000000000004000006000000140000000000030100000000000004000000000000100000000
000000000000000000000000000000000000000600333333000005003010303031330300000003333336033333300000000000000000000000000003033300333333303000000000000000000030033030033333
000000000000000000000000000000000000000000000010100300000000000000000000000000000000300000010000031000000000300000000000000030000001060000030000000000100000000000000000
000000002000001111111110000002000360000003111111100000001100000000000060050000000000000000002000004011111000000000000000500010111161100000000000000000000001000000111011
000000011111000000000000000001111000001000000000000000000000004000000100000000303000000000011111000000003000030000001000000000100000000000000000000000000000000000005000
030000000000000000000000000000004000000003000000000103000050000000000000000000000000000000000001000000000033000000000000000000004030000000001000000050300003013000000000
000000000000000000000000000000000060000000000000100000000000000000000050000000000000000301040000000003000030000000000000000000000000000000000000000000000000000000010000
000330000000000000000000000000000000000000000000000030000000000000000004000000060304140050000000003000000100030030000000003300000000010000002000000140000000003000010000
300333333333333333333333333333333333000003333300300030330033333040030030000000000000000010000033130333333000303300010003103333313303300000000001000000000030030333533303
