303000000000000000000000003000000000000300000000000300000050000000000000000303030000000000000300010000031000000000000000000000303000000003000000003000000310000000000000
003000000000000000300000033111000000006600330000000300000003010000060100003010000000000000000000000000030000000000200300000000000000030000000000000000530000000000000030
000000000000000000000000000000000000000101000001000300000000000000000100000000000000030000000000000000000020010110000000000000000001000000000000030000010000000000000101
000000000000000000000000000000000006600033033000000000000000000000001010000000000030000001000010013000300660006000000000000010000000003000000002000000100030000006300000
000000000000000000000000000000000000600000000000000000000030030001000060000006000000030000000000000000000610000000000000000000000000010001300000000003300000000006600000
000000000000000000333400001100000006600006060004000000000000000020000040000110000050000005000000004000011600000100000000300001000000000000000200000000003300000000200000
000000000000000000000000000033330000330000303333000000003303000303333300000000000000000003300000000000000003000000000333303000000000000000003033303000000030000330330000
000000000000000000000000000000000300060000000300010000000000000000100000000000000000000000000000000000000303000000000000000000000000000000303030000000003000000010000000
000000000000000000000000000020000010000300000000000003310030003000000000000000000330000030000000010000000000000101003000000000000530000003310033000300033100000000000000
000000000000000000000020011100010000000000000000000000000000111000000330000000000000003000040500001000000030000000000000230111000000000000000000000000000600000000005000
000000000000000000000660000000000000000300000000100000006600000000000000000000030000000000000000000000000000030000000006300000000000000000000000000050003000000100000000
000000003000000000000660000000000000000004000000000001006600000030000000000000000000006000000000100000000000000000000006600000303000000003000000003000000000000000110000
000000000000000200000660000000000060000333000000040003106600000030000000000000000330100033000100000000000000000003100000000000000033340000010500000400001100000000000000
333300000000333333333333000000000010000000001000300000003330000000003300000000010000000000033333033033000000060003333331330300000300000000600000000000000033300000000000
