000000000000000000000000000000000000000501000000006000100030000300000001000000000000001000000000100000000000000000000010000101000000000000000000000660000000000000600000
000000000000000000000000000003000000010000000000066000000200000000000000000001000000000000000000000000000000000000010000000000000000010000000000000060000000100000000000
000000000000000000000000000000100453000000300000066000010000000000000000000600000000003200000000000000000000000000000000002000000000000000000000000660000000000300500000
000000000000000000000000000000000000000000000050006000030000000005000000100000000000000000100000000000000100000000000000000020001000000000000650000660003300000000000060
000000000000000000000000000000000030000600000003066000000000002003660300000000360000000000000000600000000000000000000610000000002000000000100000000660000001360000000000
000000000002000000000000000000000000036000000000066000000000100033660000024000000200051000000000000000100000030000000100000000000000000000300000200660000000360000000000
000000000000000000000000000000000003300303000000033300103333030303333300000000000000000000000000003313430000330300000000003333330333000000000001000333000005033330000000
000000000000000000000660000010000000000000030006000000000000100000000060000000001000200000000000000001000660050556000000000000000000000000040000100000030005100000000000
000000000000000000000660000000000002000000000020301000030000000000000066000000600000000500000000000000000660000061000000000000000000000000000000000000000000000000000100
000000000000000000000660000000000000030000000000000030000010000000030000000000000000000000000033000200000660000066000003300000000000000000003000000000000000010000000010
000000000000000000000660003300000000000000000000000000000001003000000066000330000000050001000000003002010000000066000330000000000000000000000000000000000000000000000000
000000200000000036600660000000000000000000000000200000000000000100000066000000000001000000000000000036600660000003000000030600000000000000000000000000000000100020030000
000000000000000336600660000000002000000005000001000000000000310000001066000000000000000020000030000330600663000366500000036600000000000002000000000000000000100000106100
333333000033333333333333000000000000600000303303000033300600000000000030300000000333000000000000001033633003000033300003333333000000003000000003333000000033560000000000
