000000000000000000000000000000001000000000000000000000030030000000000000000000000000000000000100000001000000001000000000000003000000000000000000100000000000000300000000
000000000000000000000000000000000000000030000000000000000330000020003000000000000000001051000006030000000000000000000000000000000000000000000000000000300000000100000000
000000000000000000000000000000000000000000000000000004400000400000000000000000000000000000000000400000000000000003031000000000001000000000000000000000000000004005000000
000000000000000000000000000000000060010000010000000000000000003001003000000000000600000000100000001002100000000000000001000003000000000000003000000000202000000000000000
000000000000000000000000000000000000000303000000060000006000030000000000000100006000100000060000000060000000000000360000000000000000000001000000000006600030000000000000
000000000000000000000000000003000000000500003000060020056002000000000000402002066010000000060020000006000050000020600000000000000000000000000000000206000000020160000000
000000000000000000000200000004000003030030000000033333333033333000000003033330333033003333330033333333313000001033333332000000300000000000003000000303303333333333003003
000000000000000000000000000000000000006000000000000000300000000000100000000300000000000000000000103000000000000000000030100000000001000010300000000000000000001000000030
000000000000000000000000000000000000000500000000000000000000000000030000000000000000000000001000000000000000004000000000000000000000000000002100000000000000000010000200
000044000000000000000000000030000000303000000030000000000000000000000300010300000000300000001040000000010000000000000000000000000044110000006000000000000000000003000000
000000000000000002000000000000000060000000000000020020000000000000000000000000030000000000030010050000000000000000000000300000300011000001000000000000000003000000000000
600000000000000066000000000000000000003000000030001660000000050000000060000010000000000000000000000000000000000000000000000000000000000000000000010000000000000000000000
600200000002202066000000000010003000000220000000020660000000000000003001000100000030000300000002300003000000030000010000300003030300000002260000013000000000010000000220
333333333333333333333303333300000003303033006100033031030000000100000500000003033330200000010033310000000000000030033330000100331333303333330000500200000000000303333033
