000000000000000000000000000000003000100040000000000000000000300100000000030010000000000000000000000503000000305010000000000000000000000000000000000000000000000000000000
000000000000000000000000000300000030005550000000000000000000000000000010000000030000000000000055500000030000000300000000000000000000000001030000003000000000000000000000
000000000000000000000000000001000001001000000000000660000000000000000100030000100020000030010010030000000000000010000000000310001000000000000000000000000000000000000405
000000000000000000000000000000000000000000030000000060030000000062000000001000000005000000000000000000000010100000010000000000000000000000100000000000000000000000000000
000000000000000000000000000000000000000000000000000101000000000000000010000000000000000000000000000000000000000000000000000005000000000030003000000000000000003000000000
000000000000001000000000000000000002000000000000000660000000000000000010000000000000100000020000000000000000000000005000000000100001000000000000000000000000000011000000
000000000000000000000000000000000003000333330330330333330000000333000300000000000100000030033333333333033000200000000000333003000000000000000300300000000030033330006000
000000000000000000000000000000030000000000100000000000100000000000000030000000600000000030000000000000000000001000003010000001000000100000000100000005000000000000000000
000555000000000002000000000000000000000300000000100000000005150000000000001030002000000200000000000030000000006000100000005550000000000020000000000003031300055000002000
100100000000000066000000000000000000000600020000000300000021000000050000030000066000000500000000000000000000000030000001010000500000000060000000000000000010010000066000
000000000000000066000000000000000000000000000100000003000000000001000000000000066000006600010000000000000000001000001000000000063040030660103000100000000003300000066000
000000000000000066000000000000000000000000000000000005000000060000030100000000066000000000003000000000000000000000000000000000000000000000000010000000000000000000061000
200000000000000066000000000000000000000000000300010000002000000000000000000000066000006300000000000000000000005010000002000000000000000000000000000300000000000100066000
333333333333333333333333333300303300000300000000000000003330330633300300000001333130300333300000000001000330333300300003133333333330303323300000000300000033303033303333
