000000000000000000000000000000000000003003000100000000000000000000000000000000100000000000001000000000100000003000000000000000000030000000000000000000001016020100000030
000000000000000000000000000000000002000000000000011100000000000000000011100002000000000000000000000006000010000300006300000000000000000000060101001003010000000000000000
000000000000000000000000000000300000000300000000000000000000000000000000000600003300000001000000000000000000000100000000000000000003300000000040200030000000000000110100
000000000000000000000000000000000000333300000000100000030030000000000000002001033300000000000000000600000000010000100010000010030000000000000000000001030050000030000000
000000000000000000000000000000000003000300030000000000000000003000033000000000003000000010000000005000010000000001000000000000000000000000003000000010000000000300000000
000000000000000000000000000130000000103000000000002000000000000000000300000000003300060100030000000000001000000000300000003001000100000000010000000000000000000000000000
000000000000000000000000000000010000000333000000003033330000000000060033033000003513000000003000000000000033333300000000000100030000000000000033303000000000000001333030
000000000000000000000000000000000000000000000000000000000003000000000000006000001000000000000000000000000000000000000010000030000100000000000000000000000000000000000000
200000000000000001111111000000000000000000000000000010110000003000101100000000300003210000000000030040000000111100511110000000111000020000000000000000010020000031110030
000330001101000000000000000000000000110300000000000000300110100000000100000000000000000300001501000030000000000060501010310101000000030033000310000000000000033000000000
033330000000000000000000000000000000000000006000000000010300000000000000000000100000033330000000000000000000003000000000000000000003003333000000300050001000333000000050
000330000000000000000000000000000000000000030000000000000000060000000000001030000010000030000000000000001000010000000000000000000000000033000000000300000000030000300100
000330000000000000000000000000000000000000000000000000000000000000000000000010100000000300000060000000000000000003000000000000000000000030000000000000000100003060000000
000333333333333333333333333300300003330633600000033333330333003330300300000000400100000033331301330000000313330303333333333033030033300160330100000000000001003330033033
