000000000000000000000000000000000006000000000000000000000000000003000000300000000000000003000000000000000003000000000000000000000003000000000000200000000000000010000001
000000000000000000000000000000000000000000000000100000000000000060000000100011101010000000000603000010000000000000000000000000000000000000000000000000001000000010000000
000000000000000000000000000000000000300000000000000300030000000000010010010000000000000000030000000000000000000100000000000000000000300500000060000200000000000030000000
000000000000000000000000000000000000000000000000000000300000000000003000030336000006000063000000000533000000003000000000120001000003000000003000000000003000000330000000
000000000000000000200000000000000000050000000000001000000000201000003000003310300000000000000000000000000000000000000000000000000330300000003000300600003000003030000000
000000000000000011111000000000100000000000000300030000000011112000003010013300000001000003000000000003000001100100001000000101000430300030000003000000104010033300002000
000000000000000000000000000000010000000000006333300000300000000330330303033333000333313300300000000030333000000000000000000000033333000030330000333330330313333300003003
000000000000000000000000000000000000003000000100000003000003010003000000000000000002000000000010001000000000000100000000001000000000000000000100001000000000000000000000
000000000000001111110000000000000001111010000000000000000000000000000000010000000000002600000000000000000101101064111103000000000001010000000000000001003000000001011110
000000000000000000000000000300000000000000013000000000430003000000000011000000400000000000000000100000003000000000300000000000000000000000000000000000000001000000000000
000300000000300000000000003300000000000000030003000000030000000000300000500000100000001000000000010000030000000000000000000030000000001000001000100000001000000000000500
000000000000300000000000033300002300000000000003001000330000010000000000000000000000001000300000000000333000000000003000000030000020000000000000000060000010002000000000
000300000000300000000000333300001116000000000003000033330000000000000000000000000000030000001000030003333000500000000040030030001111100000000030000000000000111110000000
000333333333333333333333333303016000330300330330333330300000000000333300000010000000000000000000003300333303333033335303003330000000000001300000000000000000000103330333
