000000000000000000000000000000000000001000000000000000000000000000000011000020000000040000000000000000000000000000000000000000000000000003000000000000000100030000000000
000000000000000000000000000000200000000000000000000000000000010000000000000020000000002000000000000300000000010000200300000000000000200300000030000000000005000000020600
000000000000000000000000000036600000000000100000000000300000000000000000000020000100060200000000003000100000000303600000000003010000000000000000000300000000000000600000
000000000000000000000000000006601000000000000000000001000000000000000000000660000000066000000001000000000021000006600300000001000006600300100000000005001000000000661000
000000000000000000000000000030000000000060000000000000000000000000300000000660030000366000000000000000000000000036600000600000000000600000000000000200000006000103660000
000000000000000000000000000030600000000000010000050300000000000000000000001600000360366000000000000000101000000036600000030000000006050000000000000000001000000063660000
000000000000000000000000000033333030000000004000003031600000000001000003003630010100653333300000000000000003003303330300030033333333330000003303030000060000000003333331
000000000000000000000000000000000000000030000000000000000000000003000000000000000100000000000003001000000000000000030000300000003000000000000000004100000000000003005000
002000000000020000000000000000001000000000003000330000000000000000000500010000020003000500000000000000000300000200000060000000000000000000000000000000000000000010000000
066000000000020000000000000360000300000100500000010100030000000000000300000000660000000000000000000000000000010203001300000000000000000000100000003002000000010020000000
066000000000660000000000000000013006000000000006600003000000000003000000000001100330000000000300020300000000006650100000010000000003000001000000400000000000000660000000
366000000000660000000000000000006000000030000306300000000000500000030000030303660010100000000000000000000300006600300000100000000000000000000000000000030000000060000000
366000000000660000000000000000000000010000000006600030000000000000000500000003600000003000000000000003000000006001000000000010000000000000000000000000001000000060000430
333333333333333333330003003300000000000000333333300300330000000003003333333003330133331031100100000000003330033300000000000000333333000000001030130030000030333330030000
