000000000000000000000000303000000000000000000000000000000000000000000002000000000000000003000000000100000000030000030300000000000000000000000000000000001000060030000000
300000000000000000000000003000000000003033033000000060010000300300000000533330330000000003000000300100333330003000000300300000000000100033030300000000000030333300330000
000000000000000005555500000000000033000000000000000133333033033100000030030000000000503000005000003000000013000050000000005554000010330000000000000300303300000000000000
000000000000000000000000000000000000000300000000000000000000000003000000035000000000000000310000000003000100000000000000010000030000000000000000000000000000000000300000
000000005550000000000033333005050003001000000000000300000000000000000000000000000000133030005550000000000000033003333000000000055500000010000055000500000000001000000000
333003333333000000500000000033303000000300010300000000001000000333003300000000000000000000133330005000000000050000000000000500353130000000013033340000000000000000001000
000000000000000000000000000000000000000000000000004003000000000000000000000004000000004000000000000000000600000000000000000000300000000000000003000000000010000000000000
000000000000000000000000000000000500000000000000000000000000010003000000000000000030000000001010000000000100000000000000000000000000000000000000000010303000000000000000
033000000000000003333330000033000043000001000003000000001000000330000000000006000030300010003300000000030000000033010000000000033000400000003300000300003030000100000000
000000030333333000000000000000000010003000500000001050500000000000006000050540000000000303000000003033133000505500000003003313000000050000000030000500010000300000005055
000000000000000000000000000000000000000000030003000000000000000000030000000000000000001000000000000000000000000000000400000000000000003130000000103000000000103030010010
000000000000000000000000000000000500006001003030000000000655000500000000000060333030000000000000003000006010010000000001000000000000000000000000000033333000000000000300
000000000000000000000000000000000000330033000050000100010330300000000000005000000000335003000000000000000000050300000000000060000000033300300000000000001003303030000500
000000000000000000000000000000002000000000000000030000000000011000000000000000000000030000000000000030000300000000000100000000000000030030000003000000000000006000000000
