000000000000000000000000000000000000000300000000000000060000000000000000000000000000000000000000000000000031300000000000000000000000000000000000000000000000000100001000
000000000000000000000000000000005000000000000000000000000000000000000000001000000002000000303000000300000000000000006000000000000000010000000000000001000000000000000000
000000000000000000000000000000000000000003030301000000000000000000000003030300300303033333003030330100000000000000000000010000000000000000000000000000000023033030030000
000000000000000000000000000000000000000000000000100000100000030000000000000000000000100000000000101001000000000000300000000000000000000000000300000000000100005010300030
000000000000000000000000000300000000000000000061000000030000000000000000000000000000000000000000003000000000000000000000000303000000000000030000000000000000000030000000
000000011110000000550000000011130000001000000300000000000003000111030000000000000000001000001400001200000000000000000000000000000000001055501200000001000000000000000000
000000000000000000000000000000000000000000300003300000000030000000000000033000000000001003300033003333333133000500000000410000333000000000003333033000000300003000030000
000000000000000000000000000000000000000000000000000030000100000300000000000000060000100000000000000000000000000000100000000000001000000410000000000000000000000000000000
000000000000000000000000000000000001000000003000000000000010000003000000000031065000000000006000000000000000001000000000000000300100000000000000000000000000000000000100
000000003333300000000030333304012000303333000000000000000000000000000000000000000000300000000030000000600000000003000000333300000300000533303003030000000000000000000000
000000000000000000000000000010000000000000000000000000030000000000000000000000000300000000050000000000000100000000000300000010001300030100000000430000000000000500100001
300000000000000000000000000000000000300000300000000051000000000000000300000003000010030000000000010000003600000000000100000000300000000000000000000000000000000000000050
120000000000000000000000000050000000000000120000000005000003000000000000030511200000000000001000000000000011100000100000003100100001010000000000000000000000005501010100
333333300000333330000000330033301000303000330330000300000021300030000100000004333330000000000000003000300000000000000000000033313033300003000000003333000000000000600000
