000000000000000000000000000000000000000000000100000000000000000000000000000000000000000000000000000001000000000000000000000000010000100010000000000000006000000000000000
000000000000000000000000000000000000000000000100300003000140000000000003000000000000001000010000000000000000030003000100000040000010000000010000000000301100000000000000
000000000000000000000000000000000000000000000106601000050000000000300000000000000000000000000000000060000030000000660000000000000006600000000000000006600000100000000000
000000000000000000000000000000000100000000000006600000000010300000300030000000000000000000000000006000000010000000660000000000000001000000000403000006600000000000000000
000000000000000000000000000000000001000000000000600000000000000000000003000010010000000000000000000030030001000106160000003000000046613000000000000000600030003000003000
000000000000000000000000000000000040000020000006000000000000100000000000000000000020033300200601200000000000000000360000000020000000603030003000000006600001000000000000
000000000000000000000000000000000003133333303333300000000000005001030000000003031333300333000333130000000010000030033330033330333030300000000000000003030300000001000000
000000000000000000000000000000400000000000000000000301000000000000000400000000030000000000000000000006000000000000000000000000000000000000000006100000000030000000100000
000000000000020000000000000000010001000000002000000000030000002010000050000001300000000000000000020000000000000000300000000000000003000000004000000000000000000020000000
000400000000660000000006600000000000000000006500000040500000066000010300600000000000000600000030060000000015600000003630030100000000003040001000000000400000000600000000
000000000000660000000006600010000000000500000000500000000001366300000000660200010000000000000000610000000000600000000000000000000000000000000000000000000000503003000000
030000000000660000000006600000000000000000006600000000000000006000001000660000300000000000100000660000000003600000000000101000000030003000000000000030000000002360000000
033300200000660000220006600000000500010000016000003300023003666000000000660000333002000000100000600010001036600000000000000000000000003330020000220133301000000660000000
333333333333333033333333333300000000000000333333303003333003303000000003303133330033000000003333030000001333333300000000000100000000333330336030330330333333333300001001
