000000000000000000000000000000000000030000000000000000300000000010000001300000000000000000001010030000000020100001000000000300100000000000000000000000000000000000000520
300000000000303000333000003001000003000333000020030000003000333000003000010000000000001000000000000000100000100010003300000200000000000000000000000000033000000003000010
000000000000000000000000000000030300000000000600000000000000060001000000003000000000000000100000000000000500661000002000000000103000000000000003000000000000000000000000
000000000000000000000000000001000000000000000660000000000000000000003100006030000000000000001000600005000000610000000100006600000000000330000000000000000002000000000000
000000000000000000000000000030100020000010000060004000600000000034000101500000010000000000200003000000000001060000000000006600100002200006000000002000000000000000000000
000000000000000000000000000000100000000000000600000000100003100000000000066000000000000000003000000503000000610003000001000630000000000000000000000000000000330106020100
000000000000000000000000000003333333000000003330100000000000000000000030333033033333333333033335333333333303330000000000033063333303300000003333333000500033333000000000
000000000000000000000000000000000000000000000000000000000000000000000000000000000000000000000002300000100000000000000000000003000000001000000000000000000000030000000003
000000000002000000000000000000325000000030030000000000000300005050000000000000000000000000030000333000000000003030300000000000000000000000003004033000003000000000003200
000000000066000000000000000000000030030050000010300100000000000000101000000000000000000000000000100000000000000000000000000000200000001000000000001000000300000000006600
000000000066000000000020000002003000000003300000000000000000000000000000000000000000000000100000000000000000300050001000000000000000002000000003030000000000000000006000
000000200066000000000000000000000000030000100000000000020000000000003000006000000000001030500000000010000000000000000000000000000000000000011000000000000000000000006600
000000000066000000000030000003000000003000030001300000000000000000000000000000100000000000000000203000000000000000003000300000000000000000001005000033000000000030000635
333333330333333333333333333330303330001000333333100000000000000003100033330323333333010000000100000030000000030000000000001000033033333333310000000000000033033353033033
