000000000000000000000000000000000300000000000000000000000000010000300300000000000000000000000000000000000000002000100000004000000001004000000000000030005000000000030000
300000000000000000003000003000000000003333030000015000000300000003333330000000300100300000000004003300000000003000000000360000030350030000003030003000000000000300100000
000000000000000000555000000000000000000000100000330330000000000000000000000000000000010000000060000000003000000033330300000000000000300000000000000300000000000000000000
000000000000000000000000000000000000000000000013600003000033330000000000011000000000000000000000000000000000000000000000033330010000000000000000000000000000002100000000
000000005555555550000003334065155050000000000000000000101000000000000000000000000100000000005515050000000003304600000000060000000000000000000000000055555530333000000000
330000033333003000000000033013333000000000003000000000000000000000000033030000000000410000030333000000100000033000000000000030000000033300003300000331330000003300000000
000000000000000000000000000000000000000000031000000000000000100031000100030600300000000000000000000300100000000300030000000000630000000000010000001000006000000003300003
000000000000000000000000000000000000000000000013000000000000060000000000000000300000000000000000600000000000000000000000000000000000000000000000000000000000000000300000
030000000000000033333030000030000000000030000000303000000000000000000000000300000103030000000033300010003000000000000000000031003033301000000300000000000000030000033333
000000033333300000000000000300010000000006000050500000000000000033333000003000000555000000000000400000535333333000000000000001001003000005550000000000035530310300000000
003333000000000000000000000010000000000000000000003033300050000000000000300001000000003330000000000003000030000000010000000000000000000000000003300001000000000200010030
000000000000000000000000000000000000033340500010000003000500500000300000333450150000000500000000005550000000050005106550030000100000055500003000003505000000005000030000
000000000000000000000000000033000100000131303005000000003030300000000000053300010001000000000030003330130000000033330000000330100000200000000005000300000001004030000000
000000000000000000000030000000000003200020001000005000000000000000000000000000000000000000000030000000100000000000003100000000000000003000000000000000000010000331000000
