300000000000000000000000000030100000100000000000000000000000000003030000000003001610000000000000000000000000000030000000000000000000000000010020000000000000000003000000
000000000000000000000000000000000010000000500000000000000000000000500000000000000000000000000000000000000000000000000000000000000000000000000000000000000000001000000000
000000000000000000000000000000100000000004000000044000000010010010000000000300000100000000000000000000000001000000000000000000000000000600004060003011000430000030000030
000000000000000000000000000010001000000000000000000000000100000000000300006000030053004000000001000000020310000000000000000000000000000000100000300000020000000000010000
000000000000000000000000000000100000000000004000000000000000000003000000010000000000000000000300000000000000000000000056500131000000000000000100000000300000000000003000
000000044444000000000000000000000000003010440030000000000000000020000044440001000000000050002000000000000000000000311000200000006100004044005000000000000000000000000100
000000000000200000000000000000000003303030000001000603330000000333303300103200036001000000033030333330333000000000000003300330000000000000000000333310033000000000000000
000000000000000000000000000000000000000000030010000000000000000000000000050000000000005000030010000000000400000000000000000000000100000050000000000000001000000000000000
000000000000000000000000000000000000000000001000000000000000000000000000000000000000000000010000003000000000000000000300000000000000000001000000300000000500000006000000
000000444000000000000000000000000030000000000000000000000000000000010411000000400000440000000000000000004400000000000040000000400000600000030000000000000000000000000100
000000000000000000000000002000000000001000000002004000000000020000000000000000000000000000000000000000000000000000000000000020000103000000000000000000002000000000000000
000000000000000000000000000010000000000000000040000300000000000000000003000000010000000000000001000000000010000000000003000300000000000100003000000000000000000000000000
000000000000000200000000000000000500010000003000002000000000000000000000000000000000000000000000000000300444420010000000000000000000000003000000000000000044444000000000
333333000003333333333333333306000010000001303300333333033300333003333000200000300133000001300000000030303000000033330003333313000003300000003303031333063300000200000000
