000000000000000000000000000000100301000000000000000000000050000000300001000000003000000000000000000000000000000300000040000000000006000000000000000000000000001300000000
000000000000000000000000000000000100000500000000000010000010000000000000011500000000000000060000001000530000500000010000030000003055000000000000000000000000005000060000
000000000000000000000000000000000000000000000000000000000000000000000000000000000001300000300000000050360000005000000000000603000010000000001000005000005000000000000006
000000000000000000000000000000000000000000000000000000000003400000000000000000600000000000000000000000000001000000000000000000030000000000004000031000006000000000000000
000000000033333300000000000000003000000000000030033000000303000000001001010000000000000000000000000100000000333300000000000001000000000000000000000000000000000000003003
000000000000000000000000034300000000000000000033300101000000000000500000000003000000000000000040000000010000000000000000000000000120010000430000000000034300003300000000
205500000000000000000000000003333003301403000000000000000000003330600333010032055000333033020550003003300200000010310033330030330033300000003030003011000034300030000000
000000000000000000000000000000000000000000000000000000000000300000000000000100000330000000000000000000000000000000030000005000000000000000014000000100000000000000000000
000000000005500000550000000000005001000000000000000000000000400000055000000000000000000000050000300000050000000100000000500000000055000000000000551000000000000030000000
000000000000000000000000000300000040300000000000000000000000000000000000000000000003000020000003300000000000000003500000000000000003500000000000000060000000000030000000
000000000000000000000000000000010000000000000000000000000300000000130000000000001000000010032100300000000000000000000000000000300000000000000000000000000030000000000000
000000000000000000000000000000000000000000000000000503331000000301000000033030000030000000000000000000000033000300033300000000300000003000054000000001000000000000003000
000000000002000000000000000000000030010000000060000000003000300000020000000000010000000006000000430400200000010000000000001003000000000000000000200000001000000001000000
333000333333333333003333333030300330030033205000000000000000000333333000000000333330003100300010003031303000000000000002050001333300006000003333000003000030333302025000
