000000000000000000000000000000000000000000003300060000000000000000000000010000000000001000000000030000010000010000000000330000001020000030000000003100000000010000000003
000000000000000000000000000000000005000000000000000000031300000000000300003006000000040000000000010310000000001000000000000000000000000000000001003001100000000000000000
000000000000000000000000000030000000000000000000100000330010000000003501001153000000100011000000003000300001000000001100000000000000001300000000033000000030000000000000
000000000000000000000000000000000000000000000000053133330000000000033300100300000006000000000000000005040000004000000000000106000010000100000003313000001030000000000000
000000000000000000000000000033000003000005000001300033330000000003333300000000000000000000000000003300000000000010000000006003000000000200000033300000030033000030000000
000000000000000000000000000033000000410000000006000300000000300103003000000000000000000000000000003300001000000000000000000000000000000000000130000000500030000000003000
000000000000000000000000000000333333030000000000000333030000000333033333333330000000353303300000003330330000400030330330000000000000000003003333003333033330333330000000
000000000000000000000000000000020000001000030000000000000000000000000000000000600000000000000000100000000000000000000000050000000000003000000000002000000000000000000000
000000001110000000000000000300000000000000011110000000000000000000100000000000101000100000301010000000000000300000000000000003001100001000000000000000000000003000000010
300000000000000000110000003300000000000500000000000001103000000010000000005030000001000003300000000001000000000030000100000003001000300000000000000000011003000000000000
300000000000000000000000333300000000000000000000000010003000000010005000000001000000000113300000000000000000000030000400003033000001001000000000000000600000000000000003
330000000000000000000003333300000000000000000000000010000300000100005000300000000000043333300000000000000000000033000000033333000030000030000000000000000002000000000000
330000000000000000000003003000000000010000000300000000000300000000003000000000000000303000000030300000000000000030003000030030001000000000000000005000000100000000000000
333333333333333333333333333300000000000000330333333133036333333000000000000000333303131003033330330000000006100033303633304333333033300000300010000330333300000000000000
