000000000003000000000000000050000000000031030500000000000001000000030000000000000010000000000003000000000000000000010000000000000000033030000000000000000000000020000000
000000000030300000000000000000000000100000000000000000600000000000305000000000000000000010030030000000000000000030000000000000000000000000000000300000000300000100000000
000000000000000000000000000000000000000000053010000000000000000010100000000000000000000000000600000000000000000100000000011000001010001000000000000000030000000000000000
000000000000000000000000000000000000000000000000000000000000000000000000000000000000000000000000000000200000001003000000000003000000001000000000000000000000300000000100
000000000000000000000000000000000000000000000000000000000000300000000000000000000000000000000000000000000000000000000000103000000000000000000000000001000000020000010030
000000000000000000333414000031010000000603040000000000000001110000100000003330000000000100000000000000000005003000003130000000024000010000000000000000000000000000000000
000000000000000000000000000000330300000000303330000333333043303000000000000003000003333333303000503603330000000000000003333333030010030000313303300333003630000000000000
000000000000000000000000000000000000000000000030000000000000000000000003000300000100000000000000000000000000003000000000010000000030000000000000000000030300000000300000
000000000000000000000000000000500000000000000000000000000000300000010000000000000000000000000000000100000000000000000000003000000313000000000000000000303000000000000000
000000000000000000000000000000000000030000010000000000050000000000000012000006360000002000000500000000103000000000000000003030000000000000003000000000000000000000000000
000000000000000000000000000000000000000000000100061000000020100000000000000000000000002300000000000006000000000000000000000010000000030000000000000000000000000030001000
000000000000000000000000000000000000000000000000300001000000000000000000000000000000100000000000110000000300000000000000000000000000000000000000500000000000000000000000
311100000000000000000000000031400000000000000000000000000000010111000041400000000010000033301000000100000010000000000003111000000003100000003010000000060000003334040000
333303330000033333333333333300000003000003000000000000600000000330303300000001333303004000030000030003003000000000000003300003000020033331333333000003000000000100000000
