000000000000000000000000000000000000000000000000001000000030300000000000000006000003000000000000000000000000000000000000000000000000300000000000100000000000000000400000
100000030000000000000000000300000000000000010000000004000000200300000000000030035200030000000100033000000000020300000000000000000020010030000000203000000000052000000000
000000000000000000000000000000000000000000000600000000000006000000000000000000006600000000000000003000000000100000300000000000000600000030000000000000300000066010000000
000000000000000000000000000000000000000000000100000003000006600000000050000000006600103500000000000000013000300000000000001000000660000500000000000000000004066000000300
000000000000000000000000000000010000000000000600030000000000600000030000000146006600000000000000000000000001600010000010000010300660000000033000030000000000660000000000
000000000000000000000000000000300000000000000660200000000006600000000010000000005600000000000000000000000036000000000030000000000601100000000000000000000000003020000000
000000000000000000000000000000001000000000333033000333303331330303313030000003363003000000000000002000300333300330333330000000310313300000000000000000000103013500000000
000000000000000000000000000000000003000000030000000000000000000000000000000000001000000000010000300000000000000000000003000000000000000000000000000000000000000000003000
000020000002000000000000000000000000000200000000300000000000003100000030000000000000300000003000000000000030020000030000000000000000000002000000000300000000000000000200
000660000066000002000000000000024000006400000000000000000000000000000000000003002000000660000000000000000000663030020000000000030000000066000000000050000000003010306600
000660000066000066000000000000600000006600000000000000300000100000000000000000060000000600000500000000000001060000660000000000000010000066000003000000003000630000006600
000660000066000066000000000006660000001600004000000005020000000000004000000000060000300000000000000000000003660000660000000000000050003066001301000000000000660000006600
000660200066000066000000000000060000006600000000000000000000000005000000000000066030003630000001000000000000601000660000000000000000000066030000000000000000660000036000
333333333333333333333303333333331333330333430000300000003005005000000000000003330333300313303000000003333333333033333110000000000000033333000033303000000033363033333330
