000000000000000000000000000000000000000000000003000000103000000000100001000000000030000000000000000000000000000030000300100000001001000030000000000001000000000030000500
000000000000000000000000000000000000000000000000000000000006000000000000010000000000000000000000000000000000000500000000000000030000000000400030103000000000000000002000
000000000000300000000000000000020000000000005010000000300030000000000400030000000000010000000030000113000000000300020000100000000010003000000000001100000001000000002000
000000000000000000000000000000560000000000000000000000000000000000000000000010000000003003000000003000000012001300600000000000050000030201030000013100006000000000060200
500000000000000000000000000000663000200010000004000310000000030000000000000005050000000000000000000000000100000004666001000000000000000100030000003500030000000500060000
000000000000000000000000000020660100000000030000200000000200000000000200100501000000000100000000000000200000000320600200000200000000200105030000003003153001000010066030
000000000000000000000000005030330130000000300333300000003330303333033300000500000000000030001000003010033333330330033333330303030333033303333333303000000000000003330303
000000000000000000000000000000000001010000000000000000000000000000003040000000000003000000000000000000000000200000000006000000000005050000000000000000000001000000000000
000000000000000000000000000000000000002000053030000000000000000000050000000000000000000000000000000000100000000000000000000000010000000000000000000000000000000000000000
000000000020000000000000000300001000000010000000000000030002105000003000000030000000300200000000300100000000000000000000000030000003000000000000000001000030400000000002
000000000660000000000002000300000000000000000000011230030000000000100000200030600000000600000300000000100000030000000000050000000001300136000000000000500000010060000000
000000000660000000000000000300000005000000000300000000030060000000000010000030000000006600000300000000000030000000500000000000000005000000000000000000000000001000000000
020020020660200000002000000300000000000000020020000000031066020000013000000000000000006602001000000000002000000300030000000100000360000100000000003600000000002000000102
333333333333333333333333333300010030001000033333300335333300300000000133330330030000333063300000003333133010000000010000000000000005000000000000000000015033333013331336
