000000000000000000000000000000000033000000000000000003001000000300000300000000000000000000000000000000006000000000000000000000010000000300000000000000000010005000030000
000000000000000000000000000004006000000030000000000000000030000000000000000100002000000000000020000010006000000030000000000000000000002020000010050000003000000000003000
000000000000000111031110111111100000001015100111100010000000000011103000000000011000010010100310001110000001103610000100011031000000000000000001111000000040000001101000
000000000000000111001000000000000110000005000000002111300000000011130100000001211110050000042611100000001010000100000000111001000000012110001100500000000000000000000001
000000000000000111010001100010001100000000031100010111000003003000001000000001311100001300010101010100000000101000010000111010000004000111000000000000000003000300100010
000000000000111111101111110000000100000000111411050114000000000111100000000005511110011113050111001000015111000110111000110101000000055611000000001001001100000000000005
000000000000000000000000000033310330030303000000000033200000000000000033333003031300000000013330003330133300000000300000000000600000030333003333333000000000000003330033
000000000000000000000000000000000000000000000000000000000000000000000000300000000000000000000010000000000000000003000000000000011000000000300000000000000000000000000000
000005000000000000000000200000010500000000000000005000000000050002000100000000000000000000000030500000010000000000000000000100300000000000600000000000200003000003000000
000111100000001111000001100000000000400100301103100000030000611100011100000001310000000000000011010000000000000100000001111000000000000611110111100001000000110300050000
000000000000000000011121111000000000000000031633100000003000000000000001000050031011300000010010030000000000000000001000000013000000000003000000300101001001113000000000
000000000000000100110101110000000000001000031141004000000320000001100500000000000111000000000000000000000000000000000500100110000033000000010011000101010001640300000001
000000000000000000015551110000000100000010111113100000000010000011140000000010000005000300000000000000011000000010000110000015000000000000003101100051100211111010000000
333333333333003330033333330000000000000006001050033333003033034000000000000003300033000000031303330000001333030000000303310000133330033333130000000033030000000000331300
