000000000000000000000000000000000000001000000000000000000000000001000000003000030000001000000000000000000000000000000000000000000003003060000000000000010000000000000000
000000000000000000000000000033000000010000000000301000000000000030000200000000000000000000000000030001000000000200000010000000000030000000003000000000000300000000003032
000000000000000000000000000000000000003010000003306000001000100000000030000000000010000000000000330000110001000200005000000000000003000000000000501000003300000000000002
000000000000000000000000000000000000001000000033304000000001030000026600000000000000000000000003300000000003406600000000010300001000200000600300000000043300000010000060
000000000000000000000000000000000000000000000330000000100000003000003600003001000030000300000003330003030000100600000002000000330006601000000000000000310000000000000016
000000000000000000000000000000000000000000000003000000000000000020006600030000200030000000000000300000000050000600000000000000330006600000000000000000005000003000030006
000000000000000000000000000000000000000000031030300020006330333300333300000000000000000020033303036333333330033300001000303302333600301010030000000333030300030000303300
000000000000000000000000000000000000000000006506000001600000000000000000000000000000000000000000060100000000000100000000000006000300000000000000000000000000001300030003
000000000000020000000000000300000000000003000010000000000000003000000000000000000000000000000000000000000300000000000000300000000000010000020000000000000000000000100000
000000000000020000110000003300001000000005000361006000000003033000000005100000000040000000000000000000000003000000000000000000000004300000020030000100011000000010000000
000000200000660000000000033300000000000060000000500000000021330000000100000010000000000000000000000000000000000010000000000000000033300003060000000000001000020020000000
330006600000660000000000333330000660000066000010050000000003303000000033000600000100100000033000660030004000000000000000300000000330000100660000000000000333000660300000
330006602000660000000000003003000630300066000000000000000000000000000033000660400000000020333000631000000000000000000000000000000300000000660000100000030003000600000000
333333333333333333333333030330033033333330303033300000003330000000000033333330000000000000030333030000003000000000000000000000313030333031300000000303033333336000000000
