003330000000000000000000000000000000000000000000001000000000000000000000001000000000000000000000000003306000000000000000000030000000000000000000000000000000000000000000
000000300000000000000000000000000000000000030100010000000000000000001000010001000000300000400030100000103030000000000000000040030000000000000000000000000030000001000000
000000000000000000000000000000000000100030000115010100100003000010060000000000301160000000000000000010000000200000000000000000000000000611100003000001000000011020000000
000000000000000000000000000050000010002001003000001000000000000000001000000000000100000000000000000000000000000000000000300100000000000000000000000010000000000000000000
000000000000000000000000000000000000000100010001000000000300000000000000000000000000000300000000000000000100000000000000100000000000000100000000000000000000000600000000
000000000000111000000000044000000110000000000200310200000000110000000000000010220205000040000000110100000000000230000000000240010200002201005100000000000202020003000440
000000000000000000000000000040000003333333033333333333030000330333333000000003033333000000006000000000000333333300000000106000303303330335330000000033133030030330000000
000000000000000000000000000003000000300000003034000001000600000000031000003000000000000300000000000000000003000000000001000000000010000333006000300003330010000000000000
000000000000000000000000000000000001000000000000300000000000000000000300000030000000000100001000000030020000000000000000030000000000060000010000000000000300300000000000
000110000000000000000001111000010000000033000000000000000000010000000100000000001100000000000000000001100001111000000000000300000000000000010001100000000000000000000000
000000000000000000000000000001000000000000000000000500010000000000000000000000000000030000010500000000000000000000000120000000000000000003000000030000000300000000000000
000000000000000000000000000000000000000000000000000000000000500000000000000000000000001000000000000000000000300000000000000000000000000000000000000000000000000000000000
020200000000000000002022020013000000000001000000000004401000000000044000000000002000000000000010030002000002000000000300000011000000200000000220000001000000000110060000
333333300003303333333333333300000000000330000000000000300000000100100004000010003333000000000003303030030333333300000000000000033013300000000033033000000100000000000300
