000000000000000000000000000010003000100000000000005000000000030001000000000000000000000000000000000000000000000000000000000000000000000000000001000000000000000000000000
000000000000000000000000000000010000000000200000000003000000000050000000000000000000300000000000000000000100000000000000000000005000100000000000000000000000000000000000
000000000000000000000000000000366000000000000001000000010000000001660000000000000000000000000000000000600300010002000000300000000600001006000000000000000000005000000000
000000000000000000000000000000063000000000600000010010000000000000660000001000000000030000000330600016600300000003030000002000000660000000030000000000000000000000330030
000000000000000000000000000000066000000000000000000000000000000000610000000000000000000000033333000006600000000030333000060000000000100000000000000000005000000003333300
000000000000000000000000000020060000000000006300000000000000000250060000000010020000001000033331002006000000000033300000066003200363000000000020200000000000000013303003
000000000000000000000000000033333300000000000003000000000000000333333330003000333333000300003300000330333000000033300003330033410300010300003330303000010010000000300000
000000000000000000000000000000000000000000000600000000000000300000000000000000000000000000003002006000001000000000000000000000000000000000000000000000000010000000300000
000000000000000000000000000000000000000000003500000001005000000200003100000000000000010000000000000000000000010000000000000000000000000000000000000000100000000000300000
000660000000000000000000000000000000001000000000050100003000000000100001000000000001010000000000000000000000000000000000000000000000005000330000000101000000066000003000
000660000000000002000033300001001000002001003000003000000002000033300000000000001000030001000020000000000000000000000030000000000000000000000000010000000000000000000000
000660000000000066000333330000000000066000333300000000000030000333330100000200000300010000000660000000100000000000000000000100000003000000000000000000000000060000060000
200660000202000066033333300001050100066003130300000202000066033333300000000100000000010000000600303000000002020300000000300000002020000060000000000000000020066000066033
333333333333333333333333000000030003303333330000033333333333333633000000100200000000010000033030330000000333313300000000000010333000300000000000500000000033433333330030
