000000000000000000000000000040000003000000000300000000000000100000000000006000000000000000000000000000000000000300000000000110000000000000000000020000000000000000060000
000000000000000000000000000000000000000000000000000001000000110000030000000000000001000300000001000000000000000000000000000110000000000000000000300000000000000000030000
000000000000000000000000000000000000000000500000000000000000000400300000000000000000000000000000000000000000600000000300100000000000000000060000100000000050000000000001
000000000000000000000000000000000330000000000000000000000000000000000101500000000000000000000000030001000000000000001000000000000003300000000000333000301003000000000000
000000003000033300000000000000000000300000330000000001000000000000000000000033100000030000300000001000000000000003000004006000000000000000000000013000000003010000200500
000000000000000000000000034000003000000000000000000000000000000000030000000004000000000000000000000050004000004000000000040000000000000003000000000000000000000010000000
333000000000000000000000000030300030000000005000003300300033333000000000010000000000000000000000000333031000000000000000004333303100003000003033013301000000000000030000
000000000001100000000000000000000000000000001000000301000300000000030100000000000000000010000000005000000001000000000000001000100000000000000001000000000030000030000113
000000000001100000000000000001000000000000000000000001100000000000000000000600000000000011000003000000000000000000000300000000000000030000000000000010000000000030000110
000000000000000000000000000000000000010400000000300000000000000000000000000000000000000000000000000000000030000000000000010000000006000010000000000000000000020100400300
000000000000000000333000000000000000000000010010030000001000001003000000301330000000003000000003331000000000000000300003500000000010000000000050000003000100000300000000
000000000000000000000000000000000000300001020000000000000000000000000360000000300003000000000000000000000031001000000000000000310100300000000000000000000003000030000000
000000000000000000000000000000000000000030000030100000000000000000020000000030050000000010600000000000000100000000031000000000010000600030060000340000000000000000000000
000000003333333333003333003333300300000000000000003330333300010333000330330030000000033333033330333330000000000003000300000000000000033300000000010333003300000000033303
