000000000000000000000000000000000000000000000000000000000000000000000000000000000000000000000000000000000000000000000300000000000000100000000100000000000000001000000000
000000000000000000000000000000000000000200000000000000000020000000000000000000000200001000000000000000000000000010000000000000000000000060000010000000004030000000000003
000000000000000000000000000000000000006600000000010010060001004003200000000000006600000000400001010000000000000000020000003000000000400000000000000000300300000000000005
000000000000000000000000000010000000006600000000000500300000000000000000000000006600000000000000000000000300000030010000000000000000006000000000000130000000000000030030
000000000000000000000000000040500000000600003000000500000000000000000000500000016600000000000000000000000000000000005040000000000000000050000000000000000000600000000000
000000000110000000000000000000000001006000001100000260000030000002200600010000006600000000000110000000000000000000220000300000000000000110000000000000000100110000000000
000000000000000000000000000000000503333330000000033330330043303333333500000000330333003333300000300010001000006033303330000000103000000000000000000000330300000000000000
000000000000000000000000000000210000005000000000000000000000001000000000030000000000000000100000000000000000000000510000000000000000000000000000000000000500000000000000
000020000000000000000000000000000000000100000000001000330100000000100000030305001000000000000002000000000000000000001000000000030020000000000000000000000000002000000000
000660000020000002000000000400020000000004000000000000000003000000200000000000000540000200000066001000000000200000020000000000000660000000000000000001200000066010100030
000660000000000066000000000000660000000000000030100000000000000006000000000000000000000000000060000330000006100000060020000000000660000000000066000000003000066000000000
000660000000000066000000000003360000000000000000010000000000300006610100000000000000000000300066000000000046000000010000001000000600000010000061000000000000066000000010
000660000220000066000000000000660000000000000010000000000000000001000000000000000000002200000006000000000000600000660000000000000600300000000066000000000000006000002000
333333333333333333333003333333303310030330000010000010300000000033333300030000000000133013330303330000000003330333333330000051303030000000003333000000000030331030333333
