000000000000000000000000000000600000003000000000000000000000003000000000000500000000000000000000000300000000000000000000000000000000000000000000500300000000000000300000
100000000000000000000000000000000000000000000001110000000000000000000000000000000030000000000000000000000000000000030001000000000005000000000000400000000001300100000000
000000000000000000000000000000303600000000000003000000000000000000005000013300000000000000000000000000000000003000000000000000000060000000000000000000000000000000000000
000000000000000000000000000000030000000000000041000001000300000000000003033000000200000000000001000300000000300001000030050300000020000010000030000000020010010000000005
000000000000000000000000000000333000000000000604000000000330000000000000400000006000063030600000100300000003000303000000000000000000000000000000000000000000006000300300
000000000000000000000010005503330000100055000660000000000000000001000001300000006601000000000000000300020003116030000000000000200000000000010000000200000001016000300000
000000000000000000000200000003033002000000003333306000003333033000000000333330033330000000000003003303333330003333333060000000160303300000300000000330333300330003333333
000000000000000000000030000000000000000000030000000000000000000000000000000000000000000000000000000000000000000000000000000000003000001000000000000000000000000000000030
000000000000000000000000000000006000000000000000000604000000000000000000000101000400000001010000000200000000000000000000000000000000000000000000001000000000000000000001
000000000000000000330000000003000100300000000000000001000000000000000060000000000000000000000000000600000060001030400004000000000000000003110000000000133000000001000000
000020000002000003300030000000600000010003330000000002000000100000300000002303000000000000000000100000200000030030002000000000000000003023000000000110330000050000000350
000000000066000033300030000000000000010000030600000000000000000000000001000000000010003010000000500006600300000030066000000100000000000333304000003003131000030000003000
200000000066000333300030000010000003500000030000020000000100000000000020000000010000000000500000000006000200300000066100100055000000003303000010000033330000000000100005
330333300333333333333333333300000000000010033330333030332000000000000600001330000030210000000003000033333330333300033031000000000300003333030000060333303300300002000000
