000000000000000000000000000000000000000000000001000001000000000000100000000000000000000005000500000000000000000000000000000000001300000000000000001000000000300000000000
000000000000000000000000000003000000030000000500000000000000000000000000010000000000000000000000000000000000000003000000000000000000000300000000005000000000000000000000
000000000000000000000000000000010000000600000000030111013001000000000000000006600000000000100111000000000000000000101000000600000000006000006600000000010000000000000000
000000000000000000000000000000000000300000000010000000000000000000000140300006606000040000000000000000000000300000000000000000000050066000006600000000000000000000003000
000000000000000000000000000000000000000000000000000000003000000000000000000006000000001000000000000000200000000000000000000000000020066000000000000000003000006000006000
000000000000000000000444000010000000003000200000012003000201301000020000000206000000000000056000002100000000002002000000000020000000061000006600000000000000010200000000
000000000000000000000000000000000000000000300333003330000033000006003003303333033363100000033333003000333003330333330003003633000331333303000333033000000006000330000000
000000000000000000000000000003000005000000000000000000000000000000010000000000000000000000000000000000000001000000000000000000000000100100003000000001300000000000000000
000000000000000000000000000000000000000000000000000000000000000000000010000000000300000000000300000000000315000000000000000010003000000300000000000000300000000000000000
000000000000006600000001110030000000000010030001066000030004000004000000000000000100660000000000000000000000000000000000000000000006000003000000100000010000101000000000
000000000000006600000000000000200000000010000000060000000000030000000000100000000000660000010001000000000000000000000003001000001000001000000000000000000000000000000000
000000000002006600000000000000000000000000000000066000000000000000020000000003100000660000000100300100000000000000000000050000000000000000000000100000020000002000100000
000002020000006600000020000000000200000000440000016000010000000200000040400006010005660001514400000000400000000000000000400000000000000000010000000200000002000004040000
333333330033333333333333330033333630001001000600103003330001000300330300100010020000033000000000000000100000000001000001000000000000000000031000000100333030333000000000
