000000000000000000000003003000000300030030000000010000050300330000000000000500000000000000000000000000001000003000000000030030000000000000300000311003003000000000000010
310000003000300000030000101061000000001010000000000000030000000300000031300000000000000000000000030000100300101600000000001010010000003000303000000010101000000000300000
300000030000040000001111111000600001020010000020000600010111011000020030000000000100000020030000043050000001111000002000111002000000030000006000000100141100001000030203
000000000000000000000000000001000000000000000663000000000000000000060000000000200003000660000000300000000000000000066000001000000000000001300000005000000400000000036600
000000000000000000000000000000010300000000010660000000000000000000000105000000100300000660000000000000100600000000066500000000020000000000000000000000000000000100006100
000000000000000000000000000000000000000601000060000000000000000300600000000000000000000060000000000000000000000500306000000000000000000000000000000000000002000000006603
000000000000000000000000000000333330000000033000103100000000000033333000000003003333033333000000000300330000000003333300000000000000000000003033330000000000333333333033
000000000000000000000000000000000040000000000000000000000000000000000000010000000000000000000000001000000000000000000000000000000000000001000000000000000000000030000000
000000000000000000000000000003000000600010110000000000006300030000000000300002000000310000000000000000030030000000000000003000000300000000000300000000000000000000100020
000000000002000000200000000030000040000000300000000002003000004000060400000010000000300103001000000000001000000000000400000000100520000000001002004000000000000010000000
000000000066000000000020000000060000200000000000000000000000000001050000000000000000000000000000000500000000001000000000000600100000030000300000000120000000006300020000
000000000066000000000030000000000003300300000130000000000000000000000000000000000000000000000000005303000000000000000500000000000100000001000000000031000000000000000100
000000000066000000000000000000000000000000030000000100100000000600000000000050000000000000000000000000300030000100000010000000000000000000000000000030000000000000000000
333333333333333333333330333300010003300333000000003033300000000333333300006003333330000000013323330000000633330230031333300303330030310030000000310330300300000000000000
