000000000000000000000000000001200000000060000000000000000000001000000010000000000400000000000000000000110000100000005000000003300003000000000000000000000000506000000000
000000000000000000000000000040000000030050000000000000000000000000000000000100000000000000000000000000000600000000000000001000300000010000000000000000000000000001000000
000000000000000000000000000000001000001100000000010003000300000000100066000001000000660000000000000006000000000010000000000000000000300000000000000000000000000100000000
000000000000000000000000000001000000001000000000000000000310000000004066000100000030660001001000000000000000000000000000010000000000300000000000000000000000050000005050
000000000000000000000000000000000000000000001000000010000000000000000066000010001000060000010660030000000000000000000000000000000010000000000000003006600600000001000000
000000014000001111000000000001010000004000340000000000001400100000050066000010000000600000000060000010000101000000000000000000100000014000001400000006600300000000100000
000000000000000000000000000031000003103303000000000013000000000333303303313531000000030013333030330000000000003033333000000000000000000000000000000333000300000000013000
000000000000000000000000000000000000000000000000000000000000000600000000000000000000000000100000010000000001000030010000000000000403010000000000000000501003000000000000
000000000000000000000000000000000000000000003100000000000000000110000010000000000000000000100000000000000005030000000000000000000001100000000000000000000000005000000000
000110011100006600000000000011100000600000000010010001000000000000000011100000000000300003011000000000000000000000010000600300000000000010000001100660000010000000000000
000000000000006600000000200050000001000300000200000000000000300000000100000000002000000000000100030000000030100000000006000000000000003030000000000661000000300000000000
000000000000006600000006600300000000000000006600300000000000000000000000300000006003030003000003000000000000000000000006600000000000000660030000100600000010000000000000
000000000000006600000006600300000000020000006600300005001011000000000000034000006003000000000300000000000130000000000006500000000000000660030000000663000000000001000000
333333333333003333333333330331333003333300331300300000040030000000000003333003300303000000003333003333330010300030033033333330000000033333013301103303330330333000000000
