000000000000000000000000000001000000000000000000000000500000000000000000000000000000010300000000030000100000000000000500000000000006000000000000000500000000000005000000
000000000000000000000000000000000000010000300550000000000000000060010000000000003000000010000000000002000000000000000000000000000000000000000000003000000000030000000000
000000000000000000000000000000000000000000200130010006000030100003400000000000000000000010001030000006000000000100000000000000000000000000000000000000000000003000000000
000000000000000000000000000000000000000000000000310000000000400000100000000000006000000300000001000060000000000000000003000000000060000000000000000000000000000003000000
000000000000000000000000000000000000000000000000000005000110000000000000000000000000000000003000000000300000000000000000000000000000000000030006000030000000000000000000
000000000000000000000000000010000300000000000000040100004000300000000000000000000000000000000030300066000200330000000000000003000000000000000000000000060000000000000000
000000000000000000000000000033033300000000333303300000000330333000000000500000000000333333001000003333333000000000000000000000000000033330330030300000301000000040000060
000000000000000000000000000000010000000000000000000000000000100000000000000001000010000000000000000000030000010000000000000000000000000000000030100000000000000000000300
000550000000000002000000000303000000010000000200001000000002000000000000355000000000000550100000036000000000050000055000000000000000300120300000000000000000005510002000
200140100000000066000000000000000000000000006600400000000066000000003000014011000100000140100003000000000000000020014010000000000000000660000100000000000000114010060000
000000000000000066000000000001000000000000006610000000000066000000000000000000000300050000000000000000000000003000000030000000000000000660000000010000000000000005016000
000000000000000066000000000000500000000000006650003000000006000000000000000000000000000000000000000000000000000300000000060000000000000660000000000003000000503000066003
000000000000000066000000000000003000000000000600000000000063000000000000000000000000000000000000000000000000000000000000000000010060000660001001001000010003000000036000
333333333333333333333003330000000030033300333033300000001333330003031013300010000000330333000033010000000000000003330000000000003330033300333033303000000033330333330030
