000000000000000000000000000000030000000001000000000000403000000001000000000000000000000000000000000300300040000000000000000000000000050000003000000000006000000000000000
000000000000000000000000000000000006000200000600000000000000000000020000000000000000000300001000300060400000000000000000000000000000000030000000000000000000000000000000
000000000000000000000000000000000000200030000003000002000000000100000060000000000330000300020000000000040000000002000000010000000000000000000000330020001000000000000001
000000000000000000000000000000000001000002031000000000000000000000000000010000300000000000100000000001000000000000000000000000040000000000000300330100000200011000000300
000000000000000000000000000050000000000001030030000000000000000000000000010000330300000030000000001000000005000066000000000000000000000000000330300600000000000410000300
000000000000000000000000000000000006150000033033400000000000300000000030000002330000000000000002000000000003030066003000000000000000000000002330030000000000002200000000
000000000000000000000000000000000000333333330333400000003030033000000000050003330303000000033333330000000030003333310000000000004000000010003333333333333303303330030000
000000000000000000000000000000003000000000000000000000000000000000100000000000010000000040000000001001000000000000100000001000000000000000003000001000000000000001000000
000000000000000000000000000000000000300000000000000000000063000000000030000000000000000000000500000000000000000000000000000000000000000000000010000000000000000000000300
020000020000000000330000000001000000053601000000020000002000003010000000103001000000600000000000000000330026000000000002000000000100000003300001010000010010000000000000
100000200000000330330000000000000000000000000010000000000000050100000200000000000000003300300000000330030100000200000000001000060000003303300000005030000001000000000100
660000000000000330300003000000000000000100003000040010000100000660101000000100000300000000000000020300300661000000300000000003000000001303000030000000000000600300010030
660000000002202330330000030000000000000000000030005002210000220660000000000000000001000000000000002330030660000100000000010120000001000000300000300000000000000000000000
333333333333333333333333003300010000000000333003330030300330103303333300000000000000030300000000000330333330033300000000333333303000333033333033033000000000006000000000
