000000000000000000000000300000000300000000001000000000000000000000300000530000000000000000000000000000000000000000000000000000000000000000000010000000000000000000000003
000000000000000000000000000000001000000000000000000000000000000000000300000000000300000000000000000000010600000000000000000000000000100030000000000000000000300000000000
000000000000000000000000000000000000030010131000061000030000331000000000000000000000110000300001000000000016033110000030000323300000000005000000332000000000000000000020
000000000000000000000000000000000006000030000000000000000000000000300000000003000000000000030000000100000000010000000000000000000000000000000100000000000000000000000000
000000000000000000000000000000000100000000200000000000000000000300000000000000000300000000000000003003000000000000000000000000000000000600000030000000600130000000000050
000000000000000000250233000000000000000000000000001060000000000020020023300000000000000010000000003221200000000000000000000000000000000000000000000000025032012000000000
000000000000000000000000000000000000000100000000333310003033030300333300000000000300333000000000003033333333333333330063330333500000000000003330333000003003330330000000
000000000000000000000000000000030000000000000000000000300000000000000000000000000000060300000130000000000000000000000000000000000300000000000003000000000000000000000000
000000000000000000000000000010000000000000000000000001000003000000000010000000000013000000300000000001000000000000000000000000100000000000000010000003000000010000000000
000000000003311100003030000000003310000001001000000000000300000110000000000000000003000000000000000000000050000000000010000010000101000000000000000000000000000000010003
000000000000000000000000000005000000000000100000000000000000030000000010000000300000000000000300000000000000000000000000000000000000000000000000000000000030000000000000
300000000000000000000000000000000000000000000000000000000000001000000000000000001000600000000001000000000001000031000000000000000000000000000000030000001000000000000006
322120000000000000000000000000000003006000001005032212000005000000000000000000000250000000023300000300250000000032212000000000233130000000006300000000003010000030000000
333333333333333330000000000001313300000010000000003330030000600330000000000000000000000000000000000010000000000030030030005000000100000000000000000000000000300000100000
