000000000000000000000000000000000000000000000000000000000000000000000000000000001000000000000000100000000000000000000000000010000000000000000000000000000000001000000000
000000000000000000000000000000010000000100000000000000000000003300000000033000000000000000000000000100000030000000000000000000000000000000000100000000000000000050000000
000000000000000000000000000044001000000003010000003000002400000200000000000000000000000000002000004000000000000000000000200010030000100000000000000000000000100000000000
000000000000000000000000000000000010004000000000000200000031000000000000000000001000000300066000000000000000000006000006630000003000000000000000000010000000000300001000
000000000000000000000000000000000000000000300005000000000000000000000000000100000004000000060000200000000000000300000036000000000000000000000000000030000300000000000000
010000000000000000000000000000202200000000000000321003000023020000100000000001100000000000266000000020020000000600160066600000000000000000032200000000000100000000000300
000000000000000000000000000031303000000000003313333333330303333000000000000000000005000000035000533033303003333300303330300033000000000100003333033000303300000030000000
000000000000000000000000000000000000000000000000600000300000000000000000000000000000000000000000000000060000000000000000000300000000000000000000000300130000000000000000
000000000000000000000000000000300030010050030000000000000000000000000310000000000000000000000000000000000000000000000110000000000000030000000000000000000000000000000000
440000000000000200000000000002000000000300000000000000000200000000000000000000000000000000000300000030000000000000010000000000000000044000000200000100010004030000000000
000000000000006600000000000066000000001030300000000000006600000000000100040000000000000000000000000000000000000000000000000300000000000000006000000030000000003000000030
000000000000006600000000000366030000000000350000003000006600000000000000000000000003000000030000000000100000000000000000000000000000000000006300000000000000000300000003
002022022000006600000000000666000030003000010000000000001000000500000000000060000006200000000000000000000000000000000002200000000100000202000600300000000600202230000000
333333333333333333333003333333101300000300000000003300003303330330333300000010035333300333300000000000000000000030000003003303000000433335303333030000000033303330000000
