000000000000000000000000033000000000000000000000000000000000000000000000000000000000000000000003300000000000000000000010000000000000001000000000000000000000000000000000
300000000000000000000000000000000003000000000000300000000000100000000003000000300000000000005000000000000030000000000100000000000000030000000010000000100000000000100100
000000000000000000000000000000000000000000000000033333000000030000300000000003303301000000000000000333333000000000000000005333000000000000003000000003000003003100000000
000000000000000000000000000000000000000600300000000100000000000000000003000000000000000000000010000000000000000030002000000000000000000000100000000000000000000000001000
000000005555550050000005555010500000000000000020000000000000000000000001000000000001000000000505501000030000003000500000000000055555500000030550555005000000100003000000
000000033333300000000030333300000000000000000000000000000000000000000000000000000000000000033000330000100000000004600000000000333303000000603033330000000000060000000000
000000000000000000000000000000000000000000000000000000000000000000000000010000000000000003000050000001000000020000000000001000001000000000000000000300000000000000530000
000000000000000000000000000000000000000030600000000000300303000000000000000000001310000000000100000000000000000000000003000000000033003000000000006030033000100000000000
000000000000000000003030000000000000000000030000000000000000000000000000000030030003300000300000000100003000000000000030300000000000000100000000000000000003000000000003
000033333333300000000000000000000000000300000000000000000001000000033300100000001000035000000003330000000000001000300000000000000000003333000000333000000000004000000000
000000000000000000000000000000000000000000000000000000000010000000000000000000000001000000000000000000000100000000000100030000000000000000000000000000000000000000000003
000000000000000000000000000005505550000000000000003055000550530000000000000000055500000000000030000000000055555500000000050000005555000000100000000005555300000000003000
000000000000000000000000000030333300000000000005000033031333330010000000000000002333000000001000000000000103030000500000000000030303300000000000000030333300000000000000
000000000000000000000000000000000000010010030000005000000000000000000000000050000100040000000000000000000000000000003000000003000000000000000001000001000000010000000000
