000000000000000000000000000000000000000000001010000000000000100000010000000000003000000000000000000000000000000000000000000000000003300600000000000000000000000000000000
000000000000000000000000000000000004000000000000100000004000000600000000000000000000000301000600034000000000600040000000000001000000000000000300000000000000000004000000
000000000030111100111111111100000004140000000111101110111101040003034105000011111111110011300000114141040000000000000010003011000000011001100000001110000130000054140040
000000000000100100001110000000000000000000000110311000000000000030110000000501000000110400000010000000010600000000000000001010000000000001010100000033000100003000010300
000000000000301100101111000103000000000000001116001100010000000003110000000001110001110010100111110000000000000000000000000030002001011001110000000100010110000000000000
000000000000011000001111100000000000000001000000511110000000101000000001000101001000000000100000053001001000003000500000000000004000011000000000000100000103500000000031
000000000000000000000000000000000003333033030333300000003333303333330333333030000001000000033333333300303000000033333031000000400000000000003303133000000030000000030030
000000000000000000100000000000000000000000000003000030000000000000030000000000000000000000000000000000000000000000006000000000100000000000002000000000100000100000000000
000005000000000000000400000000000500000000000000000300000000101000000000000000030300000000000000500000050000000000000000000050000000040000000000000000005000000000000000
000000000000010000111414104065000001130000000301110000010000000110001100030110000050000004100000110000000101111100100000000000100111101011401110301000000000301110003001
000000000000000001100000000000000000100601000001000000001000000000000100000100000000000000000000100000000110300000011000000000110000000006001100000000030100011000000010
000000000000000011100000000000000100000101040000000000010000000110000100000000000000001000000000000000300111000100001000000000011000100000000100001000000060100000000030
000000000000000000005000000100000051000001000000100000030000000100000100000011000000000000003001000000000110100303000000000000311120000005000001000000000010003000000001
333333333333333333333333333330003330000000000000033333333110333000000000000000300000303333300000003330333000000031333133333033060000033013330000300303313330303330000000
