000000000000000000000000000000000000000000500000000000000100000000100000000003000000000100000000000000000000000000031000000000000000000000000000000000000000000000002000
000000000000000000000000000001000000000010000000000000000110000000010300003000001111000003011100000000000000000000000001010000000111100000001110000060000000000000000000
300000000000000000000000000000153100000000330500000030000300000005600030000000000000003300000030000000000001110000100100000000000030000000000010000000000003300000011010
000000000000000000000000000000400000000000000000000000100000000000001000000000330000000010000000000000000000000000001000000000330000000000000003040000000033000000000000
000000000000000000000000000010000000000000000000000000043000330000050000500000000000000000000000000000300000000000000000006000000000000000000000000000000300200000300001
030004414100000000000000000003100000003000030004400000000000000141001003000440010000030004000000000000000000000000103000003000030000000000000000000003000000000000000000
000000000000000000000000000033133300000000000000000000010003300000000000010003333003000000033333531000000303330303333330330531333333300000003333500100000003333303330303
000000000000000000000000000030000000000060000000001000000000000000000000000033001000000000000000050000000000000000000000000003000000000001000000000000010000000000000000
000000000000000001111111000010030000001011000000000000000300600000000000000000000000000000000000003000001000110100030000000000000000000000000000000000111100000000003000
033000000111100000000000000000000000005000033000000000000000000001111003000100000000000000003300003000005000000030000000330000000000000000000003000060000000000003100200
330000000000003300000000000000000003000000330000000000000600100020030033010000000000000000030000000000001330000000000003000000000000000100000000000330000020000000000000
300000000000000000000000000000010000000000300000030000000300000000000030000000000000000000030000030000000000000000000003000000000000000000003000000000000000000000000000
000000000000000000000000000000000000000000600030014100000000000000000000000000000003141000000000000000000000300000000400000030050000014110001010100000000000000000330044
333333333333333333333333333333133300033300303333300000000000000333033353333300000000000000033330330100000600333300000003033303000000000000000001000330333300050000000000
