000000000000000000000000000000000306000000000333305000000000000000000000300000003000005050000303100050001000303000000000003333000000000000003300000000000050000000000000
000000000000000000000000000000000000000000003333000000000000000500000000000004005000000000300000000000000003333000006000033330000001000000005000000500000000500000000000
000000000000000000000000000000000000101000033330303000000000000000000002300000001001000330300000000000000130013006010000333300601300601000000000000000000000000001330000
000000000000000000000000000001000000066005333303300000000006000000000000000000000000300000000000000000000333330300001003333001000000300000000000020000000000000000000000
000000000000000000000000000000000000060000003333300003000366030200010300001000003000000000000000000000000030333300000003303333600000000000000000000000000000000000000000
000000000000000000000000003001100000066000333333300000015060060000003300000000000000001000000050000010030601330300000003333333101000000000000000000000003301000000110000
000000000000000000000000033300000000331300130333303333033303300003333000000000000000003000030000000001303330333300000101303333000000000000003333302033300300000000000000
000000000000000000000000333300000000000000000000003000000000000000000000002010003630000000000000000000000000000000300010000000000000001000000000001101010300000001000000
000000000000005000000003333000003000000000502010000300000013000000000010000000033030000000000000005000030000000050000000000000300000300000000000000003053000100300000010
000000000020000000000033333300003000000000000060000003000000000000000000003000333333000200000000000000000000030000000000002000000010000000000002000033333300000000000000
000000000660000000000333333316000000000001000000000000000000000000000003000003353303000300000001000000000006000300000000066000000001000000000066006033313000000000000000
000000000660000000003333333300000000000000000000000300000000000000000000000003333330006601000000600000003000000000030030066100000000000000000066000303303330000000000000
000000000660000000033333333300005000000030000003300005000000000000003000000063033303006100000000010300033000000000000000066000000003000000000010000303335300000000000030
333333333333000333333333333300000000100333003330300000003303333000430000000000333333333010300031000333310306333303330331003300000003303031003303300330332300000000010333
