000300000000000000000000000000000030000000004001000030010000000000000000000000000000000000000000000000000060000000000000000000000000000000000000050000000030000000000000
000000000000000000000000000000000000000000000000000000003000000001000000000000000000000000000000000000000000000000000000003000000000010000000003000000001301000000030000
000000000000000000000000000050010000010000000000000000000003001303000000000000000000000000001000050010000000000003000000000300000005031000000000000000000000000000000000
000000000000000000000000000000000000000000000000000040010000030000000000300000060050000000006000000000000001030006600000000000000000000000033060000000000000000000001000
000000000000000000000000000000000000000000000010000000000000000001000000000000660000100000006100000000000000000006600000010000000001000000000663000000002000000000000000
000000000000000000000000000000000000000020003002230600000000000000001000020200603000000000006000003000022000300006600000000020010000020000220060000000000000000000000000
000000000000000000000000000030330033330303033333300000000000000000000013333030313033000000030330333333303000000033330333333333000000003033033330033000000033030030000000
000000000000000000000000000000000000300006000003000000000000000000300000000360000000000300001100000000000000000000000300000010000000100010000003000000000000030300100000
000000000000000000000000000000000000000000030000000000000000030000000000004000000000030000060000000000000000000050000000000000000000006000000000000000300000000000000000
000000000000000000000000000000000000001000000000000000000000000000003010000000000000000000003000000000000000010000000000330000000000300000010000100000000000000000010000
066000000000000000000000000000000400033000000000036300000000000000000000001000000000000031000000200000000000000060000030000000000000001000000000000000000000000000000001
066000000000000000000000000000000000000000000000100000000000000000001000000003000000000000100000000000060000000000000000000003000000000000000100000030000000000000000000
066000020000220000020000202000000003000000000000000600002000022000000000000100010000000000060000000000021000262000100001000020000000003000000000000000000020000220002020
333303333333333333333333333300160000000000100000333330333330303000000000000603303333000000000010003013333303303000000003033033010003000000001000000000000003333303333303
