000000000000000000000000000000003000030100000000003000030001000000000000000000000100000010000000000000000005000000001000000000003001000000000000000000000000000000503000
000000000000000000000000000000000000000000000000000000000000000100005000001000005503000550030000050100000000010000055000000000000000100000001000000000000000000000030000
000000000000000000000000000000000030001100000000000000000000000001000000000000001100001110000000500000000000010000011000000000000200010000001000000000000000000000040000
000000000000000000000000000000000000000100000000000000000000000000000000000000000000000000000000000030000006000000000005000100106600002000000060000500000003000000050300
000000000000000000000000000000000000530000000050000000004000000300060100001000000000000003020000000000000000000000500000000000006600000000000000000006000000000000000000
000000000000011000000011444003000400000000100000000000010000000000000100140000000000000003000000010000000011400000000000000001006160301101000114440000010110000005000020
000000000000000000000000000013330303003333003000000000000000000100000000006003003033330033330333030000000000000033333030000000333303300000000000000000000000000003313033
000010000000000000000000000000000030003000000000000000000000000000100000000000306000010000000000000000000100000000000000000000000003010000010000000100500000001000010000
000550000000000000000000000000000000000050000000100000000000000000010000000000030000000000000000000000000000003000300000000000000000000000000000006000000000050000000000
000110000000000002000444400000020000000000044400000000000444000000200030000000000003000020000020003000000300000000600000000000404400000100000002000000001000011000000000
000000000000000066000000000000660600100000050000000000000000000306000000000100000000000000000060000000005000000000000000000000000200000001000066060301000300003000003000
000000000000000066000000000000661000000060000000005000000010000006000000000000000000000000300660000000000020000000000000000000000000000000010066300000000000000002100030
000000000000000066000500002000663000000440500002000000000000020016600010000003000000100000000660025000003000000006000000000000500302000010000060000000006000000000300000
333333333333333333333333333330330330030000333330301000003033333033303300000003333333000000030303333303333000000030000000303035333333300000000330333333303330033003000300
