000000000000000000000000000000000000000000000000000000000000000000000103000000000000000000000000000000060000003000010000000000000000000000300000003000000000011000000000
000000000000000000000000000000010000000000000000000100000000000000000000000000000000000000000000000000000000000000030000000000000000006100000000000000000000000000000000
000000000000000000000000000000060000000000100000000000000000000000100000000000000000000300000000000200000000000000030000000000000020000000000100000003000000130000000000
000000000000000000000000000000000000000000000000000503000040000000000000000000000000000000010000000000000000000000000000000000000002000000000000100100000000000003000001
000000000000000000000000000000000000006000000000000000000000000000000300000000000000000003000000000000000000100100030000000000000000000030000000003000060000000003006000
000000000000000000000000000000000000000100000010005000200300000000000020030020000100000000000000000000000000030000000003003000200200201003000000000000002000000000000005
000000000000000000000000000000030000000000333033303303330000000030000053330300000000000005000000000140000000030303333300030000333331003333010001000303030333333330040000
000000000000000000000000000000000000060000000600000010000000000100300000000000000000000000000150000000000000001300000000000010000000500000002000000000000000000000000003
000000000000000000000000000000003000000000000000000000000000000000000100000000000000000000000000000000010000000000000001000000110000000000000000010000000000110000500000
000000000000000003000000000000030000000000000000010000000000000010000000000000003000000000000000400000000000000100010000060400000000000100000000000000010000000000500000
000000000000000000000000000000000000000000100000000000000000020000000000100300000000000000000010000000000000000000000000000000000000005000000000000000000000030000040000
000000000000000003000000000000065030003000000003000025000000000000000000000000133000000000043000100000000000000000000000000000000000000000000000500000001000000010300060
000000020020020000000000002000050003000001000200220000000000000300002300000000000000000002000010000040000200300000000000000000000000000000000003030300200200000000001000
333333333333333333333333333313303130000000333303100100000010000330033333331303303333330333333333331333033333333300000000000000330300300000000000000334033334333306000000
