000000000000000000000000000000000000000000000000000010000000000000000000000000010000000000000000000000000004000000000000000000000000100000330000000430000000000000000000
000000000000000000000000000000000000000000000000010030000000000000000000000300000003300000000000000000000000000000000000063000000000000001000000000000000000000000000000
000000000000000000000000000003000000000000000000000000000000000000030000000000000000000000004400440000000400000310000003000000044443400100000000000010000000000000000300
000000000000000000000000000000000000000300000000000000000000010000000000000000010000000000000000000000000000030000000310000001000000000000000010003000000000000000000000
000000000000000000000000000000000000000000000003000000003000002000000000000060000000300000000000000004000000000000000000100000300000030000001000000000000000000000100000
000000044444004000000000000000016000000000400000002000210000060444440000000004000006303000200010004444400000002000000004440400000001030000003000000444440000000004000000
000000000000000000000000000033330000000000000000033333033333103300000000003000000000330333333033330000000333333000000000000000033303300300333330333000100000510000600000
000000000000000000000000000000000000000000000000000000000003000000000000000000000000000000005000000000000000000000000001000000000500001000000000000000000001001000000000
000000000000000000000000000000000000300000100000000100000000100000000003000000000000000000000000000000000000000005000000000200000000000000010000000000000000000100000000
000000004444444000000000000000000000444344000000000100000244044000000000000000000000000000000000000000300000300040030000000000000000010001000440440050030040000000000000
000000000000000000000000000010000000001000000000001100000000000000000300000000000300000301000000600000000000060000000000000000000000000000300000000000000000000000000000
300000000000000000000000000000000000000000300000000010000000000000000010000041000000003000000000000000000300000000600001000000500000000000000030000003000000000000000000
300000000000000200020000000000000000000000000000063440000000100000000002000200000000000000040000000000000000000002000300000000000000000000300000000000003002000200001600
333333333333333333333333330000000003330130303133300000000333333000000033330330300000000000000000000000000333330033003330333600000000000000023333333033330033333330000000
