000000000000300000000000000000000000000000000000300000060000000030000010050000600000000000000600001000000000000000000000000030000000000000000000030010000000030000000000
000000000000000000000000000000000000001100000000030000300000000000000000000000000000010500000000000600030010000100000000000000000000300000000050000000100300000000003000
000000000000000000000000000000001003446000000000000030000100000000500010000004400000055500000000000000010000000010103000000000440000060000300000000000000000006000155000
000000000000000000000000000000060000001000000000000000000002000300100000000000000000000000000000000000100000200000100000000000000000600020000300000000200000000000000100
000000000000000000000000000000000000010000000000000000000000000000000000000010000000000000000100003000002000000000000000101000000000000000000000000000000000000000300000
111110000000000000000000000040000000002255000000030111006030000030000000010000000255000000200000000021022200000000000010001000000223100030000000000000000011101000000003
000000000000000000000000000033333333330333000000001000000333333331303004000003331333003333300000001330033303330333000000000050033303333333330000000306353000000003333333
000000000000000000000000000000000300000000000100000000010000010001000003000300000000060000000000306000000000006000000000000000001000030000000100000000000000000000000000
000000000000000000000000000000000000003000000000000103100030000000000000000000000030300000000000010000000000000000000000030000000000000000000000330000000040000000000030
444000000000000555000000000000000000000100000000105550000000000100010000000000000000000000001000000440000000500000005010000000000000005550000440000000000000000100000003
000000000020000000000000000000000000100000000000000000000000000000000000010000000000000000030000000005000000000001000000000000000000000000000000000000000000001000000100
000000000000000000000000000000000000000010000000300000000000000000000000000150010000000000000000000000030000000033000000000050000000000001000000003000000000010003000000
000225500000000000000002202200000000022022000001000000000012002311110000000000000000000000000000000002055101111000220020000000101110000000000002255001001000220220003000
333333333333333333333333333360000003303303000000033333303333333000100000000000000000000000000000000333030000000003300330100300000000033103033330033000000033330330100000
