303130000000000000000000000300000000000000003030030000030000010000000330313000000000000000000000003051300000000000000000001003000000000311000000010000000000000303031300
000000000000000000000000000000005000000130003300000000000000000000000000000000000000000000000000000000000000000000000001000000000000000000100000000300000000000000000300
000000000000000000000000000010110100300000000000000000000100110000000000000005000010000031100000000000000001111000000000000000000000000000010000000010000000013000000000
000000000000000000000000000000000030000100000000000000000000100000000000000000100000000000000000000000000001003000000100000000033300000000000000000000003000000000300000
000000000000000000000000000000000000300000000000030000010000600000000000000000600000000300003000000000000000000000000500000000100000000000000105000000000000000000050300
000000000000111000011110111101200100000000000000011010100030002010111130000000100000000000203022000000430021000003312001101111100000100001001000011030220000110000000300
000000000000000000000000000033333000303600000000000000000303033000000300000033100300333333636333330000003333330033333330000000000000000000000000300343313333333000000000
000000000000000000000000000000000000000000000000000000010300000001000301000000000000000200000000030005000000000002000000000000300300000000000000300000000000000000000003
000000000000000000000000000000000000000000000000000010000000000000000000000000000100300000050100000000003000000000000000000000000000100000000503000000000001000004000000
000000000000000000111101111000000000000000500000000001000000000000000010011500000000000000000001000001003001000011131100000000000000000000110000000000330000000110000000
000000000000000000000000000000000000000000000000000000000000000600000300050000000000000001000030000000000000000600000100000000000000000000050000000000000001000000000000
000000000000000000000000000000000000000000000000000000000000000000000000030000030006000000000000300000000100000000000000100000000000000000000000000000000000000000000000
030220000000000000002022000010100100302250000001100000020000110030220002200000030012000000011001110000011030001102201000000000000001100000020000011010130000030021001011
333333333000003333333333330000000003033333000000003300000600004303303336353000000000331000000000000000000010000030311003300000000000033333330000000330000033000030000003
