000000000000000000000000000000000000000100000000000000000000030000000030000100000000000000000000000000000030010000060000000300000001000000000000000000000005000000000000
000000000000000000000000000000100000000000000000000000000000300000000000000000200000000000000300010000000000000000000000000000330003000000000000000000000000000006500000
111111010000005000011111000011110005000011010110011300000000000111000000000000000303000000030000001000000500001100000000010110300000011000000000000011100000000100030000
000000000000000000000000000000000000000000000000000000000000000001001000030301000000000000000000000000001000000000000000010000000000000000000000000000000000001000000000
000000000000000000000000000000000000005000000030531000000000000000000040000000000000001000060000000000001000000001000000000000600300000000000000000000000000000000000000
000000050000000000000000000000000000000330100000000000000600000000000060000000006000100000063000005000000000000010000300000000000000000000001000000000000000000000000000
000000000000000000000000000031330330000400000000000000033333303000000030331003000000333330333333300000000000000003030030000000333300300000000010000333333300000003333333
000001000000000000000000000003000100000000000000000000000000000000000010000001310030000000060000000004000000000000100000000300000050000000000000000000000300000000000000
000000000000000000000000000000000010000000000000000000000000000100000000000000301000003005000010000000000000000030000001300000000000000000000000001000000300000000000000
300000011110000000000000000033000000000000000010100000005000011130100011011105000000161000000110000000000110111000000001101000110000050000310000000303000010100001111110
000000000000000002000000000000000000000000100200000101000000000000000060000000002000005000000000010000000000000003020010000000000000004000000002100000000000000000040000
600000000000000000000000000060000000000000000000000000000000000000003000300000000000000000000000000000000000000000000000000000002005000000000000000600000000000000000000
600000000000000000000000000060050005000000020000000003000600000000000030000000000000000000000300000000000050000000000000000000500030000160003003001600000000000000000000
333333333333333333333333333333303300000000033003330333300000000303003300000003333033100000030330333330330000000033333333333033000000000000003003313303333302100000000000
