000100300000000000000000000000000010001003000000000000000000050100103000000000000000000000000000000003000000000000000000020000000100300000000000000000000001000000000000
000000000000000000000000000000300600000060000000040000000000001000000000000000000000000000000000000000000010000100000300000000000000000000000000000000010010040000000000
500000000000000000000000000000111010100000000005000300000000000100111100000010000000300000000003001010110000000010111010000000500000000000000000000101111100000000000001
000000000000000000000000000100000000030000000000000030006010000000010000000010000000100000000030020000000000000000000000000001000600000000000006002000003000000000000000
000000000000000000000000000100000000000000000000000000010000000000000010000010000006000000100000630000000000000000006000000001000030006000000000066000000000000000000000
000000000000000000000000044400000000000000030006000030200500300000005500004440000000000004400000600000000000000000101000000004000000000100000000066010100000000203000001
000000000000000000000000000003333330000010000000033003033000330333003000000000003000000000033033330303303003000030330330000300000200000000000330033333333033033306130336
000000000000000000000000000000000000000000000000000000000030000000000000000000001003000000000010330000000000000000000000000000000000000000000000100100000000000000001005
000000000000000000000000000000400000000000000000000000300000000000000000000000001103000000000000010000000000000000000000000000030300000103000050000000001000010000000000
000000000000000000001101111100000000000001000000000003000000100000000000003005000000000000150004000000050006000000000300060000000000000000010000000000000000000005000003
000000200000000000000000000000000020000000100000000000000000000000000200000000000000000000000000000003000000000001001300060000000000200000000030001000000002000000000000
000006600000000000000000000000000600000003000000100000000000000000006600000040000000000000003000000010000002000000000000001000000006600000000000001000000000000000000100
000006600000200000000000000000003001000000030644000000000000000000000610000000000000000000000000000000020000000000000000000020250006000000000000440000030000000100310000
333333333033333333333333333330333310333133000000000000000010003331330330031330000000030003310100003303330000040010400006003033363333000333331000000000000000000000000000
