000000000000000000000000000000000000000000001000003000000400033000000100000000000550000000000000000000000000000000000000000000000000000300000000100000000000000000000000
000000000000000000000000000000000500000000010000000000000000000000000000000000000000000000300000000000000000000010000010000000000000300000000010000000000010000030000000
000000000000000000000000000000000000000000020011000000000001100000000000000000000000000030000000000000000020310002001000000000000000000030000000030020030000000000000000
000000000000000000000000000000000000000000660100000000066600000000000000006000030000000000000000000030000600000066000000000030000000000000000000000660010500030000000000
000000000000000000000000000000000000000000000000001000006600000000001000000000000006000000000000303000000660000066000000000100000000000000000300000610000000000000000000
011000000444000000000000000000424000000000662020000000006620100000000002100000100000000000001600000000010361020066202000002000000000000000013000100660000002020000002000
000000000000000000000000000000002003303333333333333333030033130000000030303030000000233003300000003031333333333133030333300330100000000000000003010333331333333303333333
000000000000000000000000000000000000000006033000100000000000000001000000100004000000000000001000000000000000000003030300000000000000000000000000000000000000000000100000
000000000000000000000000000000000000000100300000000000000000100000000000010000000010300000000000000000000000000000000000000000000000000000000000000001000000000000110000
000000000000000000000020010000000000000000003000000000000000000100003030000000000000000030600000000000000010000000000000000030000000000000060000000000000000000000000000
000000000000000000000660000010000000000000000000000000000000001000010000000000000300000000000000000001300000000000001000300300030000000000000000000000000000000000000000
000000000000000000000660000000000000000000000000300000000000005003000000003000000000001000000000201000000000000000030005000000000000000000000000000000000000000000000000
000200000000000202000662020021300010002000000000000000000002000003020000000000040000120200000000000003410011000000000100044000020001001010000004000001000000000010000000
333333333333333333333333333300000103333333000650100000303033333000010030313030000000130033000000000000000001000033330330000000303300300000000000000000000020000003330033
