000000000000000000000000003000000000000600000003000000000000000000000000000000000000100000005000300000000000000000000001000000000000000000000030000000000000000000000000
000000000000000000000000000000000000000000000100000000001000000000000000000000000000000000000000000000000001000050000000000000000000000000000000000030000050000000000000
000000000000000000000000000000000000000001430000002000000000000000000000000200300000000036000000000000000000000000000000000000004000030000000000001000000000000000000003
000000000000000000000000000000000000000000000000000000000000000020003000000000000000020003000100000000000000000000000000200000000000301000000600000000000040000300000000
000000000000000000000000000010000000000000000050000000300010000660000000000000000000663000000000000000005000000005000000600000000004001000000010000300000020000000000500
041100000000000000000000000000001000000000003000204310000000000001000000000000000000660000000000002022200000100200030000000000000000000150000001000000000000000000000010
000000000000000000000000000000000000000013000333300000000030300303333300000000000000033333300000001333333000031300000303303333303030000000000000000000300000105000000000
000000000000000000000000000000000000000000000104000000000001030000000000000000000000000010010000000000000000000000000011000030020000000000000000000000000000000000000003
000000000000000000000000000020000000000000300000001000000000330000000000000000000000000000110000000000000000000000000200000010000000030000000000000000000000000003003100
000000000000000000000000000000000030000000000000001001000103000000056000000006603000005000000000001000000000000000100000000001000010000000000003000000000000000000000000
000000000000000000000020000000000330000000000000002000030000000004000000000000000100000000030000000000000001000000000000000000000000300000000000000020000000000000000000
000000000000000000000660000013000000000000000036060000000300000000000300000300000000000000000000000000001001000000000000000300000000000000350000000660000000010000000005
000000000000022022200660000000000000000000202220066000310000000001000113110002022200000000000000003000000000100104110000000000000000220202000020200600005000000000000030
333330000033333333333333333333333300030000033333333033330000000000303300600000333330000000033003000000000000000000005000000000000303033303333003033333503333333000003033
