000000000000000000000000000000000005000100000000000060000000000000000000000000000000000000000000000000000000061000000010000000000010000000000000000000001000020000000000
000000000000000000000000000000000001003030000000503000000000000000000000000000000000000000000000000010000000000000000000005000000000000000000000030000000000000000000000
000000000000000000000000000000000000000330000001000000000310000000010000100000000000100001000000000000000000000010100010000031030000000004000000100000001000303000300000
000000000000000000000000000051566000003330300010000000003300000001600000000000000100000060000000000010030000000000000000003330013000000040000046600001000600004000300000
000000000000000000000000000000060000030300003000000006030000103000630000000000000000000660000066000000100005000000000100033000030000010026000000600000000100003000300000
000000000000000000000030000020566000000330000000000360000300000200600000000000000004200600030460100100000035060000100000330300030005000066002006601000000000000000000000
000000000000000000000200000033303033033303000303033333330010333300333011010000000000333030333303330010000200001001000003303333333313300330303333333020010030000000333330
000000000000000000000000000000000000000351001000000000400000000000001000001000000000403000000000000010103000000000010400100000000000000000010000010000000000030000000000
000000000000000000000000000000000000000000000000000000000000001000000000000000000000000001100060000005000100000000003000000000000000000000000000000000000000000000000000
000020000000000000330030000000000000300000000000000000000000331000000000000000000000000000000000100000000000033000000000001200000000001000000000330000000000000000000050
000660000000000003330030000000000000300000000000000030000000300011000000000000000000000000000000010000003000340500000000000600000000000001000503330000000000000000000000
000660000066000033300030000000000000000300000000000003200033300000610000000100020000000000003000000000000003030000000000000000000500000000120033300000010000066000000000
200660000066000333300030000000000010000000030000000000000310300000600000000000300000000000003000000000000133030003000002006600001000000000000333305030050000066300500000
333333333333333333333333333300000000033330200000000000003303303330330300000002000000010000003313330005000313330300000003333330000000000000003303333200000000133030000000
