000000000000000000000000000000000000000000000003100000000360000003000000000000000000005000001000000000000000000001000300000100000000000000000100000000040000030030000000
000000000000000000000000000000000000000000000510050100000010003101000010100000000010000000000000000000000000000000100000000100000000000001000000000000000000106000000100
500000000000000000000000000000100000000000000011001000311060033000003330000305000000000303003100000000110000003300000013300100010010000000100001000000000011000333300000
000000000000000000000000000010000000000000001000000000300000300000003300001000000500000003000000000000000000230300000003300010000000000003000000000000000000500333300000
000000000000000000000000000000000000000000300004000033330000333000303300000000000040000033300000003000006000033000000003300000000000030000000003000000000000033303300005
000000000000000001111000000000060000001111300000002301330033333033133303000400000000023033000011113000000010003300001003630000000000030303000000111600000002333333300000
000000000000000000000000000000300003050000330333333303333033330333030300010000100000533030300000003333333333033300000003033030000000033333330000000000000030033033303330
000000000000000000000000000000000000000000001000000000000000006000000000000000000000100000300000030000000000000000000000000000000003000000000003060000100000000000000000
000010000100000000100000000300000000000050000000000000000000100000000000000000500100003300000000000000106000000000100000000000000000300000000000000000000000010030100000
330000000000330000110000003300000000000000330000000000330300000000010000000000000010500000000000003300003000000000000335000000000053300000010000300300500000000330000110
330000000000330000000000033300000000000000300000030006333300000000000300000000000000000000000001003300000000000000000030000030200003300000000000000050000000003030000000
330000000033333000000000333300000011000000330000000033330300000000000000000003001000000300003000003300000000300000033330000000000133000000000000000000000100060303000000
333000002333333000000003333300000000000000333000000033001030004000011100000003010000000040000000500330000000003302033333000100003013300011110000000600000000330333000000
333333333333333333333333333300000000030000303033303301333333333000000000000003033303000000000000003000330000030033303330200001001303300000300000000000000033333313130303
