000200000000000000000000000010100030015600000000000000000000000000000000020300000000000030000010000000000000200000000000002000000000001100000000000000000003020100000000
000000000000000000000000000000000000000000600300001000000061000400000000000000010000000000000000230100000000030000000000020000000001000000000000000000000000000000000000
000000000000000000000000000030300000000000003300030000000000006300000000000300000000000000033303000000000000100030000000000000000106600500000020030000006600003000001010
000000000000000000000000000001000000000000000000033000000000060330000000000000003004000000030000003300000000000033160000000005005006600000000000000000006000000103000000
000000000000000000000000000040100100000000000000033000000000066000000000000000000000000500000000003300030000000033000000000010000000130000000000001000006600030003300010
000144400000000000000000000000000100000000000144400161000000060030000000014440005000000001000001003300000000144433000000001444100016600000000000000000006003114443363000
000000000000000000000000000033303330000000006000000000300330333000000300000000004000000000003333300000013000000000000030000000033333300000000000000333130300000000010000
000000000000000000000000000000000000131000000000000000000060000000001000000000000000035000000000000000300000000000020010000000000020300000000000000000600000000005000000
000000000000000000000000000000003000000000000000000000000000000000000000000000000300300001000000000000000050000000000000000000000000000000000000001000001010000010000000
333300000000003000000000006600000000000000000006600000003033000100000000000000000300000000000000660003000300000000001003000000000000033030000000000033300000000000000050
000000000003003300000000006600006000000000000006000003000005000000000000000150000300000000000000660000000000130000006000000300300000300000100000010000000000300000000300
000000000333303300000000006611100000000003011006000330300000100000000110000000600300000000000000060000000000333000000000030330001000000030030000000000000000000000005330
000000000333003300000000006600010000030000000000600333000000000000000000000330033000000000300000600020000003000000601000033301000000000000100001000010000005000000063300
333333333330000000003333333310001000000000333333033330003300303000000000100003333000053000000323300000000333330000001000300000100100030300300000000303033000006303333000
