000000000000000000000000000000000000000000000100000010000000000000100000000000003000000000000030000030000100000000001000010000000000000000000000000010030000001000000000
000000000000000000000000000001030000000000000000000000000000000030000000040000003000000000003300000000000000000000000000000000000000000000000005000000000003000000000002
000000000000000000000000000000020001000000010000000000000000300000000000000003300003000000013330300000000000210100000000000500060100000000000002000030000030004600000000
000000000000000000000000000050660003000000000200300000000030005050000000001103313003000003003330030000000006600000000000002000100030000300300061000000000500000000200000
000000000000000000000000000000610000000004000033300000000000000000000000000003333003000000033300000000000106600000000000000033030000000060010060000010000000001002000000
000000000000400000000000000000660000000040000033300010110000030000003000001003303003000000013330030000000000002000000000000333000000000000400066020000000000000500000040
000000000000000000000000000033333030000000333313300000000000000130000000000003330003333330033010030000000333333100000000000320000000000000000333103000000033303330600000
000000000000000000000000300000060000000300000001000000000000000300000000000000000001001000000100000000050000000000300300003030300100001001000000000000001001000000000060
000000000000000000000003300000330000000030000000030000000000000000000100000000000060000000000000000000000000000000000000030000000000000000600000000000000000000000013000
000040000020000000000333300301130030000000000040500000000002100040030000000000000300000003050000000000000000000000000003333103000006000004001003000000000000000003333003
000000000660000002003333300300033030000000000000000050000060000000000000020011000000000050000020000300000000000000360000330000001000000000000050000000001300000003333000
000000000660000000033333300333330035000000000010000300000066000000000000000330100031010000000000300000000000006000660033333003000000000000000340000100000300000003003000
000000000660200000333333300310330030001000000000000000000066020000000000001330000000000000010000310000340000000000630200333003100000000040000000000001033300000030330000
333333333333333333333333000300300000000000103033300000003330330001000003333033333030000000030301200400000000003013303033330003000000033333330000000300330303000003333013
