000000000000000000000000000000000000001000000000000000000000000000000005000000000000010000000010000000000000000000000000000000000000003000000000000000000000000000000000
000000000000000000000000000000000000000000000010100010100000000000000001000000000000000000000000000000002000000000000000000002000000000000000010000000200200030060010030
000000000000000000000000000000000000010000000106000000000000000000530000000000000000600000000000000000006000006000000000000166000010000300000000000000000600030000000000
000000000000000000000000000010000001010000000006600000000000000050000000000010000000000000000000300000066000000000001000100060000000000000030000000010006600000000000000
000000000000000000000000000002000000000000000003600000000000000000000030000000000000010000000000000000066000006000300000000006000000000000000000000000006000000031000000
000000000000000000000000000010000000030000002016600000040001001000200000000000010000000000000000000020066000010000000000000066003003000000000000001002006620000000000300
000000000000000000000000000033133030000000333333300100003330330333333010000000000000001000000000003033303000000000000000033330330303333303330333033333333300333301000000
000000000000000000000000000000000000000000000000000000000000100000000000000060000000000000100000000000000001000004000000003600000020000030000000000000000000000000000000
200000000000020000000000000000000000000030000000000000000000002000000020000000000000000030000400002003600000010000000002000000000000000006030000301010000000000002000030
000000000000660000000000000000010050000000000000000000000000066300000000000000001000010000000000003000000000001000000000000000000000000000010000000000000000000000000300
003000000000660000000000000000300000000000060000000000000000066000000000300000000000000000000000000030000000000000000000030000000000000000000000000000006000000000030000
033000000000660000000000000003300000130000003000000000000000066000000000000000030000000000060000000300000000000000000000300100000000000000000000000000000000000000330000
033300000200660000000000200003310000006000000005000000001020066101000003330004000000000200000000000333000000000000006300330000600000000000003000000000000006330303033000
333333333333333333333333333333303330000000000006030333030333003000000033303330000033333330333030333333313000000000000003010303003000000000000000000000000000600003303333
