000000000000000000000000000000000000000000000000005000000000000000000000000000060000000000000000000000000000003333333300000000100000000000000000000000003300003003000000
000000000000000000000000000100010000003000306000000000000000000000000000010000000001000000300000000003000000000000000000000001000030000000000000001000000000000020000000
000000000000000000000000000000054000000000000000000000060000000000000000000100020000001000000003000000000000000000000000000000000010000000000000000000000000100000003000
000000000000000000000000000000000000000030000100000000000300000000000050000000000000000000000000000000000010000000000000361000000000000000000000000000000000000000003000
000000000000002000000000000030000002600000000000003000000000000100000000000100000000000000020000000000000030000000000000100000000000000000000000000030000010000000000000
333330000000000000000000000000000003000000000000003000000000000010100000000000000000000000000000000000000030000000100000000000000031300000000000000030000000000003333100
000000000000000000000000000000033300000000000000000000000033331000000000000000000030000000000000000033303000300401010000000100001000000303030000000010000000333300000000
000000000000333333330000000000000000000000000000030333310004000000001000000330303130103333000003000000300030000000000100000300000000000000030000000000000032333300000000
000030000000000000000000000000003000000001300000000300000000300000021000000000500000004000300000000000000000030000000000030000000000000000030000000060000000000000030000
000000000000000000000000000000000000000000000000010000030000010000001000000000000000000000000000000000000020000000300000036000000100000000000610000000000100000000000003
000000000000000000000000000000000000000000000000000100100000000000003000000030000000000000000100000000000000000000000000001000000000000000000003000000200000000000000000
000000003000000000000000000000000100000000000000000000001000000000000006000000000000000000000000001000000000000003300000000000200000000030010001000200000000000000600001
000030303000000000000000000001003030000010333300000000000500300333330003000000000000000000010000003033300000031300000003033300000000000000000001000000000000001000003306
000000000000000000000003333300000000000000000100003000001000000000003003000000000000000010000000000004100000006000000000000000000000000000000061000000300000003000000000
