300000000000000000000000000000000000010000000000030000000000000000000030000300000030303000000000000000000000033000000003001000000000000000000000000000000000000000000000
000000000000000000000000000000000001001000000000012000000000000110000103000300600300010000000000100000010000000000001000000060110000020000030000000000030000000000200000
000000000000000000000000000013100000000000001000031111000000000000000000000000111030000000003000000003000000000000000000000000000000000035000000000000003000000001101100
000000000000000000000000000000030000002000000000000000000000100000200000000000100000000003000000000000000000000000000000000000000200000030000000000100010000003000000010
000000000000000000000000000000033000040004000000000000000000000000000043000000000000000100003001000000003000000000000000300000000500000033000300000000000000010600000000
000000014140000000000000000000033000002103000000000030000000000000203004140000000000000000003200000000300001400000000000300000000200000003000000000000000000000400000000
000000000000000000000000000033300303333133100000033333330000000133033000000003333633000000003033300000000000000100000003030303033043333333333033313000000000000001300333
000000000000000000000000000000000001050000000000000000000000000300000000000300000000101001103000000000000000000000000003000000000060000000000000000001000030000000000004
000000002000000000010110000000000100000000000000500000000000000000010000000101000000110000300000000210000000000000000002000000020000000003001000000000000000000000500000
000300011111000300000000000003000000010030001000000003000005000000000003000000000000000000000000300111100030000000000000000000111110001000000000000010000000050000003000
000300000000000000000000200000000010000000000000000000000000000000000000000000003000000201000000000000000000000000000010000000000000000000000002000000000000000030003060
000330000000000300000000000000000000000000000000000010000003001000030003000000000302000200001030000000000000000000003000000000300001000000000000000000000003000000003300
000330000000000300000000200000040600000000000000014040000000000000000003000000003300000200000030000400010000000414040000000000000000000000000002030141000000000030000300
333333333333333333333333333333333030000000000000003000000000050000100000330533203303330003331333133303330060000000000000000000300000300001003333133010000000000003333331
