000000000000000000000000000000001000000000000000000000600000000100000000000000000000000100000000000001000000000000000000000000030040000000000000000200000010300033300000
000000000000000000001000000000000000000001000000000000000000001000000030330000000000000000000030003333000005305000000003033000003000000001300000000030000100330003100000
000060000000000005500000000000001031000503000020000006000005100000000000030000000600000060000000000000000000006300030000000000330000300000000000003000503000000003300000
000066000000000000000000000000003330000000000000000006600000500300001000000000000000050060000000000000003000033300000000000000400311000000000000033000000000000000000000
000066000000000000000000000060063331000000000000600006600000000300000000035000000600030000000000030000000001033030000000000000030000000000000001333300000000100000000100
300033333000055000000000000003033335000000330000003003300000000000300000003003000330300000330000051000001500303103003003300010000000600000000003103510000000000000000100
050000000000000000000000000030333330000000000000005000000000000000600003033330500000050000000000000003333333003310000000000133000013300000000003303000000000033300000033
330000000000000000000000000000000001303000000100030000013000300000100003000003000000003000033000000000000000000000000000000000000000000003000000000010000000000000001030
000000000000003333000000000003000000000300000000033300000000000000101100000030300050000000100001000001000000000010000043000001000000000000330000030000000000000000000000
330000000000000000000000000300500003330000000000000000003300000000000000000000000000003550533033000100000600000000055000001000000060000000000000000000060000100000000000
000000000000000000000000033300000000000030000000003000000000000301000030000000051330000000000000010060000000050000100010000333000066000000000000000000006000000000000600
000000000000000000000000033300000000000000000000000050020000001000000000000000000333000000000000010000000000000000030000000330300060000000000010000000006000000000305100
000000000033300000000000333300005000000040003006000000000000000330000100033300003333000300000000010001000010333050000000003303000003300033300000000300003000033303000005
000003333333000003333333333333333000000003000000300033330003033000000003333300333133100000100000330000000013630000000003303303050000031333000010000050000031013000000000
