000000000000000000000000000000000000000000000000000000000001000000004000300000000000000000000000000001000000001000000000000000000000300000300000000000000001000000000000
000000000000000000000000000001000000000030000000000000000050300000000000000060000001000000000000000030000000000000000000300200000300001000000003000000000000000000200000
000000000000000000000000000000000000440000000000000000000060000000000000010000000000000100600000000000000000000000000010000000000003044000000000000000000004400004400000
000000000000000000000000000000000400000000000060000603000003010003000000000000000000000000000000000000000000000000000000000000000000000000100000001500000000000030000000
000000000000000000000000000000000000100003000000030000010010000000000000000000000000000000000000000000000000000000000000000000000000000000001000100040000000000000000000
111000044400000000000000000002000000030000000003044100000000000510000000000000200030000000102020000000000444003044400060110000000000000000000212000000003000000000010000
000000000000000000000000000033300033030300010010005000000000300000000003333033003330000000033300333333333000050000000000006000001030032330333333033000000003033003333033
000000000000000000000000000000010003000000000000000001000300000000000010000030000000010100000000000000000000000000000003000003000000000000000000100301000000000000000001
000000000000000000000000000000000000000000000000000300000001000010000300030000000000000030000003000000000000000300000000000000000000003000050000060010050000000000000000
044000044000000000000000000000000000000000000000004000000000000034006004000003100000000000004400004000000000003000000000100000044000000000000000300000000010000000300010
000000000000000000000000000000000000030000000030000000000000000000000300001000000000000000000000000000000000000300000000000010000000000000003000000000000000000000000000
000000000000000000000000000030000000000003003000003000000105000000000000000000000000000000000000000000000000000000001160400000000000000000030030000000000000000000003000
000000000000000202000000000011103000000006001000010000003010300000000000030000000000000300000001000000000111000002000010000000000000001000000003030404010201100000000000
333333033333333333333333333300000003013300100000031033030000100333303031333330000000000000030001003033330000000000033340000000333030033333333330030000000000010330000300
