000000000000000000000000000000000000000030000000100000030000000000003000000000000000001000000010000000000000000000000000600051000031000060000000000000000300000001005000
000000000000000000003000000300000000001130010000000000000000003000000000000000000000000000000400033000000000000300030030005555000000000001000000003000000000130030000060
000000000000000000000000000000003000000010000000000000000040000000303000000000000000020300000000000003000000000000000001000000000100000030000000000000000000000000040001
000000000000000000000000000000010100000010000000000000000000100000000000000000000300106000000000000023014000000000000000000000001000000103000000000000000000000000000001
000000000000000000000000000000000000000001000000001000000000000000000000000000000000000000000000000002000000000000000000001000600000000000000000000000000000000000000101
000000300000000000000000000000000000003033000000000000030000000000303300000030000000000006300000000500010000000000000000000010000000000000004000000000600000000000000010
005033000000000000000000000000300003333332000050000503300100000300031301503300000000000000000000003333313000000000000001333301000000003330030030003030000000000000000000
300000000000000000000000003000000003000000400000000000001300000000000300001300030000100000000000000060600000000030000000000000000000300000400000000000003400000000000030
000000000055553000000000003000600130300000000055030000000000000000555500000033000030000000030050050000010000103000000000000000000000000100000000000000001030000000005505
000000000000000003000000003003000000000000000000004030000000000004000000000000003003300030000000001000010000003000000000001040500000000000300000600003003000330000000000
000000000000000023004000000000000000000000000000000230040000000000000005000100020004000000000000000000000000000000000000000000000300001000010000000000000000210040000000
000000000000000000000000000000000000000050000600030000000000000000000000000010000000000000000000010000000000000000000000100000001005000000000000003000000000000000000000
000000000000000000000000303300000000030003000000000030000050000400000000000003000000000010000005000010003030303300000000000000000000300030033000001000303300000000000000
030000033333003333303333333300000000300000030331033030030350000533300000000001333043031001033033000050330063333303000000000000000033033330060050320333333333333033303000
