000000000000000000000000000000600000000100000000000000000600000002000050000000001004000000000000300000030000000000000000000000000000001000000300000000000001000000300001
000000000000000000000000000000000500000000100500000300300000000030000000000000300000001000000000010030010300000000000030000000050000000001000000000000300000000000000000
000000000000000000000000000001000000030000000000000000000000000050000100000000001000000000400000000005110100000000000000000110000000000000000000010040000000000000100100
000000000000000000000000000000000000000000000100000000003003000000000000000000000000000000000000000000000000305000000010000000030000000000000000000060000001000000001000
000000000000000000000000000000000000000300000000300005000000000000000000000030040000000000001000010000000100000000000000000000000000000000000000000000030000000000000000
000000000111110000000000000000000000010000001010031000020000000101111100000040661000000000000000002000000000000000000002000000000000036111112000000000000000000100000000
000000000000000000000000000033030030000000000000033003360000000000000000031003330003500000000000203335133000000000060000033333000000030000003003333000000030033330000030
000000000000000000000000000000030000001000000000000000000000000000000000000011000000100060010000000000100000000300000000000000000000000000000010000002000000000000000000
000000000000000000000000000001000000100300000000000000000000000000000000000000000001030000000000000000000000000100000000300300000000500004000000000000010001000000000010
000000000001100000000000000000000000000500030000000000060300010300010300000000000000000030000004000000004300000000000000400030000000000400000000000000000001000600000300
000000000000000000000000000000000000000000000001000003000030000000000000000000100000000000110000001000000000000310000000000000000004000000000000100000000000000000000000
000000000000000000000006600000000000000002000600100000000000000000000000000001060000000000300352000000000006600000600000006000000000000000000200000006000000000000000000
000000220000000000000006600020000000000000006600000000002001000000000000000020000000000000200000000001011020001304000000000002000000000000000011111006600005031020000000
333333333333333333333333333333333310000000003333000000001303030303333002333030000000303033333303300000000333330330333331333033333333000001000000000033330303333330001000
