000000000000000000000000000000000000000000000000000000000000000000000000000003000000000000000000000000000000000300003500010004000000000000000000003000000000000000000000
000000000000000000000000000040000000000000300000051000000000000000000000000031000000300000000000010030005000000000000003000000300000030000010000000300000000000000000000
000000000000000000000000000000000000000000030000000030013400000000000000000303000000000100000000300011000000000000000000000033000000030300001000000000002000000000003000
000000000000000000000000000000100300000000000000000000000000000000000000003330000006000000000030000000010000000000000010000333000000000000000000000000000030000000000000
000000000000000000000000000000001000300000300003000000000000003000000000000333003000300000000000000000000000000000000000030003000000030000100000000000000000500000000000
000000000041000000000001111100000000030000300002010000000000001000000020000363010220300022000000000000000000000000111110000030000000030002203000000300000010000033010011
000000000000000000000000000033300035000000033330302000000000000333330330333333333333033333303010003333033000001000000000303333333033331333301000000000000033333330003000
003300000000003000000000000000000000000002003000000000030000000001006000030000300000000000100000030030000003300000000100000003001000300300000030000003300030360000003000
003300000000033000000000000000000500006003003300000000000000000000000000030000010000000000300000010000000000000000000000000006000000100330000000000003000030000000000003
003300000000333000000000000000000000000033000000000000000000000000000000333003000000000301300000000000000003000000000000050000000000000333000060000000100030000000000033
033330000003333000000000000000000010000003033330300000300000000000010003303000000030000033300000000000000013330000000000000000000000003133000000000003310030000000000303
333330000000333000000000000000000001000033330000000001000010000000000033333400000000000000100000000000000313330300000000040000000000113333000000000333330031000000000003
333330000000333000220000000000110110000003333030100041000000010000000033333000001111000003300011000011111033330000010000000300000400033333010013000333330000000200100003
333300033333333333333333333300000003333303033010003000000000000000000030300000000000303333300033000000000303300000003000005000000000031330000000000303300033031633033333
