000000000000000000000000000010000000002600000006000000000000000005001000000005000500000000010000000000000000000000000001000000003000000000000000000000000010000000000000
000000000100000000000000000000000300000000000010000010000010000000000000100000000000001000000000030000000010001000030000000000000000000000000000000013000000000000010001
000011111110155000001001111000333000000000000000000331101111015001111000001010010000000000000310000000000031111000000000000000000111000333000500000000004000000031030005
000000000000000000000000000003330000000013000000000000000000000000000000000000000000000000000030000000000003000000000031000000000000003330050000003001000040000000000000
000000000000000000000000000033333000000000000000001000000000000300030300000000001000005000033030000000000000000000000030000000000000033330000003003000000000000000000003
000000000000000000000000000033300000100003000000300000000000001000000000300000001000300000003030000000003000000000000030000010030000030310000004003000000000000030000000
000000000000000000000000000033303333033313003313300000000000000000000000000003033323303003303333330330003000000033333333301333000000003330313300303303333300303030000000
000000000000000000000000000000010000020000000000000300000010000000000000000000100000000000000000010000050000000000000000060000000000005000000000100000000003000000000000
000000000000000000000000000000000000000000000000000100000000000000000000000000000000000000000030000010000000000000003000030013000000103100000000000000000050000030000000
000000000000000033300000000050000010001010000000011100150000010500500000363000000000000000050120011110015001013150000010005000000011101110150100111503000010111100030300
000000300000000333000000000000000020050000000000000030000030301000000103330000000003000000300000000000003000000000000000000000000300000000000000000000030000000000333000
000000300000003333000000000000000000000030000000000000000000000100003033230003010000000000300001000000000000000000104000000000000000000000000000600000010003002003306000
000000300000033333000000000000210000000003000050000000000000003001000633330003000000000001300003000000000000000000000010000003000150000000034000000000601000000003333000
333333303333333333333333333300045000000000333033300000000333330001000033331033033300033133300000000000500000100000000010300330002000000000001000100000000010003003303313
