000030000000000000000000000000003000000000001000000000000000300001000000003000000000000000000300000000000000030000000100601000000000000003000010000500000000000000006000
000000000000000000000000000000000000300000000005100610000000030000000030030000000003050000001000000000000000000001000000005000000030000000000040000000000000000010010000
000000000000000000000000000000300000200000001000000000000000000000000002000000001000000000000000003110211000000000000000011116020000000000000230100000003000000000300001
000000000000000000000000000030000000600000000001000000000000000500000066000000000000001000000030000000000000501000010000030000360000000000000600000000000000000000300000
000000000000000000000000000003003306600040060000000000030000000000100060041000100300000000000000000300000000000000050000000000660000000000000600000300000300000000000000
001111111100000000000000000000111116602000011030000000000011011000000066020000000000000000001100000000000001111100000000000000600200300101116602000000000601100000000000
000000000000000000000000000000000003333333000000000300003060000000000003030300000000000000000000003031033000036000010003030330330333310000003030333360033000000030000000
000000000030000000000000000000000000500000000000005000000000000000030000000300033000000050003000000003000000003000000000003000000000010000000003000000000000003000000000
000000000000000000000000000000000000030000000600100000003000000000000000000000000000350000000000000000000000000000560000000000000000000000000000000030000040000000000000
011011110010000200000000000000060000000000000130001401110000003030010001101111000000000000600100501003000020000000010001001000000000000000001000000001010100000000000000
000000000000006600000000000000400030006000000000000000000000000000000300000000000030000000050000000000000060000000000003000000000000100000000000000000000000100100001005
000000000000006600000000000300000030000000000003001000000000000000000300000000000000000000000000030000020060000000000040006000300000000000006000500003000000010003000000
000000000020006602000000000600000060000000000200000100001010000000004500000003002000000500000000060030000600000300000000001003111002000000000000400000000000101100000000
333333303333333333333333333333333330000000030333330333333000000030333100333301333300000300003303330333333333333033333330333330000000000000000332031333333300000100000000
