000000000000000000000000000000333300000002100010000000000000000000000000030000000000000010000000000000000000000000330300000500000100000000000030000000000000000100060000
000000000000000000000000000003333030000000100000000005100000000000000000000000000000000000000000000000000000000003333000000600000000000000000000000000100000000001000000
000000000000000000000000000033333000000000000002030000000000000000000000100000000000000000000000000000000000000000333000030000000000000000000000000000101000000000000103
000000000000000000000000000030203000060300000000300000002000000000000000000500000000000600003000000001000000000103330300000000000000100003030000003000000000000013000000
000000000000000000000000000000333000000000002033300000400000000000300000000001000333000000100000000000300000000030000000000000000000000000330000100000033000000000000060
000000000000000000000000000033333130000300000033310000000000000200000000000000000330000021000010000000000003000030333000000000030002000003330000020000033320000000000000
000000000000000000000003330033330330000000330630100000060033000033033300000013300001331303000333000000000000000013030303000000533333333300333003333330330330333330033300
000000000000000000000003333000000000002000000000000000000030030600000005003004000000000000000000000000000013333000000000010000000000000000000000001000000000000000033300
000000000000000000000033330000000300000000000000000000000330300000010000000200000000000000000000030000000030330000000000000000003100000000000000000000001030000005033000
000000000000000000000333330000000000000006003000000000002330300000000000001000010000000000000000000000000303330000000300000000000000500020000000000000030000000001033300
000000000000000000003333330000000000006005000003003000003333301000000000000600000000000000000000030000000100030000000003000010000001000000000000000000000001000003033300
000000000000000000333333330010001000060000003000000000003030300000003000000100000001000000003003300003000300330040000005000000300000000000000000000000000000000003333300
200000000002200000333333330000300000000010000002020000003333300000020000000000000000030100000000332100000333330000001001000000000000020000300000000000000000000003333300
333333333333333333333333303000010000030300333333333330333333030335333310000000000300000000033333333331003630300000000100000000033030003333330000000000000000010000033430
