000000000000000000000000000000001000020001001300000000000000000000000001000000000000000000000000000000003020000001000000000000000000000000300000000000000000000005000000
000000000000300000000000000000300000000000000033000000001101000000060000000000000000000000000000213030000000000000006300005000000000000000000300000000030010000505000000
000000000030000000000000000000000000010413000010000000000000000000011100001410000030000000000001010000111000000000000000000011000000000000002001000000011101001010000000
000000000000000000000000000000000000000000000100000001000000000000000000000000000000000000000000000000003000000500000001000000000000000000000000000000000000000000060000
000000000000000000000000000000000000000050100003000000030011000100000001000100000000000030000000000000000000400000000000100100000000000000000000000010305000000000030000
000000000000000000000000000000000000033000000000000000000000000000600000000000000000000010330000000000000000000000000000000000000000000001000000000060000000000000000000
000000000000000000000000000000060000033333500000031003003333033003033000333333000300000001000330033333333000000300003003333333000000000100000000000003003033330030000300
000000000000000000000000000000000000000000000000000006001000000000000000000400001030000004000000000000000000000000000010030000000000500000000000000000000000000000000001
111110000000000000000000005000000000000050100000011000000010000004000000000000000030111010000000300000000010000000000001031000000000100000000000400000000000000001611100
000000000000000000111000011101000000003101000010000000003000000000005000000000003000100010000030000006000000000000001113000000000000000000000000000300303031000000000000
000000000000000000000000000000000000000000000300000000000000000000000000000000000000000010000000001100000000000000000000000000000000000000000000000000000000000000000000
000000000000000000000000000000000000000000000000000003000000000000100310000001000000000010000000000000000000100000000000000000306000000000030000000100000000000000000000
000000000000000000000000000000050000000000000010000000000000031000000000030000000000000000000000000100000000000000000000000300000000000000000000000100000000000000000000
333333330003000033333333333300101303303033000000333331010000000003001000000000000200333030300000000000030300030000103033303333000000030013001000100000000000000003333333
