000000000000300000000000000000000300000000005000000000000000010000000000000000000000000000002000001000000000001000000000000000000000000000360000000000000000000000000000
000000000000000000000000000000001000000000000311000000000030000110100000000000000200000000000010001000000000000011000000000000000000000000000100000100301000000100000100
000000000000000000000000000000000000030000030300500000000000000000000000000000300000000310011131000000000003000000000000300000000100000000000000000000001003000000000030
000000000000000000000000000060000010000000335000000000000000000100000000300003300000000300100000000000000003000000000003350000000000000000000000000000000033000000000000
000000000000000000300000000000003000000300300000000000000000000000000000000003300000000000001003000000100100000000030300300000044001000000003000000060000003000000000000
000004414100000000000000000014000000003000030010006000441410000000000200030543300000001000000000000000000141000000000003310000000004411100001400000000000231000001000000
000000000000000000000000000000020000000000333333300000000000000333133300000003330303330100303303300000000000000033333331300033000000000000000000000303103333303330000110
000000000000000000000000000000000010000000000000000030000000000000000000000000000000000000010101000000000000010051200000000000000000000000000000000000000300000300000000
000000002000000000010110000011040030000000020000000000000000000002000002000000000020000002003000600000010310000002000000000005000000000000000000000000100002000000000000
000310011111000300000000000000000000000000110110000500000000000000310011111400001000000000003000000300000000000000011000000000000310030003000000000000010015111300000000
000000000000003300000000000000000000000000000000000000000000000000100000300000000000000000020010003000020000000000100000000006000000000000000000000000000000004000000000
000000000000003300000000000000000001000000000000100003000000000000000000000000000000000000000003003000000001000000000000000300000000000003006000000000000000000030000300
000000000000003300000000000200003020000000000000000000000000001000000000000000000000000004003000000301500000000200000003000000000000000001000000044000003000000060000000
333333333333333333333333333300031033330323303331301003100002000330303333333000025000000000000000003331333303330133333030000000300033300000000000000333350333305330000000
