000000000000300000003000003310000010000000030000000010005000010000000000000000000000000000303100006000000000000100300003000003000000000000300000000000102300000300000000
000000000000100000000000010010000000000010000000000000000000000000033000030000000000301000000000000000000000010000001000000006000000001001000000010301000000000100000000
000000000000000000000000000033335000000000003013300000040000000100003000000000003300010000000000000003330000000033330000010000000000001000000003334000000000000000000000
000000000000000000000000000000000000000000000500001100000000000000000004000100100000000000000000000000000000006100000000000000000000030000050000000000000030000000000000
000000000000033002000000000003000005500003100000000000300000000000060300000300000000300203000300036300000300000000000003002000000006000000000003000310230000030030000000
500050000000440000003000034300000000000001000030000400003000000000004400001000060000000003350005000010000000034300000000000003026050000043430000003000000000000040000000
300000000000000003333300000000000000000000000000000000000000000000000000000000000000300333330010000000000100000030000000000333300000030100000000000000331300000005003000
000000000000000000000000000000005000000003001003330100000000003000000000003000000000000000000000000000002000303000000000000030000000000000300000100000000000000330000000
000000000000000000000000000000000000000000000010000000000000110000000000000000000020004000000000000000000000000000000000000060011000000000100000000000000000001130000000
003333333330000000000000333040000300000000000000000033300101000000000000033300030000333300000000001033333000000000000100000050003333000033003033000003333500000000000000
000000000000000000000000000010010000000000000000001000000000000000001000100500000000000000000000006000000000000001030000000100000000000000000000000000001000000000200300
000000000000000000000000000000000003002000000000000000001000000300100000000000000000000000010000010000000000000330030000000003300000030000000000000000000000000010000000
000000000000000000000000000050000000000003000034000000000000043103000301110005001500003000000010000000100100004000030000000344000000000000100030000000001030003230000500
000000000000000000000000000030000100000303300000000001003000030000333300000003000000000000001000000000050000000001001030000000000000000000000000000000000030000003600000
