000000000000000000000000000003500000000000010000000000000301000000000000010000000000000001000000000010000030000000000010030000000003005101000000310000030000000000000000
000000000000000000000000000003000000000003000000000000000000000000000000000000000113000000000002000000000030000000000000000003000030030000000000000000000000002000000000
000000000000000000000000000000000000055000000000000000000001000000000000004000100000005300000000000003000040000000300000000000000000000000000000000000010000001000000000
000000000000000000000000000000000000000005003000000000000000001000000000000000000000000000000000000000000100000000000000000000000000000000100200000000000000000000000000
000000000000000000000000000000000000000000000000000000100000000000020000100001000000000000000000000000000000000000000000000010000000020000000000000000000000000000000000
011100111110000000000000000000000000000300002200005110010012000000000000000000000022110100006240000000000000002200000000111001010000013110001111300000000000220000010000
000000000000000000000000000000000000333333303301300030303331303000000000000003303033300500033333330000000333333300000000000000000000010001000000000000000053333030033330
000000000000000000000000000000000000000000000000000010000000000001000000000000000000000000040000000000000000000030000000000000000000000300000500000000000101000000001000
000000000000000000000000000000000001000000100000000000000000000000000000000000001001000000060000010000000004000000001003000000000000000000503000100600000000000000000000
044000000000000055000000000000010000000000000500004000500000000005500000000300000000000000000000000005030000000000551003400000000000000030000055003044000010000000000000
000000000000000000000000000000000000001000000000000030001000000000000000000000003000000000030000000000006000000000000010000000000010003000000000000000000000000100000000
000000000000000000000000000000060005030000100000000000000000000000000100300000035000000000003001000000000000000000000000000000000000600000000000000100000000000000300000
000002200000000002000002200006000000000010311100010000220000000000100011100301055001010135100000000002000000000000020003001020030005000220000002000000002001010000000000
333333333333303333333333333333330000000000000000033333310333300333300300000010000000003000000000060303033333335033333033303303303330003303330300333330133300000000000000
