000000000000000000000000300000010000000000000000000000000000000000010030001000003000000000000000001000000500000000100310000003000350000000000100000030000000000000003000
000000000000000000000000000000000000000000004030400000006000000000000000000000000000000000000000030101000000000030000000000000000030000000000000000010000000000000000000
000000000000000000000000000000030000000000000000000000000000000000040000000000030600000000000000300000000000460000333000000000000000000000030000000000000050000000000000
000000000000000000000000000000000600000000001000000000000000000330030000060003000000333030000000000000000000000000000000000000000000033363000000010000000130301000000003
000000000000000000000055550000000000000010055500000000006000000330030100001030555500330000005350040200000040000000500000010000050050000003010000000000400003000000555500
000000333333300000000033330000001010000000034030030313100100000000030033363300333300010000363300000000000000000000000001000000003030000103003333330000000000003000033300
000000000000000000000000000000000000100333010000000000000333333333333300000101000000303336000000303303033033333300000000000000000000033003130000000033330033333300003060
000000000000000000000000000000000000100000000000000000000100000300006000000000000001003000000030000000000300006000000300001000000000000000103000100000001000000000003000
000000000000000000000000000002000000000000000000000000000000001000030000000000000000001000000000000000000600000000000000000000000000000000000000000500000000000000100000
000000000333100000000000000000000000000000000010000333100000000000000000000000003010000000100000000031300000200000000000000000000000000000000000000000330000000000050000
333030000000000000000000000000000000000000033030001000000000000000000000000100000010006000000000000000000000000030005000000000040000000030000000000001000003030000000000
330030000000000000000000000000300000000000330031000000000000000100000000000000000000000003100000000000000000000000000000100000003100000000010000000000000301000000000000
000030000000000000000000000001000000000000400030000000000000000000000000000000000010333330000000030020000000000033300300000003000000000060000000000000000000200000000000
333333300000000333333330333300000000333030333333103300003103333000000000010000000000000501010000000000000010000000010000000000033333000010330000000000000003033330000000
