000000000000000000000000000033000000000000000000000000000000000000000000000000100000000010000000001000000000010000000000000020000000050000000000000000000500000000300010
000000000000000000000000000000002013000000000600000000000000000201000000000000010430010000000005000300000000010000014000000000000006000000000000000000000000000000030060
000000000000000000000000000041000000001411400000000010000044444000000041100010000411600000000000004100000004300000014110000000000000001000000002500000000000000000003000
000000000000000000000000000000000030000000000000000000000003000000000000100000000000306600000050010000300000000000000010000000000000000000000000400000000000003000000000
000000000000000000000000000000000000010000000000000610000101000000500000000000030001006000000000000000000000500000100000000000000100000000100066000030000000000000000000
000000000000000000000001444000000000002000010000600144400003000000404000000000002000006600001000000001000000302000000000000000000404000200000006000300004030000030014440
000000000000000000000000000033303003333013000000000000003333333000000003603003331030333033300060003030300333563333333030000100000000031303013303333000100000300000000000
000000000000000000000000000000000100000000000000000000000000000001001000060000000000000000000000000000000100010300000000000000000001000000000000030000000000000000000000
000040000000000000000000000000100000000300000300000001300000001000000000000000000000000040000000000000400000000000000000000000050000000000000001000000000000004000000000
000141141000000002000004444400441400000000000000000020100060000020030001000000005000000000000006000001410000000000434443002000000000000000000044404000000030010114100000
000000000000000066000000000000030003100003000000000660000030510000000000000000006000000000000300000000001000000001001605066000000000000000001000000000600200000000000000
000000000000000066000000000000000000000000001000000060000300010000000000000030060010000000000000000000000000000000000100060000000000010000000000000000000100000000050000
000200000000000066000000002002000200000000003000000660000003300100020000300000066000000000000000000002100001440000000100066000000000000000000000020000150000023000160000
333333333303003333333333333330333300000000100000000300030000000000000000000003330333000013000000000033333000000433333333303333001000000000000330003000000030033333330000
