000000000000000000000000000000000030003000330000000001300010000000003300000000000000000000003000000000016310000000003000000000030000100030000000000400003300000000000000
000000000000000000000000000000050030000000330000000000500000000000003300000000000000000000000000000200000031000010000000000000330000000300000000000000030000000000000000
000000000000000000000000000000300000001000330050000000000000000300000000000000000000000000000000020000000330000000301000000000300000000010030000000000033000000000000000
000000000000000000000000000002000010000000300000000300000000001000333300000000000000003040002000340000000300000000000000000000330000000000000030000400333000003100100000
000000000000000000000000000010000000020000330000000000104001000003333300030000000000010000000001000000000530400000300000000000330000300000000000000003333300010000000000
000000000000000000000330000000021300300000330000000030000300000033343300000000001000000000600020000000050330000000000000000000030000000000000002010033333360003000000000
000000000000000000000330000003033300322000633033000000023340000330333000000000000000000000010033330000000300336300003000010000330303300000003303300313333000000000300000
000000000000000000033330000000500010000133001000010000003320000300000000000000001000000040000000035000000000003000000330000000300300000000000000030000000033000000000005
000000000000000000333330000000000000000333000000000040003100000000000000510000000000000000000003030000000060000000003000000000000303000000000000000000003053000000000000
000000000000000000330330000000000000010030000000100000003300003000000060000000000000000000000003000000000000011000003300000000300000500100600000000000000033000000000000
020000000000000003333330000000000000003333000000000001003020000100000000000000000003006000010003331000000000000000030330200003010000000000000000000050010033000000000000
000000000000000333333330000000000000330330000000000000003000000000000000000000000000000000000033330000000000000003033031000100000000000000000300100000000031000000000000
000200000000000333333330000000000000333033000000000000003300000000000300000000002000000000000330333303001000000003333330002000000000030000003130000100000133000000000000
330333000333333333330333333300000000333330003305300000003033330010000000303030303310010000033333303300000003330133333300303310003333330000000000000003363303330330000000
