000000000000000000000000000000000000000000000030000040003000000000100000000000000100000130000000000000000300000030060000000000000030010000000000000030000000300000000000
003000000000000000000000000000000000010000000000000000033030000000000005000000030000000102000000000000000343000010300000000001000001000000000100000000000330000000000000
000000000000000000000000000000000000100020000003000000003010000000000000000000000000000000000000000000000300000031000000000001000000000030000000000010000000400100000000
000000000000000000000000000000006013100000010000000006000000000000000000000000000000000000010001000000000300000030000030000000300000000000000000000000001000000000000000
000000000000000000000000000000000100000000000002000000001000000000000000000000000000100100000010000000000300000031030300000000030000000000000000000000300000100000000000
000000000000000000000000300000000001000000030000000030004000000003000000000000003000000010000000000000000300000030000000010000000000030000000063000003000000000002100000
000000030000000000000003330000010003200003003033030300003333333000000600000100033300000000000333330003300033303330033333303030003330000000001030300350000000333333333030
000000000000000000003300000010000003000000000000000060030000000000000100000000000000000000000000000000000000000300000000000000000000300000003000000023000310000000200003
000000000000000000033303000000300003030000000000000000000030000000003000000000000003003000001000000000000300003400000000030000000003000030303001000000000300300000000000
000000000000000000333300000000000003000000030000103003030000300000003300000005030000003000000003000000000000033001000000000100000033300000003000000000033300000000000000
000000000000000003333300000000001003000000000000000033300000000000033300000000030000000000011000000000000000000300000000000000000333300000000000000000330303000000000000
000000000000000033333300300000000000003000000006000333030000000003333600000000000000300000000000000010330003030000003000000000000303300000001003000000333300000003501000
200000000000000333333300000060000103000000000000003033300000100033033320000000000000000000500100002003000033333300000000000000001330300000043000000033333300000000001000
333333000333333333333333333300000003033313033303013330330000000333336303333300003033000000000000103333300030333300333330000100030363030000500303330333343300000000000000
