000000000000300000003000003000000000000000300300000005300000010000000300000300000000300003000000000000001050003000000300000000000000300000000000003000030003000000000000
000000000000100000000000010010001000000000000060000001100000000001000000000100000000000001000000000000101000010000300100000000000000000000000001000020000000100000000010
000000000000000000000000000030000000000330100000000000016330000000000050000300000300020000000333330000300000000000000000000300000000030000000000000000063000000000000000
050000000000000000000000000000000030000000050000000000001001000000000000000000000000000000000000000000000000000000000000000000000000000000000000000030000000050030000000
000000000000033002000000000000000000000001100000010000050100000300200000000030000000500000300240100000000000001000500030000000030200000000003001000000000000030000001400
500555500000440002002000000000000000000000300553300000000610000050200000000445005053000600000000000000010000000000050040000000000203200000000002000000000040100000300044
300000000000000033333330000000000000000000306004003000330000000003033300000003000000010006000110000000003333000000000000000000003333300000000003333000000033000000000300
000000000000000000000000000000000000000000000000000000000000030000000030000000030100000500000060000000000000000000000000300000000000000001003000000000000000000100000000
000000000000000000000000000000000100000003000000060000040000110000000030000000000000000000000000601000000000000000000000000000000010000000000000000000000000000000000000
003333333300003000000000033000000000000000133400000330030000000000000000000000030303000000000000003000001100000033300000033333000000000000003330000003303300000000000000
000000000000000000000000000000000000000005000000000000000010000000000000102000000000000000005013000000000000100000000000011000000000000000000000000000000005000000000000
000000000000000000000000000000000030002005000000000000003000000000000000000000000000000000003000000000000100200000000000100000000000300000000000000000000000000003000000
000000000000000000000000000000000440002030000000000000001000000000000100000000300000060000000000550000000000200200000000000000000000050150050000000000000050055050000300
003000000000000000000000000000000000033333010010000300000310000000000001000000630000000000030000000000030503300303000000330000300000000000000000000000000030000000003030
