000000000000000000000000000000000010000000000000000000000100000000010000000000500001000000000000400000000000030000000000000000000000001003000000000530000000000000000000
000400000000000000000000000000031030000000300000000000050021100006000000000000000000000062000000000000005000003000000300000000000000000040000000000000110400000000000000
000000000000000000000000000010000000000002000000010005000600000000030004000000010000300100010000000000000000000033300000201010000000000600000000300000000000600300003000
000000000000000000000000000000000000000006000000100100600000000000000005003000100000000000000000003000000000000000000000010000000000000003000000006000001000001000000000
000000000000000000000000000000000000000063000330000000003300003000000000000005000300010010000000000000000000031000000030003300000001000000000000066330300013000000000000
000444400000000000111000000000003000003366003333006101113300100000044400000010333330000100000001110000100030300000030000333330000300000044440003366300000000000030000000
000000000000000000000000000000001100333333030330000000003303033000000000000000333300000333300000000000000303330011030333030300000000000000000330033033333300000000000000
000000000000000000000000000002400000003300000000000000000000000103000000000000000000000001060300000000000000000000030000000100000010000000100000003000000000000000000000
000002000000000001110000000000511100000000006000003000000001020000000000020100030000000110000000000000000000400000000000000300000000000011100000000000002000000000000000
333100000000000000000000000206001003330000000000000000003331000000000400000000000000100000000600600000002003100000000020000000002000000000000000000313100001100000600000
000000000000000000000000006600030000001100000000000000000000010000000000000000040066000000000000000000066004000000300060000000000030000000100000006004000000000000000000
000000000033003300000000006633000000100000000010000000000000004000000000001001010066330030000000000000000000000000016660005000000000003000010003001030000000000000000000
000000003333303300000000336603000000000000000404400000100000000000000000001100003366360000010006300003106000144400030660001111000000033100000333330000000000046440000010
300333333333003333333033333333333330003303000000000000003000303000000000000000330330333003300000000230000000000000033330000000000000031333333330300301333300000000000000
