000000000000000000000000000000000000500000000000300000000000000000000100000000000000030000000000110000000000000000100000000000000030100000000000000030100000000000003000
003010000000000000000000000005002000000001000000000000300020000130300000301000000005000000000000000000000003010000301000400000000000000000000030030300000000031000000000
000000000000000000000000000000300060010000000030000003330000001000000501000000000000030000000000000000010000000000000000000000001133300000000100333030000000000000000000
000000000000000000000000000000300000000000000030000032300000000000000000200000000000300000000002000003000000000000000100000000000333000000001003031333000000000005400000
000000000000000000000000000000033030000002000005000333330000000000000000000000006600330000050066000001100000000060000000003000003333000100320033303330000010000020010000
000000000000000000000330000000000002102000000000000333032002000330000000000000006600300000000006000000000000000000000000000000033330320000000313333330000020060000300000
000000000000000000000333030000000003003336000000030333633300333363030000000000030330033333300630330010000000000000000000000000333033301033333033333030330356000303330303
000000000000000000000330000030000000000000000000000000000300000600000000000003301000000000000000000000000300610031003001000003000000000000010000000000000500000000000000
000000000000000000033330000030000001000000000000000000000000001000030000300330300000000000000000300000000020003330000000000000000000000000000000000000000000301006000000
000000000000000000333330000033000000000000000000000000000100000000000000003003000000000000000003000000000000033333000130000000000000000000000000010000000000000000004000
000000000002000003333330000033000016000200000000000000000000000000000000033330300300000000000000000000020000303303000000000000010000020000003000000000020000000000350000
000000200066000033333330000003600000000600000003000000000000001000000000033133300000000000000000000030004302333333003000000003000000001066010000000000003000001000000000
200200000066000333333330000030000000000600000000030000000000000000500003333133300000330000000000002002000050033330000000000000300000000166000000000300600000010000000000
330333300333333333333033333303300300033333000000030303000000006001000033303030300033333030000000303313303333033303033300000000313030030333000000000503333000000000000000
