000000000000000000000000000001000600010010000000000000000001000000000000003030000000000600000000000000000000000000000000300000010030000003000300100000000000000000000000
000000000000000000000000000000000000000000000010000000000001000000000006000000000001000000500000000000000000000000000000000000000000000000001000000010030000001000100000
000000000000000000000000000000000600001000050000000000050040500000000000000000000045003000000000010000003000000000000000000000000000000010005000000000010100000000300000
000000000000000000000000000000000000000003000000000000000000000000000000010000000000000000000000030000000000000000000000000000301000010004000000000000000000301003000000
000000000000000000000000000000100005000000000000000001000000000100010000000000000000030000000300003000003000010000000010000000300000000000000000000000000000000003000000
441100000000000000000000000044110000030001000000000000000000000000500000000000030030000000030003000000000141000040110000000000300000000000000400000000000000000003005000
000000000000000000000000000000000000000000030313303330330000040000000000011003303333000000000033330100000001000000000000000000330000300003003333303000000000000003303333
000000000000000000000000000000000000000000000000000000000000000000000000000100000000000100035000000000100000000000030000000010500010000000000000000100000000000000000000
000000000000000000000000000000000000000000000000000000000000000000000000000000000000000000300000000000000000000000330000002000000000000000000000000000000100000000006000
444000000000455500000000000000000000000000444000000000003440001550300000000000002000001000043400005000000000000500001455500000404000002000004440000000000000000350000000
000000000000000000000300000000000000000000000000000000000000003000000000003003000000300000000000030000000000003000000000000400000000000000000000000000000000000000003000
000000000000000000000300000000000000000000000000030000000000000000000000006000000000000005000000000000000000100000000030000000000000030000000000000301000000000000000000
000000000000000000000300000000000000000001000000001000003000600000000044010003000000000000010000000000000000050064005000000000000000000010000000001000000000000004401000
333333333333333333333333333300000010000030303333333330530303333133330300000003333313000000033333330330030333333303330333333333333303300000033333330000000033500031000000
