300000000000000000000000000000001000000003040000003000000000030000000000000350000100300000000001000000000300000000000000000003000000000001000000100000020000000000000000
000000000000000000000000000000400000000003000000000000000000000000000000000000030000000005600400000300000002000000000000030003031100000401000040000000600000000000000000
100000000000000000000000000000001100100633300000003000000000000300000003306000000113000000000001100000000136000000000000000011100300000301100030100010000100006000000000
000000000000000000000000000000000000000330002000000030000003001000000000300000000000000000000000000000000010300300000033000133000000000000001000000000000000000000000006
000000000000000000200000000010000000002333000000300000000000000000020000002000000000000000000000000030000000000000002000003333000000000000030010000000020000000000000000
000000000000000000110000000000000000330000000000000000000000000000000000000100000100000000000000010000300001000000001103330031133001000001000000000000011000000000000400
000100000000000000000000000003333333303330000000000000000000301000130000000000303003000000033130030030000300000003000013333333333333033333333033000000000000000000000000
000100000000000000100000000300000000000000000000030000000000000000000300000000001000000000000010000000001000000000000000000000000000030000006000000001000330000000000300
000100001000000040100000000300000000100000000000000010000300000000000301100030605000000003000010000000003000100000000100100000010000000000000000000000000300000000000000
000000000000020000110000003300000000000052000000030000000000000003003300400120000000000000030000000000033000000000000000300000000000010010000000000000003310000000000002
010000000000660000000000033300000001003006410000100000000000000000600300000630120000000000002000000000331010006600000000000066000000330000300100000000033300000000300136
330000000000660000000000333300010000000666330000000000010000000000033000000600000000000020033010000003030000006000000000000066000130010000003300004300333304000000000066
330000000000330000000033003300001100000000000000000000000000000030003300000301300000000011003000500030330000003300000003000003000050030000000310000013003300500000000130
333333333333333333333333333300000003310333333333000006000000000333333333333333303333000600003333300033403333333000006000333333000000000000003500133333313002010003330333
