000000000000000000000000000000000000000000000000000000000000000000000000000000010000000000000000000006003000000000000000000300000000000000001000001000000000000000000000
000000000000000000000000000000055000000000000000000000600000000000000000000000200000022000000001000060000000000000000000030000000550000000000000000000001000000300200500
000000000000000000000000000000011000060000000000000000000000000000000000000000100010051130000000100006000000000003000000000000000010000000000000000000000000000000114001
000000000000000000000000000000000000000000000000100000000000000000101010030000100320010000000100003066000000030000000000000000030000006000000003000030006000000000000020
000000000000000000000000000000000003500000000000001000000000000003200000000000100000000000000000000366000000000003000000000000000000000000000000000030300000000010000000
000000000000001010000000200000000200302200000000000040000000000000000000020000100030010010000000000066005000200050000000000000020002000000030000000030000000020000100000
000000000000000000000006600505333030016003000000000000000000004000000000660053330333033033304001033033303006100500660050003333313331300000000000000000000000666353030333
000000000000000000000006600000000000000000000100000660000056000000000400663000000000000000000100030000000000101000600000360000030030000000000000000026600000000000000005
000550000000000200000006600003000000000003020000000660000000000000000000460130005000000000000000000000030000550010100000466000020000000000000005000006600000050000000000
000111000000000111000006600000000000010000031100100060000000000000000000100000000110300010010000000000000000110000006000066000010100000000000000000006660000000501000000
000000000000000100020006600000000000000000500002000600000000001000000000660000000000000000000000000004003000000000000000066000000002400500000000000000000000000000000500
000000000000000100000006600000000000000000310610000660200000000000300000000000000000300000200000000000000000000000000100060000010000000100000000001006600000000000000000
020002000000000100000006600510110100000000310000000610051010000000000000660051200020000000000000000000000320002000300000066005010000010500000200000036630510100000000000
333333333333333333333303330300000003333033333131030333330000000333333330033033333330000000033333335000000303003300300003333301003333300010103010303303030300000003303333
