300000000000000000300000000000300003010000000000000000000000000000030000000000010000000000000000002000000000000000000010000000000100000000000000100300000000003000000000
000000000000000000340000000000000000000000001000000000000000000000000000000001000300000000001000000000300000000000000000000000600000000000000500000000000000003400000000
000000000000000000000000000000010000000000030430000000000000000300000000000000300000300000000000300060001000600000054000100000000000000000000000000000000003300010000000
000000000000000000000000000000000000000003000000000000000000000000000000000000000000000000000000000000000020000000000000000030000060000000000003010000000000000020000000
000000000000000000000000000000000000000005000000000000200000000000000000000000000000003000000000500000000300000000000000300000000000000010000000000000000000000000001000
000000001110000000000000000000020200000000000000000000000002010000000001110000030101010100000020200000000500060000000000002020000000101110000030000000000000000000101000
000000000000000000000000000000333000000000033333300000003033303330300000003000000000000000033333330000050333321013303333303333000000000300103133303303600003000000000000
000000000000000000000000000000000000000000000000000100000000000301040100000100000000003030000000001013000000001030000000000010000000000003000000000300000000000000000000
550000000000000000000000000055000000000000000000010003400000000000000000000000503000050034005000000000000000000000000005503000001000000003410000000020000000000000000000
000000000044400000000000000000000606000000200000001000000004040000000000003060000010000000000000000000000000404000000000000010000000000000000100440000000300000000000000
000000000000000000000000000005000000000000000000010000001100003000000100600000000000000000300000000000000103000000000000000000000000000000010001000000000000000000300000
000000000000000000000000000000030010000000000000000000000001000000000000000010000000000000000000000000012000000000000300300300000003000003300000000030000000100000000000
000000000000000002020000000000000000331000000000000000000000000000000000000000000000000000013000000000003000000000000000000000000000005000000000000000000000000000002024
333330333333333333333333300033030031000000303300160003003303333000000000000060301303000000033033030000100330033000000003033303330300000000001313303000000000000003333033
