000300000000000000000000000000000000000000000000000000000000300000051000000000010100000000000003000000003000001000030000000030000100000300000003000000030000000000000600
000000000000000000000000000000000000000000000000000000000011000004000000003000000000000000000000000000000000000030000000000000003000010000000000000000000100400000000000
111111111111155000000000000000000100000000101101155000001111111000000000000000000000003001011011111010015000000000030000001030000020050020001111111000000000000000000000
000000000000000000000000000000000000000002000005000000000010003000000003303000000000063030000000000000000020000000000000100002030030030001030000000050000001050000001000
000000000000000000000000000000000000200366001100000000000000000000000003300000100103300000000000000000000000002030000000003066333000000000000020000003000000000000000000
000000000000000000000000000000000000003066000000002000350000000001000033300003000100300000000000000500000000000000000331306066300000033000000000000000000300000000000000
000000000000000000000000000000001003330333050000000000000000000333330336333330000000333333300000100000000033003333333333333333333333300000001000000333033133303330400000
000000000000000000000000000000610000000001001003005000000000000000000000000001000000000000000000000000001000000000000600003000000000000000000000301000000600000000000300
000000000000000000000000000000000000000000000000103000000000000000000000000030000400000000000000430000000000000300000000000000000000000003000000000050000000005000000000
000000000000000030200000000011103150000000000000000300010000000011010000000000000300000000003000005000000000000000000001101110111111500100000000000100040011110150000200
000000200000000330300000000000000001000003000000000300000100000000000000000000000000000003200000000000000000000000000000000001000000100003000000000011000200000000300300
000006600000003330000000000000000000000000000000033000010000000000000000010000000060000000000000300000000000000600000000000000000300000000000000000000006600000003300000
000006600000033330000000000000000003000000000000033300001000000000000000000030000066000000300000000000000000006600001000000000000000000000000000100030016600060003330001
333333333333333333333333333300000003360333333333313303330000000000000033030333333333003303300000000000000333133300000000000000000143033333300000000303331300000003303333
