000000000000000000000000000000000000010000100000060031000000010000000000100000101000010000000031000000100000060000010000000001000000000000000100000000100000000000300000
000000000000000000000000000000300013500000000000000000000000000000000300000000001003000000000000000010003100000005010006000000000000000000000000000000100000000000000000
500000111110100000000000000001100001111000500400030003110110000000000350000000300300111000130011110000030500000003000001100000300010000000000100000030005000000063000131
000000000000000000000000000000000000043000000100000000000000001000003300000005030010000000030040000030633000000003030010000000000000010000000000000200300000000000000000
000000000000000000000000000000000000000000000000030000000000000000003610010000330000000000030000000000303000000433300000000010300000000000000000000333000030000003000300
000000000000000000000000010100210000000100000000030000000020004000033031000003333030002000030000000000300000000033330000030000300000000011110020030333300013030003000000
000100000000000000000000000033333030000000103100030333330333333333333000500003331303303330333303330303333000000003333300333030030333300000003333330333033300000003033333
000100000000000000100000000000010000000000000000000030000000000000000000000000000100000100000000000000000000300000006000000000000000001001000300000000060000000100000000
000100000100030000000000000000000000000000000000000100030000000000000000000001106000000400000010000000000010006000100030000000001000000000000310000000000000000010000000
030000000000333000111111000003000000000000100000030000331000000111101000000003000010101100003500500000000000000003350305000001000000011100100000033000000000000001110000
033300000000333000000000000003000000000000010000001000330001003000000000300010000000000000303330000000001005000000010330003000000000000600000100033600000000300000500300
333000000000333000000000000003300000001020000000001001333000000000000000000603000000000000003600000513000000000000300300000503000100030000000000033000000000000000000001
333300000003333000000002000033300001000000000001300103030003000000000000001013000100000000063320000000000300000100003300000000000000000000000000333000000000001050000000
333333333333333333333333333333133330000000000003033333300000000000001000000003033333000000133333330000000000100030333330000000000002000010003333330000000000000000003000
