000000000000000000000000000000001000000000000000000000000000000030000000000000000000000030000000000000000000000100000000000000000000000000001010000000000000040000000100
000000000000000000000000000000000030001000000000000000000000000000000000001000000003000000000000001000000000000300000000000000000000000000000000000000000000000300000000
000000000000000000000000000003000000000000000000000000310030000444000005000000000000000100000000000000000040000000000000000000150000000000000440003030005000000000031005
000000000000000000000000000000000001000000001000003330000000000000100000020000030030000000000000000003000000000000000000000000000000000000000000000000000300000000000000
000000000000000000000000000000000000000000000003003000000000000300003000000000000000000000000006000001000000000000000000000000000000000000000000001000000000030000000000
011100000000000000000000000000000000000000010000000110000000000000224000000000000000000030010000006000000000002000000001011000000000010000000000020000000000000000010000
000000000000000000000000000000000060333333000000000000000000000330333333330330303333030333300001100000000030033001333330000000303033301000003303500000003300000003333333
000000000000000000000000000000000000000000003000000000000000000300000000000100000000000000000000000000000000000000000000000000000000000000000000000010000000000000000000
000000000000000000000000000000000010000000000000300000100001003000000000000000000030000000000030000000000000000000000060003000000000000000000000000000000000000000001000
444000000000055500000000000000005004440000000000050000004000000003001000000051000000000000500000005500000040000000000014400000000000000300300000100000003000000005500100
000000000000000000000000000010000000000000000000000000006030001000000003000010100000100000000000000000000000000000000000000000000000000000000000000000000000000000000000
000000000000000000000000000000003000000000000000000000000600000000000000000000000000000000000000000000000000000000001000000000030000000001000000000000410000000000000000
000222000000000000000000000000000000002220000030000000000000000000000000000006111005030000000000000000000510100000000001000220000000000000000011000000000000003000000000
333333333333333333333033333303033003333030000000033333300000000000000033035330000000333330010001003353003000030000000003002330000000003033330100000000000000000003330333
