300000000000000000000000000000100000100000006000000000000000002000000000003000001100000000001000000000001000000000000003000000060000030006013000000000000000000000000000
300000000000000000000000000000300000000000000000000000020001030030000010000000000000000001000000000000000000000000300000000000003100030000003000000100000010000100000000
000000000000000000000000000001030010000000000000000000000333000000000000000000000000000000000000003300000000000300000003010000313110000000200000004330000000000000000000
000000000000000000000000000000000000000000000000000000000000000000000600000000000000000000000000000000000000000000300000000000000000000000000000000330000010030000000066
000000000000000000000000000000000000020066000000000000000000000000000660000000000000000010000103000300000000000000000000010000000000000000000330100330000000003000000066
000444000000000000000001100000000000000006000000000000000000000006000660000000011000000000000000000000010001300600010000000000020000000044000004440330010000001010000000
000000000000000000000000000033033630300331000000000000000300003330333300100100003000000000033333003303033005000000000000000006333033300300000000100030033331330003033303
000000000000000000000000000030000000000000000000000003003000000000000000600000000000000005500000000000000300000000000000000000000000000000000000000000000000000060000200
000000000000000000000000000030001000000000000001000000000000000100000000000000000030003003030000000000000010000000300000000000000030000000000000000001000010300000000000
333300000000003300000000000000000010000000000000031000000000000330001010030000000000000000000000000100000310000000000000000000330000001000450000000033301000000000000000
000000000000003300000000006600000010000600000000030000000000000330003000000000000000000000000002000000006330000000000060000000330001100000000000000000000000001000000002
000000000003003300000000006600000000000000100030033010000000000034000000000000000300003000030000100100066330000000000643000300300015000000002000000000050000000100000000
000000000000003300000000006600004400011000000000033000000004440030000000000000000000001000000000000000016330000000000630000000340030000000000400100003000000110000000000
333333333333000300333333333300010001000000333330003003300000000030033300000003303300000010006000003333300001033033033333333000000013300000000000010313333300000000000010
