000000000000000000000000000000000000111000000000000000000000300000000000000000000030000030000000000000000000000000000000000000100030000000001001000000000600000003000000
300000000000000000000000000000000000000000000000002000000000300000000000000000030000000100000030003000000030020000000000000000000000000000003050000000001000000000003060
000000000000000000000000000000001000000000000044000000000000000060000000030000000000000000000000000030000000660000000000000060000000000030000000005000003000040000030431
000000000000000000000000000000000000000000020000000000320000000000000000005000001000000000330000000330000000660000000000000000000000000000000500000000000000000000200000
000000000000000000000000000000000000000000100001000000000000000010000000000000000000000000000000000010000033630000100110000000000000000000500000000000000001000000000030
000000000000000000000000002000000000000020000030000000000000000300003000000000001000000000000000301000001000660000000200010000001000100000000500000000002000000300200200
000000000000055000000000000000003050000000333333300000000000000330133350000000000000500300033333003000005330003300000000000100003333300000550000000300000003330333303633
000000000000000000000000000000630000000000000000000000000010000000000050000000000000000000000000010000000000000003000000000000000000000000000000010000000010000000000000
000000000002000000000000000001001000001000300000010002000000000000000000000000040200000000000000000300000000000000000000000000000020000000000000200000000000000000000000
000000000066000000000000044030000000000000000000010063000000000000000000004303006600000060000000050000400000000000000000000003006660100004400006630010000000000000003000
000000000066000000000020000000000000015000000000000160000000000000000302000000006600000000000000000300000100000000051000000010000060002000000000000401000000000000000001
000000000066000000000000000000006000000000000000000006001000010000000000000000006000000000000000000000000000000000000000000000000663000000000001600030000000000000000300
000000000066000000000020020000000000000000000000000066000000000000000002000006000000000002000000000200200100000030000000000000010660000002000105600100000000001003000000
333333333333333333333333333333033033330331000000033330333333303000000003033030330033100100500000000103333333333050100003036303333303310331333000033330333000030055000000
