003000000003000000000000003000000000030000300000006000005000000000000100333300000300000033000000000000000000000003513300000000000000000003000000300000003000000000000300
000000000000000000000000000000000000000000000000000000030000000000000000000003010001000000000000000000000000005000000000000000000000000100000000000003000000000300000000
000000000000000000000000000000000000000300000000010150300000300000000000000001000000000000000000100000000000000000000000000000000000030000000300000012000000000000000000
000000000000000000000000000000000000000003060000000001000000000000000000000600000000300000000010000100000000000000300000000000000000000300113003000000002000000001000000
000000000005050000000000555000000000000300000000000000000000550000300000000000300501000505000005050003000000000000000000300000300000300005050303000000505000000030000505
333333333033330000000000033300000001030310000000000000000000333000000000010003300333000003033033330000000000010000000000000000333330303030310300010000033300000003301033
000000000000000000000030000030000000000030000000001000300300000000000000001000000000100000310040000000000000530000150000000000000000000000100000000030350000300000000000
000000000000000333330000000003030000000300000000001000000000000000000000000000000000031033000000000030000030000000010002000000000000000030000000000003333000000000000000
000000000000000000000000000000300000000310000031000000000000000000000000000000000000000000000000000000000000000000000003000010003000000000000000000000000004000003000000
000000000000000000000000000000600001002000000000000000000000000000000000000000000000000000000000001000000000000000000300000230000000000000000000000000000000000000000000
000000000000000000000000000000000304000000010000000000000000000000000000000000103000000051000000000000300000000000000010000000000000000000000000000000060000000000000000
000000003030000000000000000006000000000505010303000055500500010000000000000000030000030000000030000030000000000000000000000000000400000055500000000003000000000000000000
000000000000000000000000000000000003303333000000000003330303033000000000000000000000000000000005003130333000000000000000030000000000000003130000000000000000000003333333
000000000000000000000000003320000003000300000000001000000000300000000000026030000000000001000000330000000000000300006300000003010000000000000000030000000000000132000100
