000000000000000000000000000000300000000000000000000000000000010000000000000000100000000000000000000000000010003000000030004000000000000000000030000004000000000000000000
000000000000000000000000000000000000000000050000013000010600000000000000000000000300000310000010000005000000000300000000000001003010000300000000000000003001000000000005
000000000000000000000000000000000000000000000130000000000001500000000000000000000000000000000000000000111001000000000000000000000000300021000002040000000000000000000000
000000000000000000000000000000000000000000010000001000000000000000000000060000000000000000630000033005000050000000000030006000000000000100000066000000000000000000000000
000000000000000000000000000030000000000003100001003000000000000100000000060000000000000000030000000003000000000000000001000010000004000660000066000000000000000006000000
001111111111111000000000000010111111000000100000001111110200000011101000660001100010006003000111110200030100000000000011111111101111100660000000003000000000000000111511
000000000000000000000000000000000003603303000000000101003303332000000030333330000000000000000000003303333000000130000000000000000001000033303033130333003330000000010000
000000000000000000000000000000000000000000300000000000000000061000000000000000000000000000000000000000000000000000000000000000000100000000000001100000000100005000000000
000000000000000000000000000000000030000000050000000000000000000000651000000000000000000000000000000300130000000100030000000000000000000000000003000000000000000000000000
000111000000000000000000200011020000000000000111000000000300000300000000010000000000000000000000000000000000000000000000000000000000300010100003050004000000011100000000
000000000000000000000006600000660000030000000000030000000001003000000030000000000000000300010660000000000000000000010000000000000000000000000000000000000000000000000001
000000000000000000000006600000660001000000000000000000000000000010000000000000000000000000000060000000000003000300006000003000000000000000000000000100000000003001000000
020000000000000002000006600000060000002000020000000000000000000010000000010110002000111131100660000002000003000000000001000030000001302000000010111036000002000001000000
333333333333033333333333333330333333333323033333000000033333303010000000000503334330000000033030353333333353000333033030000000333030133303330031000333330033330330000000
