000000000000000000000000000300000000003000005000000000000000000000030000003000000010300000300003000000030100000300000105000000000100000000030000100000000010000000000000
000000000000000000000000000000000000000000010000000000040010300100000000000000000000016000000000330000000001000010000000000000000001000000000030000000050006000003200000
000000000000000000000000000000010000030030000000044504410000003000000000000000000000000000000000004440041000003000000003000000000000003000001400000000000000000006000000
000000000000000000000000000000010002000000003012000300000032005000000000000000001000000000000000203000001000010000001000000000000102000010000500030000000000001000000000
000000000000000000000000000000000000000000000000005000000000300001000000000000000000000000000100005102000000000000000000000000000000000000000000030000000010000000000000
500000040444004400000000000000000035001400100000000000100000030040000000300004040400000000030000000030000404440040040005000000000000000000030000630440000050000000044406
000000000000000000000000000031303300003010300000033303303033013300000000000000000000000000030000003033330001000000000000000000200000000000003333330000000600003000030000
000000000000000000000000000000000010100000001000300000300000000000100100000030000300030000000000000000000000000000000000030000000000000000000000000000000300003000000001
000000000000000000000000000000000000000000000000100000000000000000000000000000000000000010000010005000000200300000030030030010300000000000000000000000000000300000000000
000000044444411400000000000000003001400000300001000000004044441140000000000000330000000000014001000000000020000014000004444441000000000000000010000100300004034011000000
000000000000000000030000002000000000000130000000000300001000000000003001000000000000000000000000000002000000000000000300000000030000000100000100030000000000000000001000
000000000000000000030000000000000000000035000000000000000000000000000000000000000000000000000000300000000000300000001300000000000000000000000010000000000000000010000000
000000000000000000030000000050000001000000000000040000000100000100003000000000000000440000000000300300000000005000000300000010401000000000000001010000000000000030003000
333333333333333333330300000000003005333330000000000002003033333333303000003000030000000000030333303033133000000033433303030330000000002303033330333000002003333301000010
