000000000000000000000000000300000000000000000010000000000000000000000300000000010000000000000000000000000000000000000000000000000000000000000000300000000001000000000000
003000000000000000000000000000000000000000000010030000000000000000000000000356110000000300000000000000000003000000000000000000034000003000600300000060000000011000030300
000000000000000000000000000030000000000000000000030000000000300000000000000000000000000000030000000100000300000003000000000000000000000000000000000000000000000000030000
000000000000000000000000000000000000000000000033030000330000000000000000003300000010000000000000000003000030633030000000330000000006010000010000000000000600050000000000
000000000000000000000000000000000300000000000033134100010000000000000000030330000000000000000000000300000000303300000000000000000000000000000000000000000001000000000100
500000000002000000000000000000000000000000003303000040000000200000000000003303000000330000000002000000060003333000000000000100100000000030000030000010000000000005000000
000000000003330000000000000003303303330330303035330000300000301000000033033300000000333303000003030000000133133300003300313333333333000020003000000303110003300030034000
000000000000000000000000000000000030002030000000400000300000130000000000000000000000000002000000000000000003000300000000000000000010000000000000000003000000010000000303
000000000000000000000300000006000000000000000000000301003004000000000000000000030000100003030000003000000000000000000003000000050000000000303000000000000000000000030000
000000000000000000000300000000000020000000000000000000003030000000000000000000000000000000010000003000000030003000000303000000000000000003003000000000000000000000500000
000000000000000000330300033300000000000000000001000000300301330000000000000300000000000000000000003000033000001300000300000333000000100003303000333000303000000001000000
000000000000000003333300000000000000000000000000000000503000000000500000000000060000300000100003003100000000000000000003000000000001000033030000000000433000000000000000
000000000000000033330300000030060000000000000000010000013000000000000030300005030003000000000000003000000000000000030003000010000010000303003000000003303000002500000000
333333003333333333333300000000001000000000000043000000013000000033330333333300000000000003303053333000003001000000000003000000010000030133030000000033333000003040000000
