000000000000000000000000000000000000003000000000000000053000000000010000000000000010000001000000003000000000000000000000005000000000000000000300000000000010000000000000
000000000000000000000000000000000300000003000000020001000000000000000000000000000001000000000000000100000000100000000000000001010000001000000000000005010300000000010000
010000000000000000000000000000030000000060000000020000006000000003004000000300303000300000000000000000000000000000000000000000003033000000000000001000000000030000030306
000000000000000000000000000000030000000000100000200003000003100033030000000000000000030000000030101000002003000001000000000000003000300000000000002000060000030000330300
000000000000000000000000000003303000000200600000000000000303000303300000000006000000001000030000006000000000000000000000010000333300000000000030013000000003330003333300
000000000000000000000000000000013000000300600001000000030333300333330000000000000350000000005000303000400000000000000000010000303330003000006000100000000003333003303300
000000000000000000000000000003333300001300333033300013333330033333330300600000000000000000000100100333003000000000020000000002333131300000003533033000000033330353333303
000000000000000000000000000000000000000000000000000000000000300000000001000000000000000000000100000000000000030000000000000303000000000000000000000000000000000000030000
000000000000000000000000000000000000000000000000000000001030000000000000030000000000000000030000000000020010000000001000000010000000000000300000000000000000000000000000
000000020000000030330000330000000000000000000000000303000000000000000000000000000030010000000030002000000003033000000000000030000100020030002000000010000000000000000000
100000200000000330300000330000001000000000006300003300001300062000000000100000000000000000000003000000000533030000300001000002000330000000230000000003000000000003000000
600000000000003333300033330000000000010100010000033333606000000000100000000000000000000000003333000000000313330000000006000100035300300000000300000000000000030003000000
600000000000033333300033330050000000000000005000033333006010003060000030000030000050000000000300000000003333361000000306000000033030000010050000003000000010000000000000
333333300033333333333333333300005000000200004000030313333333330000300000033330000000010000033330030003330003334300000003330000333333100033330001333000000000011300000030
