000000000000000000000000000001050000000000000300000000000000000000500030000000000000000000030000000000000000000000000000003030000000100000000000000100000000000000000000
000000000000000000000000000000010000000000000050000000000000000000000000020300000000100000000001000000003000001000000000000000000000000000000000000002000000000000000000
000000000000000000000000000000000000000000003111000000000110000040000000000000001010030000020060060130000000111000000000000000031000000000000000000100000001300000000000
000000000000000000000000000000000000003000000000000000000000000000000030003030000000330000000000010000000000100310000000100000331003000000000000000300000000000000031000
000000000000000000000000000000001000000000100000000000000000000003000031000000000000030000000100000000000000000000000003303010030000000100000000000030530000000000000000
000004014111000000000444110000111000000040100000000010002000000143110003003000000100000000010100002000000000000010101000300300030000000000001411100000000000000000003000
000000000000000000000000000000000000000000000030000000003330300000000003333330003300303333000010003333000000330000000000033003333303000000000100010330330343333000000000
000000000000000000000000000000000000610000000000000000000000000000000000400000600000000000000000000100000010000330000100000000000000000000000000000000000000010000000061
000000000000000000000000000000000000000001000000000000030501000000000000100000000000000000010000000023000010000000000030000000000400000031000000000000000000601000000000
000000000011100300000011000000000000300040011000000003000006000000000003000000060000000040000000000000000000000003100000001310000000000000000000000000000000011100000000
300000000000003300000000000030000003300000000002000000000000001000030003000000000000000000030000000001000000000000000000300000000000000000030000000330000000100000000300
330000000000000300000000000033300000300030000000000000000000000000000003200000000000000010053000000000000000000000000000030000003000000000400100000030000001000000030000
030030000000000300000200000001000000300000220000040010000000040444110003000200000003001104003500400001100000000000050000000000440100000000004441100030000000300000000000
333333300033003333333333330033333033333333333330000000010300000000030033333330000000000000003303100000010000010033330000003300000000000001000000000333033300033000000000
