000000000000000000000000000000000000000001000000000000000000000000000000000002000005000000001000000000060000000000030000000004000000100000000010030010000000000000000000
000000000000000000000000000000000000000000000000000000000200500004000000000000003000000300000000000000000320000014000000003000000000030000000000000000000000005001000000
000000000000000000000000000000000000000010000000000030000000000000000100000000200000000000000000030000000660001000000000000000000000000000000000000000000003100000000000
000000000000000000000000000031310000020000000000000000002100000000000000000000000000000000000000000001000660000010000035000000000000000000000000000000000000000000010000
000000000000000000000000000000000020000000003000000000006000000000000000000005000000000000001000000000000010000000000000000000000010030301000000000400000000000000030000
550000000000000000000000002000601000000000000002000001000600005000000103000000000020550000000100000330000060001000001200110000351000102002010000000010302000000000001000
000000003333300000000000000003333000000030000000000000003333300003333303000000000000000000300000303331330333333000000300000000000000033303330000000000000000130030330330
000000000000000000000000000000000000500005000001000000003000000000000000000003003000000000000003000000300000010000000000100000000000001000031000000000000000000000000000
000000000000000000000020050032005000000010000000000000310000000000000000000010000000000000000000000000000000006000000060200500020000000000000200300000000000000000000000
000300000000000000000660000066000000000000000000001001000000000000300100000000000000000003000000000000001000000000000106606000000000000000006600000000300000000000000000
000000000000000000000660000066010000000000030000000000000000002010000000001001000003100000000000001000004000100000000006600000001030000010010600000000010000000000300000
000000000000000000000660000060000000000000000100000000000000010060000000000000001030030000000000000000000000100000010006000000000000000000500600000030000000000000000000
000000000000000200200660000066000000000000020020055000000000000004302000000000000000000000000002000040000000062000000001600000000000000300000600003000000002000005500000
000300000000333333333333333033333300000000334333300000050000000000300100303300000103000300000333030000000000000003333300303000000003000001403333333000300033333310000000
