000000000000000000000000000000001000000000000000003000000000000300000000060003000000000000300000000000001000000000000000000001003000000000000001000000000000000200000000
000000000000000000000000000000000000000100000000000000000000300000000000000000000000000004000000000000000000000000000000000000000000010000000000002000100000000000003000
000000000000000000000000000000000000056600000000000003000000000000006000000000000000000000000000100000060000000000000040306600000000000000000000000000160000000000100100
000000000000000000000000000010030000106600000000000000000000000000000000020000000000000000001066000003000000000000011001006600000000000000000002000000060000100100000000
000000000000000000000000000010000000006600000000300000000006000000000000360000000000000000000006000000000114130000000000006000000000000000010066003100660000000000000000
000000000110000000000000000000000000006600001000030000000000000000400020660000000220000000020066035030000000000001000102006600001101000000012066000200661000001003000000
000000000000000000000000000000000003303311000000000003000000000001000033030333333333003000033303300000000000000030033363033330000030003000003333303333033500000000000300
000000000000000000000000000010010000000000000000000000040000000000000000000000060000000000000000000000100000000000000000600000000000000000000000000000300000000050100000
000000000000000000000000000000000000000000000300000001000003002000400000000000000035000000000000000000003000000000000030000000000000000000001030003001010200000000063000
000660000000000000000000004400000440000001000000003000000000004000000000000000006600000004560300000000000000010000000000000000000000000050011000000000004400003000000000
000660000000000002000000000000000000000300000000000000600000000000000000000000000600000300000100000002000110000000000010302330000000000000000000000030000030000000000000
000660000000000066000000000000000100061000000000000000006000000000000000000100006600000000000300100066000000000000000000066000000030000000000000000000000000000000100000
200660000002202066000000000000000002066000000000000002001000000005110000000002066600000000000110002066000010022000000003000000006000000000000000220000050000000000011000
333333333333333333333333333333301330300363000000030133033033333000000000000006330133003303300000003333333304033033303333333333600000000060003303335331303300000010000000
