000000000000000000000000000000000000000010000000300000000000000000000000000001000000000000001000000000000000000000000000000300001000000600100000000003000000000000000000
000000000000000000000000000000000000000000010000000003060000000000000020000060000000000000000000000000000000000000000000010000000000000000000000001400000003000000000000
000000000000000000000000000000000000000000000000000000000000000000000000002000000000430620000000000000000000000000100000000000000000040002000010000006010000000000000000
000000000000000000000000000000000000000000000004000000000000000000000000066001010000000360100005000000000000660000000010000001010000000006100000000000000000000000000000
000000000000000000000000000000000000000000000000000150000000000000000000060000000000000661000000100000000000660003000000003000000000000066000000000000003000000000000000
000000000000000000000000000000000003000000000000040000000000030000000010060000000000000600000000100000000000660000000005000000003000000300000300000000000000000000000006
000000000000055000000000000000003003333330000000030333030006035330033333333035000000330303303303330000000003033050000003333333000000003003310000300333333300000010030333
000000000000000000000000000000000000000000000000100000000002000100000010000000002000000000030000600000000000000000000000000000000000000010000000000000000000000000000000
000000000000000000000000000010100000000000000000000103000000000000000000000000006000000003000300000000000300001000003100000000010000000200000000000030000100000000000000
400020000002000000000000000010000000000000400020000000300000100000000003000004000201000050000000000000000000000001000000000200000300001000000030000300000040032000000000
000660000066000000000000000000006000000000000660000000000000100000001000000000003000004000000000001060000000000000000000006600000000000000000000000000000001060000006000
000660000066000000000000000000036000000000000660002000050000000000000000000000006600000000000000000000301000000000002000006600000000000000000000000000000303066000006000
000660000066000000000000000030066100000000000060000000000000000000000000000031006000000000000000000001000000000000000000106020000300000000010000000000000000060000106600
333333333333333333333333333333333030010015303313350000003333003000000000000003333333000000533333300000000500000000000053333303020000033330335000010000000033333033301033
