000000000000000000000000000000000000000060000000000300000000000300000000000000000030000200000000000300000003303000000000000000000000000000100010000000001000060000002030
000000000000000000000000000000000001000000000000000000000000000000000000010000014000000000000000001000003000000000000000001000000000000030000000000030030000000000306000
000000000000000000000000000000020000000003000440000000000000040000000000000000000000002200010000000000000000000000000000050000000000000000030002000000000000000000000000
000000000000000000000000000000060000000000005020000000000000000000000000100000000000006600000000000010000000000000000001000000000000000000300066004004000000000000000001
000000000000000000000000000000660000300000600006000000000000000000000000100000000000006650000000000050300000010000100000000000000010000000000166003000000001000000010000
000000000010000000000000000000660000000003200000000000122000000000005000000603001022010600000010000000000000002200010000010000000000030000000060000000002230000003001300
000000000000000000000000000050033300000303333333333300333103330000000000000003033333300033000000000000003333303300000000000000300000000600303303300333330310000000000000
000000000000000000000000000000000000000000000000000000000000000000000000000000001000000000000000001000000000000000130000001000000000000000000000000000000000000600000600
000000000000000000000000000000000000100000050000000050000000000000100000000000010003100000000000000000000000003000005000000000000000000010000000000000000000000000100010
000444000000000002000000000400003000000200000500000000000000050600000400000000002030010000400000000000440000000000000000000000000000000044400000000000000300244400000000
000000000000000066000000000000000000000000003010000000100000000000000000000000066005000000000000000300000000000000000000030000000600000300000000600000001006050000000000
000000000000000066000000000000100000000040300000100000000500100000000000000000066000001000000000300000000300000000000000000060006600000000030000000000000000000000000000
200000000000220066000000000000000000000003000000000030000030000000000000000000066000000030000000002000000000000000000223003000006600030000000000000000000010000000000000
333333333333333333330000033304100000010000000000000000000300000000033301000003303330000003310000300001343000000003030330000000300033030300330000000000033200333330000000
