000000000000000000000000000000000000000000000000500000000000000000000000000230000000030000001000003000010000000001000000300003000000000000000000000000000000000230000000
000000000000000000000000000000000000000033000000010000000000001001001000000311000000000000000000010000000010000000000000004033500000010005000003010000000000000330005000
000000000000000000000000000000000000000033000000000000000300000000000030003330000000000000000000000001010000000000000000000303000000000000000000000000100030013300000000
000000000000000000000000000000000000000330000000000000010000310000000000133300000000000000000100000000006000003600001000000133000000000000000100400000000000110330000001
000000000000000000200000000000500006030333000000110000000000000000000000133333000000003010000011000000000000000000000000033313001000000500000010000000200000633330010030
000000000000000000011110000000000000000030000000000000000300000000000003000300000000000000000000000000500000000000000000000030010300000000000000000150000000000100010000
000000000000000000000000000300000003303043000000053300300303333000000033310033303333333305333130333030033000000030000303330303000000333333333333303000000303030030000000
000000000000000000000000002300000000000000000050000000000000030000000000303000000005000102300000010000000000001000000600000000000110000000000000000000000000000000000000
000001110000000000000000003300000003100011300000000000000000030000500000000000000000000103330000000000000000000000000000000011005000300000000100000100000000000001000100
000000000000000001110000033300000000000000000111000000000000000000111000000000000000000033300000000000000000300000000000000000000111300000200000000000111000000000000003
000000000000000000000000333300010500003000000000010000000000000000000000000000000040000333300000300000000000000000000000000006030005100000000000000000000010030003000000
000000000000000000000003333300000000300000000000000002001000100000000000000000000000003353000050000000200000060000000000000003001000000002003000300000000000000003000000
000000000000000000000030003001000000030000000000000003100000000000000000000111000000030004000000000100311110000000003000100000010003000000110000011001000000000000000000
333333333333333033333333300300000033003301300033300000000003000300313300000000000003003300306000000000000000000300030003033033313303300000000000000303333300000003333303
