000000000000000000000000000000000000000000000000000300100000001000000000300000000000000000000000000000000000000600000000000000000000000000000000000000000000000000030000
000000000000000000000000000000000000000000000000000000000000000000300000000000000000000000000000000000000000000000000000300030002040000000300000010000000600160000000000
000000000000000000000000000000000000000500000000000000000050000000000000001000000300000000000000000000010000000000000000000000000000044400010000000000000000000000000000
000000000000000000000000000000000000000300000000000000500000000000000000000000000000000300000000000000000000000000000000000000006000000000000100000003000000300000000000
000000000000000000000000000000000000000013000000030000000000000000100300100000000000000000000000000000003030000010000010000003000001000000000000003000000003400000602000
011111100000000000000000000000000300002006000000000000000000030000000603000000000000000000000011110002006000000003000003002006000000000000200002100000000000010016600000
000000000000000000000000000000000003333133000000000000000333303033303300330000100000000000000000003310333000005300000000333303000000013330033030303330303300003000330313
000000000000000000000000000000000003000000010000000000000000000000000000000000000000300000000003000003000000000000000000310003000000000000010000000013000000000000000000
000000000000000000000000000000000000000000000000600000000000000000000001000100000000000000000000000000000000000000000000000000000030000000000000000000000000000000000000
444000100000000000000000000000000104400001000000000000000000000044000110000004000000444000000001100000000000000000000031030000000000000000000000000010000040400010000000
000000000000000200000000000000000000000000000000000000000200000000000000000000000000003000000000000200000000000000000001200000000010000000000000100000000000000000000000
000000000000006600000000000300000000000101000010006100006000500000000000000000000000000000000000106601000000000000000016000000300100000000000000001300001000000000100000
000002000000006600000000200601101010000020010000006000006600000000002000311100000003300002006000001630000000000001111116230000030000000000000010111030000000000200300000
333333333333333330333333333300330003333033333333033300033330303033033300000000000000333303300000003303333330033300000003330334331030300000000300001000000033330030000010
