000000000000000000000000000000000000000000000000000000000000000000000000000000000000000000000000000000000000003000000000000001000000000000000000000000000000000000000050
000000000000000000000000000000010000000330000001000000000000000000000002000000000003000000000000000200000000001000000000010005520300000000000000000000000000000001000000
000000000000000000000000000006000000000000000050010101000000000003000066000000000000000020100000036000000000100000000000000000600000000001101021000003000000000000000000
000000000000000000000000000006010000000000100000000000001000000010000066000000000000100000006000016600000001000000300000000000600000000000003000000000000010000000000000
000000000000000000000000000066001000000200000000000100000000005000000000010000003000000000130000003600100000000000100000000000000010000030200000000000000000000050000000
000000000002000000000000000066000001000000000003002000000000200506000060000303000000003000100002000600000020000000030010000230600000000000000000000000400002000000000000
000000000000000000000000000000330000000000333333033330033333303010003000330000001000000030030330003303000333130330333030130333030300000000000000000001000030333030000000
000000000000000000000000000000000006000003000006000034050000003000000000000000500000000000000000000100000000000000000000000000000300000000030000000030000000001000000000
000000000000000000000020000006001000000300000500000000000000000000000000000010000000000030000000000000000000000001000000000300000000000000060000000030000030000000000000
000000000005000000000660000000000000006000000000000040010300000000000000005360000020000010000100000010000000000000000001000000000060000001000010010660000000000003000000
000000000000000000000660000000000000000000000000000000301000000000010000000301010000000000000000000000000000000000000000000000000000500060000003000660000060100003000000
000000000000000000000660000000300000000000001000000000000600000000000000000000000600000000000000000001000000000000300000000000000000000000000000000260000000000000000000
000020000000000200000660000000000300000200000000000002001000200006000000000003000003100000000000100000000000000060000000000001000000000000300000000363002000002000001000
333333333333333333303333300060000000000000000010033333330000000000000000333333033503000000000001003333310000000000000000000300330313301000010000000303310033333030033303
