000000000000000000000000000000000000301000000000000000000000002000000000000000000000000000000000000400000000000000000000000000000000003010000000000000300000000300000000
300000000000300000000000000000000000000000000020000100000100030000000000000300000010000000000100040000000000000000000000000000000003400002000010050000003000000000000010
000000000000000000000000000000100030000000000600000000000000000000000000000000010000000000000000000000100063001000000000000000000000000016000000000000000000030000000000
000000000000000000000000000000000000000000000600000000001000000003001000000000000000000000000000000000000660000000000000000000000000001006000000000000003000000000000000
000000000000000000000000000000000000000000000660001000020050002000000000030000000010000000000030550000000060003000000300000002000000000036000000100300000600000000000000
000000000000000000000000000000001000000000006660000000000000000000000000000000000000000000000010000300000010000000000000000000001000000056000000000000000000000000000000
000000000000000000000000000003303330000000303333333330333333313000000000000000000006000000000000030353333333330300000003333330001000003033030003000000000000030603333633
000000000000000000000000000000200000000000000000000000000000000000000000000010000000000000100000010000300000000000300000000010000000000000000000000000000000000000000000
000000000002000000000020000002000003000000000003000000000030000000000002600000000003000004030000300000200000000300000000210000000000000000000000200000000002000000000300
000000000066000000000660001066000100100000000000000100403000000000600066000100000200000000000000100000000300000000000000600010000000000000030006100000010066000100000000
000000000066000000000660000066100030000000000000000000000100000000660000000000000001003000100010000016600200000000000006510030000000000300000306600000000066000000011000
000000200066000000000660000036000000000030400000101000000000000000660066000000000000000000200000003006600000000000000006000000000000000000000006100000000061000000000000
000000000066000000000660000060000000100000003000000030000000000000660066001000000300000000000000000006600110001000030006000030050000030000000006600000000066300003000001
333333333333333333333333333300313030003000000000000000003330333033133333031030000000333010300000000313333000000000000003533003303303300000003033333000000033333300000000
