000000000000000000000000000000000000000000033300000300000000000100000010000000000000000000100000000000000000000000000000000000003000000000010000000100000000000000000000
000000000000000000000000000000000000000030200000003000000000000000000000000030000000000300000000000000000000000300050000100000001000300000000000000300000300000000030000
000000000000000000000000000065000010000000100000031000000030100100000200103330000200000000030000000000000000103000000010000000000003300000000000000000033000000400000000
000000000000000000000000000000000060003000333000000004000000000300006600000300000000030001013000030000000000003300000000000000000003300000000003000600003300000000010200
000000000000000000000000000000100060000000333000030000000000000000600600003330000000010000000000010300001000010030000000000000000033330000000000000000020300000000001000
000000000000000000000000000000000660010000303300030000500000000000066002233330000000360000000000000000000320303001000000000020025320300000005000000021313300000000000000
000000000000000000000000000033333330004000313303303333330000000003313333333310000110000000000000000000000033003000000000000100033333010000000000300033533300100000000000
033300000000000000000000000000000000000000001000000000000000000350000000330000000000520330000000000000000000000043330000000000003000500000000000000050000003300000000000
203300000000030000000000000000030000010033000000000000006000000300000020330000000000203300000000000000000000000000330000000000000000000000010300030000000020330000000000
033000000000333000000000000200010000000000000000000003000000000000000003300001000000033000000000003000000003000203300003000000000000000000020000000300000003000000001000
333300000000333000000000006600000000000000003000010000003003000000000003330000000000303300000000003000000001006603033003000000000003000000060000063300330033330000000000
333300000003333000000000006600000000000303000000000000033000000000030003000000000000300311300000002000000006006613330000000000003500300000600000006000000033330000000000
333300002233333000000000066600300000225333000301003000003000010000000033330002000010333000000003303000000000066633330003000000030000303006660000600000000033300003000000
333303333333333333333333333330000000333303000000400000003330330000400013336000000000300003300000013333333303333630330033330335000000033333330303333333333333300330000300
