000000000000000000000000000000000000000003000100000000300000000010000000001000000600000000003000000000000000001000000000000033000000000000030000000000000000000000000000
000000000000000000000000000000000000100000000300000005000001000000000000000000000000000300000000000000500000100000000000000000000000000000000000000000000000000000000000
000000000000000000000000000000000000000000006600000012000000000000000001000300000000000000000000000001110000000100000000001030036600000001300001110006600000000000060000
000000000000000000000000000000000001000000006600000000000000000000000000000000066010000000000000000000031060000000001003030010000600000000000100000006000000000600061000
000000000000000000000000000000000000000001300400000000030000000003000000140050066000600000500000000000000000000000000000000000006600000000000006000000600000000100360000
000000000000011000000000000000200301000000003600002000030030000000000300000000066000300000040220000100000000030000000001000000006600002000000210000006600000000000060000
000000000000000000000000000000030330000000003333333033300000100000100000010000033330000000033331333303033000000000300000000000003330363333033333300003013300000003333030
000000000000000000000000000000003000000000000000000000000000000000000000000000000000000101000010000100000004000050000000000010100000000000000000000000000000000300000000
000050000000000002000000000000020000000000000000000000001000000000200000001300000501000003000020001000000000000000000000000000000003000000000000000001000000000000000000
000111000000000066000006600000060000000000000000000000000000000000600000000000001110003000000610000000001106600000000000000000000000000660000000000000000100000000100050
000000000000000066000006600000060000000000000000000030000000000003600000000003000001000000000060000100000006600000000000000000000000000601000000000000000000011010000000
000000000000000066000006600003000000000000001000000000000000000006600000000000000000000000000600002000000006600000000000000100000000000660000300000000000000005000003000
020000000220000066000006600001660000000000000000000000000000050006600000210000000010000000000600031000000106000601220000000001000000000660000000000160000033000011002000
333333333333333333330003333333333300000000000010000000030000000033330033333330033300000000033013300200000003333333333330000000000200030333300000000000110000000003033303
