000000000030000000000000303300000030003000000000500230000000000100300000300000103003000000000000000003033010000000000003003010000000000030000000530000001000000000003030
000000000000300000000000003000000000000000000300000100300000030000003010000003000030000100000000030000000000000100300110000030600000000000000000000000000000000010010030
000000000000000000000000000000000003030000000000100000000100333000000000000010000000000000000000000000000000000100000010000000000000011003330000060500300000000050000000
000000000000000000000000000000000001000000001010000000000000000301100020000000000000030000100000000000003000000000300000000020000000000100000030000350000000000000000000
000000000000000000000000000000000000000000000010000000300000000000000000000000300000300000005000000000000000004100000300000003000100000000000003000000000000000000000000
000000000000000000052530000000000505000002001000000000100000000000000000000005300000331100000000115000000030001000000000000130000006010000000000000000005200000005001000
000000000000000000033300000000000333000000330000000000000000000000000033300003000000033303300033333000000333000030000000006000000000000100030000060000003333300003000030
000000000000000000000000000000000000000000000000000000000000000000000000000000004000000016000000000000000000300000000000001000000000000030300000105000300000000000000000
000000000000000000000000000000000000000000000000000001000000000006030001000000010300000000000000000000000000003000000000000000000000001000000003010000001000000000000001
000000000000011100333030000000000000000000000010011003020000000000000000000001000002030000031003333301000000000000000060000000000500000010000000000030000001003320000000
000000000000000000000030000000000000000000030000300300000000000000000003000001000000030006000020000000000001300004000000001000000000000030000300000000000000000000000000
000000000000000000000000000006003330000030000000000000001100000000000030000000000000000000000600050000000000000000000000000000000000000600000000000000000000000000000000
311100000000000000000000000030110000000000004000000000103111010006000000000000230050000000000000000000060000000031110000000000000035253100000000000030000000100003110000
433303333300000000000000000040030330500000000000000000000330003003000000000000000001010000000000000000000000000043330300000000000003330100050030300000200000000030033033
