000000000000000000000000000000000000060000003330000000000001000000000000000000001000006000000303300000000000000001000000000000000000000000000033300000300000000000000000
000000000000000000000000000000003020000000310330043000000000000000000000000300000000003000030333003000100021000001000031001000000000300000003533000000000000000000000010
000000000000000000000000000000000000000000003330000000030000000000003000000000300000000000003333000000000000000100010000000003000030000000003333000000000060300000000003
000000000000000000000000000000001000100051031330000000030000000000000000000030000020000000033300000000000010000000000000000003500000000030103030000000000000000000000003
000000000000000000000000000000000030000000330300000033330003000000000000003330000000003000033003000000000000000006000000023033000300000000003303300005000000000000003331
000000000000000000000003000000032000000000333030000033032000020003003000033000000000013000030313000000005000030000001000303333000200060100003013300000020010300000003313
000000000000000000000003330033033333000000333303303333333333333103300032330330000000000000030333310000000330303000000003330303333033300000003330333323010300333003333303
000000000000000000000003330000300000000000030000000100000000000000000000000000033300000000000000000000001000000000000000000030003330000010031000000000000000000000000000
000000000000000000000333330000000000000000000000100000000000000000000010000006333305000000000003000000000005000000010000000000333330100030000000000000000000100000003000
000000000000000000003333330000000100000000000001000000000000000000000000600103035300000000000000000000000000101000000000000030300330000000000000000000000000000100000000
000000000000000000003333330000000000300000000000001002000000001030000000000003333300000000000000000500000000030300000000000000303350000000000000000000000000000000000000
000000000000000003333333330000000000000000000000000000000000003000000000000003033300000000000000000000000006303330000000000000333300000000000000100000000005000000000010
200200000002000003333333330023020000000000000000000300000000000000003300001000313300000000020020000030000000010000000100030030300030000002000000003000000020320000000000
333333333333333333333333333333333030000200100010000330000000000000000003330300333333000000010303330003000333333600000000031000033303333330330000023000000003001300000000
