000000000000000000000000000010000000400001010000000000000000000000000000000000300000003000000000000000000000503000030000000000000000000000000000030000000003000000000000
000000000000000000000000000000000000000000000000000000000030010000000300000000000000000000000003000001300000000050330501000000000000000000000001000000000000000000000000
000000000000000000000000000000000000000000000003000000000000000001000000000000000000000030300000003000000000000000000000000000000000000300000000010000003005010000100000
000000000000000000000000000000030000000000000001000010300000000000000000000000000000003000000000030000000000000000000006000000000000000000030000000000000000000000000500
000000000300000000000000000000000030000000303000000000000000001000000000000100000000303020000000000000000000000010000000000000000030000100000000000000000000000010020000
000000000000000000000000000010001000060100000000000000000200200000100000005000000000000000000100000000000002030020001022220000000000000000000620200000000023000020200060
000000000000000000000000000003333040000003000000000000003333133000500000000003333003000000300000102000010330336331303330000010004000030000003033303300330333333033300333
000000000000000000000000000000100000000000000000300000000000000001001000000000000000000001000000000010000000100000000000000000000000030000000010000100000000000050000000
000000000000000000000000000000003010000010003000000000100000100301001000100000000000000000000001001000001000000000000000000000000000003000050000000030060000300000000003
000000000000000000000000000006000000003000000000000000000000000000001000000000000000000000000000000000000000011000000000101000010050000000000000000000040010000000000000
000000000000000000000000000000000000000030000000000000000000000000000000000000000000000030000600000000000000000000000000000000000000000000000000000000000000000000000003
000000000000000000000000000000000000000000000000000000000300000000000000000050000000000010000000000000000000000033000100000000000500001330000000000000000000310000000000
000000020000020220200022000020100050220000010600002202016000000000000000000000000000000000020000020000000022000002200000000000000000003000023000000001000000000000000001
333330333333333333333333333303330303333330000000003303033333333000003003303030000000333330333333330000000303330303333330303303001000000000000000100000000000000000000000
