000000000000000000000000000000000000000000000003000030010000000030000100000000000000400000001000000000000000000100000000000000000000000003000005000000000000000000000406
000000000000000000000000000000100010000000000000100002000001000006000000000000000000000000000006000000000000000000000010000000000000000000000000200000000000130000300300
000000000000000000000000000000000000000000400000000100000000000000000005300030003000000000003000030000000000000000000000530003001000000002000001000003000300100004000000
000000000000000000000000000000000000500100010000000000010000000000000030300030000000000000030000333000000100010000000000030000000000000300000000004333010310005000000000
000000000000000000000000000000000000000000000000000000000000033000050033330000000000000000033030030000000000000000000000033000000003300000000000103303300000000000000000
000000000000000000000000000010000000000050000200600000000000003000000333300000000000000000033330030000000000000000000003333010000103300000000356033333300100000000240000
000000000000000000000000000033333300000000303333300300003333330100000110330000060000000000003330030000000000000000030003103003003003100000000333003334100300000003330033
000000000000000000000000000030000000000000000000000001000000000300000000400000300000000000000000000000000000000000000020000000010000000000000000330000000001000030003000
000000000000000000000000000005100000000000000000000000000000000000000360000011000000010000003030000000010000000000000000000000000000000000000000000000000000005002000000
400000000000000010000033000300000030030003000000000110000000000000000040000000000000001300201000600000000000000000000000000000000000000000000000000000005000000000000000
000000000000000000000333000300000001300000000000010000010000010100000000000010000000000005050000000000000000000003000000000000000000030000500000000000000000002000000000
000000000000000000033333300300000000133000000000000000330000000000000000300000000000001003300000000000000000100000000000030000000000000000000000000000030000010000000000
000000000000000000033333300300000003333003000000000000330000003000000000000000000000000003301000000300003000003000000000000000000000000100000000000000000000000010000000
333333333333333333333333300300000043103000101000033331330000001303335033003330000300310333000000003330333330133330333033330333000000000000000010000333033000000000010000
