000000000000000000000000000000100000000000300100033003500000003333030000000000000100000000000000000000033030235000000000000033000000100001000000000000000000000330000003
000000000000000000000000000000000000300000000000000010301000000003000000000000000100300000000003000000000000000000000000100000005000000000000000000000000001000000000000
000000000000000000000000000000000000001000000000000030000000000000410000000000000600000000000000000000000000400000030000000000000000300000000030000000100000000000000000
000000000000000000000000000000000000000000000000000100000000000000000000000000004000000000000000000000000000000000000000010100000000000000000001000010000000000000000000
000000000000000000000000000000000000030000000101000000000000000000000000000000300000010000000010000300000000003060000000300000000300000000000000000000000033000000050003
330030000000000000000000011133000000000010000000000001000000001030000060000006000300000000033003000003000030034000000000303000300000030000002000000000000000000001000000
000000000000000500000000000000000003333333050100000333030500000000033033300030000000050000000000001000000303036000000000100001000000000500000005000303330000003000000010
000000000000333333350000000000000000000000000003000100000000003010100000000000000000000000000000001000000010000000000000333300000000000036000333003000000000000000003030
000000000000000000000000000000000000000000000000300000000000010000000000000003000000000000000000000000001303000000300000001000000000000000000000000000100000000000000000
300000000000000004000000000000000003000000000000000000000000000300000003000000000003030000000000003000000000000000000000004000300000000000000004000000000000300000000030
000000000000000000000000000003000000000000000050000000000000000001000000000000000003000000000000000000000000000100000000000600000000000000000100000000000100000000000000
000000333000000000000000000000000000000003010000000000303306000000000330000000000000000000000000000000003000000000000000001030000000300000000050000030100000000000000000
000000300000000000000000000000003110000003300000000000000000000000000000003000000111000310000001110000003000000000001110000000000000000000000031000000104000001113000300
000000000000000033333333333300030010000000000000000000000000000021000000000303010000000600000000000000000333333100000000033333000000033333330033330050000000000000055000
