300000000000000000000000000000000000000003000000030000000000000000000000000003000000000000030000000000000000100000030000000000303010000000000000000000000000000003000000
000000000000000000000000000000010000000000000000000000005300000000000000000000000000003000000000000000004000006000000000000000000000000000000000000000000000000004001000
200000000000000000000000000050030000000110301010020000000000000000010000001000000000001300020000000201000000011002000000540000000011000000000000000001000000000002000000
000000000000000000000000000000200020000000660000000000000000000360000000000000000000000000000000006600000000000066000000000000000100000000000000000000000000100000000000
000000000000000000000000000000000300000006660100000000100000000660000000000000001000000000000000006600000500000066000000000300000000003000105000001000000010000000000000
000111110011110000000000000000000000000000600000003010011001310660200100000000000000101000000011116000002000000066020020000000040000000000602000000202000100000000000110
000000000000000000000000000000036333030333333303000000000006000333030300333330000030033333300000003330303330303333363130000000103313300500030000005110333300000000000010
000000000000000000000000000000000000000000000000000000003000000010000000001000000000000000000000100000300030001000000000000000000000000000000000000000000000000001300010
000000000000000000000000000000000000001000000300000000003000000000000000000000000000000000000000000000000000000300000000030000000000000000000000000000000000000000300000
000011000000000200000001000000000000000010001000000006002000000000000000003000010000001000000000000000000060000020000001000000001400000004000000013000000002000000000010
000000000000006600000000000000000000000000000000100000000100000500000030000000000000000000000000000001000000000000000000300000000000100100000000000000000066006000000050
000000000000006600000000000000000000000000000000000000000000000000000000000010100000060060000000000000000000006000000000000000000000000000000000000010000006000000000000
000000000000006602002202000010011110000000202000000003000001111000000000500000022030000000010011110000000000000100011010000111202000000020000000000000000461620121000013
333333300033333333333333333310000003000100033303301000000000000000333030000000133303000000000000000003033000000000000000000000333303000030330333303000303330030330000000
