000000000000000000000000000003000303330300000000001000030003000503300000000001001000000000003003000000000600000000000060010000030000100000030000002000031000000000330300
000100000000000000003000000300050000000100000100000000000000000000000010050000000000000011305000000000000000000300050000140000000000004000000001000000000100050000000000
000000000000000000000000000000000003000000300000000010003000000300000000000000000100000000030000003103003000000000000001000000000000000500000004000000000000030000000000
000000000000000000000000000000000000013000003003000000000020004030000000000000000000000000300000000020004000601000000000000000000300000000000000000000000000000000000000
000000000000000000000000000000000000000000000000000010000000000000000100003000000000060000000000300000000000000100000000000000000030000000000000000000000000000000003000
000000000000000000000000000000000030000000600000000010000000030000000000000330010000000000000000003000000000333300000030000000000000000033330000060000100000000330000000
055500000000000000000000000003033333300500050500000000003333303130000333330000000000000000033000033330300303323333303330000000000000333303300565000006000033333033300000
333030000000000000000000000000000000000000000000000040000040000003000100000000000000000000000000000000000000000000000003330300000000000000000100000000000000000010303000
000000000050000000000000000000000010001000000000300000000000000000000300010000003033006000000000000001000000050000000030000000000000000000000000010000001000000030000303
300000000000003003000000000000600000000000000000030030000000015005000000000000000000000000000000000000000000000005000003020000100100300001000000000300300000000000000000
000000000000000023004000000000001000000000000000000230040000010000000000030000000010011000200010000000000000000000000000000300002300000000001000000000300000200000000000
000000000000000000000000000003000000000000000000000000000000000000000000006000000000000000000000000000003100000000000050000000000000000000053000220100000000000000000000
000000000003033000000000333300033330303000000000030000000000333000000000000000000000000100000033030001000000000000000000000000300000000000000003333000000000000000010000
330000333333333333303333333363303330000000000000033003033333333000000000560000005000000000033333330555000000000000000003300003133330305000013303303033330300000000000000
