000000000000000000000000000000000000000200000000000000000500000000000000050000300000000000000000000000030100000000030000000000000000000000000000000000000000000003000000
000000000000000000000000000001000005050100000000000310000000000000300000000001003000020000005000000000000000100000000000000000006000055500000000000000000000000030001000
000000000000000000000000000000000100010300130000000000000000000600000001000000000000004040000100000000000030000200000000000030000000000160000000000000000010000003000000
000000000000000000000000000000030000000000000001000000000060004000000000000030000000000000100100000000000100000000000000000000000000000000000100002000000000000000000000
000000000000000000000000000000000000006006000000000001000010000000000000000000100010000000000000000000000000000000000000000000000100003000000000020000000000000000000000
000000144000000000000000000000033000000000000003344000000000000000300300010000000000030000000000060000000000303300100000000000000000603000000000000020000000000060000000
000000000000000000000000000000000003130303333300100000010300000010000133333300000000330333303333030200000333333333333030000000000000003033330333333003000000000000000000
000000000000000000000000000000000000000000000000000000000000000000000000000000000000000100000000010000010000100000000000000050000000000000100000100000000000100000000000
555000000000000000000000000000000000000000000000500000000000000010000055500000010000060000000420000000000000000000300000000000003000000000001053000100010000000000300000
001000004440000000000030000000000000414000000000000010000300000031000000100000440300000000000000000100000000000000000000000000040400000060000010000030000000000000464000
000000000000000000000000000000000000001000005000000000000000000000000000000030000000000000000102000000100000006050000000000000000010000000000000000010500000000000060000
000000000000000000000000000000000000000000000000000000000000000000000000000000000000000000000000000000000000000000000000000000000000000300000000030000000000000100000000
000000000000000000000000003300000000030010000000000000004000000000003300000000000000000000100001000000100440010000000010400000000000001000330000000003000000003030000000
333333333333333333333333333300000000333300303333300000000000300303033333113030100013000004031303330000000000000000000500040000333333333333033333330303130000000003030033
