000000030033000000000000000000000000000000000000000000000000003000100000000000000000000001000000000000003000000000000000000000000000000000000000000010000000000000000000
000000000033303303003000003311101000000033000000000000000000015300000350000000000000000000100003003313003111100000030300000000000003300000000010030000003300300000000030
000000000000000000000000000004000000000000000000030000000000000000000100000000001000300000000100000300100000000000000000030333000000000000000000000030000000000000000133
000000000000000000000000000000100000000000000000001000003000000020000003000000000000000000000000000000000000000020000000000000000000000000000030000500000000000000002000
000000000000000000000000000000000010030000000000000333000000500000000100000000333300000330000000000000000010000030000000000000001000000001000000000000006004000000000000
000000000000000000000000000000000000000000000320000000003300000000000000001000000000000000000000000300000000000000000000000000000000600000050000000000000000000000000000
300000000000000000000000000030330330040000101330000000033633300001000030000000000003000000300000000000000333130000000000030000000000030000003300300000000030000000003000
000000000000030000000000000060012001003300000000000000000000000300300000000000005000010000300000000000100300300000000006000000000000000000030003300000000000000000000000
111110000000000000000000000000000000003030330300300000000111100000330000000003003003000000000000030300000000303000000001111000330300300200000501300300300000030000101000
000000000000000000333300000000000000000000000000000003330000000000000000003330000000003003300000000300333030000030000000000000000300000000000000000000001030005000000000
000000000000000000000000000000000000000000003000060003000000001301000000000000000000100000000000000000000003000000060000000000000000000003000000000000000000000001000000
000000000000000000000003330000000000000000000100000300000000000000030040001000000000030000000000000000000000000000003000001000000000000030006000000000000000331010000000
000000000000000000000000000000000000000000100000000030000100000000000000000000000000000030030000000000000000000000000000000000000000001000000300100000000000000000000000
333333333333000000000000000300050000000000000000000000003333335000000000000000000000333331000000000000000000000000000033303033000000030333000050000000000000000033333033
