000000000000000000000000000000000300000000110000000000000010000010000000000000100000000000000000000030010000000000000000030000000001000006000000000000000000000000000100
000000000000000000000000000000000000000000000100040000000000000000000000000300000000010000000000000000600000000000000000100000000000000000000000000000000000000000000000
000000000000000000000000000003000000000000001030004000000000000001000000000000006000000000000000001300000000102001000000300001000000000030000000030000000000100000000000
000000000000000000000000000000000000000000000000000000000000000000000000000000000000000000066000000000000000200300000003000000000000000005000000000000000010000000000000
000000000000000000000000000003000010003000300000000000100000000000000000000100000000010300000001000100000010000001000000000000000000000000000000000030000000000000000000
000000000000000000000030000003000000310000000020300000000000000000031000200030000000150002366000000300000010005000000000300000000000003000000006220030000000000000000000
000000000000000000000300000003333333300000303303300000000000000000000030330331300100303333303333303033303300100000000003133133000000030000003033333330033600000000000000
000000000000000000030000000010000000000000000003000000003000000000003006000500000000000000000003000010000000000000000000000000000000000000100000000000000000000000000010
000000000000000000330000000000000000000000000003300000000000000000033000000010000000000000000000003030000100013100000000000000000000000133300006000000000000003300000000
020000000000000003330030000002500000000000000333003010000200005000333003000000000002000000000000000360000000333000100030000100022000100001300000000000000000003300300000
660000000000000333330000000066000300000000030033010000006600000033333000000000000061500030000000000000000053333001000000000000600000000303310000000000000003103306200100
660000000000003333330030000060000000000000333033311003000600003400313003000000000000000030000000000300000303300010000000000000660000304303300000000000000030313306600100
660000000002233333330030000061000001000000333333000000006600000003303003004000001000000300000000000000010333003000301035000000660000033333300300000000000133333306600100
333333330333333333330333333333333330000000333333000003103133333333333033303300000003010000010000000000001333033030303030000000330333330303000000000300000033333100333313
