000000000000000000000000000000001130100000000000000000000001000000010000000000006310100000000100000000330000000000000000000033000000000000000000000100003303030000000000
000000000000000000000000000010000030000000000000030000000000000000010000000000000000000000000000000000330000000000000000000303000030000000000000100000030300300000000000
000000000000000000000000000000303030000010000000000000000003000060300000000060000000000000000000000330333002000000000000030013000000000000300000600003330300000000000000
000000000000000000000000000000033130020000100000000050000000000000000530100000000000000000300000000333333000000000000000333303000000003000000000000003033300001000000000
000000000000000000000000000033033300000006000000000000000000000000000000000000400001000000000000003303330000000000010003000003000000000000001000003333033301000000000001
000000000000000000000000000333030330000000000000300000000000000000000000000033300033000000020000003333333000020000000003330313100000030060330000000333333300000000000033
000000000000000000000000003330333331003000000003000000003333133335333300000330330333000006033333033315333333133300000330631303033033300130330010000331330333030313333300
000000000000000000000000003300000000000000500000000000000000000000003300000300000000000000000000000000000000000020000000000100000000010006010000010000000030000000000000
000000000000000000000000033300500000400030000013000101000010000000033300000001000020000000000000001000000000000000000300000100000000000000000000000000000000000000000000
000000000000000000000003333300000100003030000000000000000000000003333300000004000000000000000000000000000000000000000000005000000050100000030000000000000000000300000000
000000000000000000000033333300000030000000003010000000013000000030333310000000000000000000000006000000500000000000000000000000000000000000000030030000000000000000000100
000000000000000000000333333300000010000000000000000000000600000333300100300000000000000300000000000000000010000000000006000010003000000001000001000000000010000000000630
200000000000000000033333333300000000000033200000000050000000000333033000000000033000000400000000130000000001003300000000000000203000000000000000000030000000000000000000
333333333333333333333333333333353333303333333333000010030003000301003100000400000000030010033003030000000000000310000000002000330033300000100100000010003333300330000060
