003100000000000000000000000000000000000010000010000310000600000000000000000000300000003000000000000000000000000010310006000000000000000000000000600000000030000000000000
000000000000000000000000000000000000000000000000300001000000000000000000000100000000530000030000000000000000000000000000000000000000000000000003001000000010000000500000
000000000000000000000000000000006000100000000000010100005000010100000001000000000410000000004014400301400100000030000000000000000500000000000001000000000100050000601011
000000000000000000000000000000000100032100030000000000000000000000030000000000000003000000000000000001000000500000000000000000005000000000000000060000200000000000000000
000000000000000000000000000000000000036000000030000000000000000000000000000000000001000000005000000000000000000100000000000010000000000000000001005006605000000030000000
000000000000000000000000044400000000000000000044400000000000000000040400001000000010000000000000000200000000000000000000000003000044400000000000444000600000100000221010
000000000000000000000000000033000000330030000100000000000600000000000000000023033330302000003330333333333330003300000000000010000000033003330000000301333330003003033330
000000000000000000000000000000000003300300100000001000000000000000300050310000000000000000000010000000000000000000000000000030000001000000000000000005000000310100000000
000000000000000000000000000005000030000000000000000000000000000000000000000000000000000000000103001001000000510000006000003000000000000000000000000000000010000000000000
000144000000000000001000141116003400000000000000000014110000001000000000001000001441000000000000000000000005000100010010001440000000100000300301440001003000000000000000
000000000000000002000000000000000000000020000000003000100300210000000000000060000030000000000000000000000000060000000003000000000200000000000010000114000300000000000000
000000000000000066000000000000000000010030000000000000001100000030000000000000000305000600000000000300030000000000000060100000006600000000000000000000000000300003300000
000000000000000066000022000000000000000000000000000200000066000000000000010100220005006600000000000003010000030001200000000000006600000000000000000000000000000000000000
333333333003333333333333333333333330000050000030003333330033333330030330000003330303333333000000000000000000500033333303333033033333103000603333333000000000000000000000
