300000000000000000000000000036000003000000000000000000000000000310000000000000000000050000030000000000000020000500000000001000000000000000000000000000000000000003000000
000000000000000000000000000010000300000000000000500010000000000010010000000001000060006000100020000000000000105300000000005000001000550000000000000000000050000000000000
000000000000000000001000301000010010000000100001111010000000000005000011100002000000000000000140015503000100000100000000000000101001111011000110000001000010100000000030
000000000000000000001000010100000000000000020010200003002000000000300000000000000000000000000000300000401300000000003010000010000000000000000000000000000100000000000000
000000200000000000101001110100001010000002330100000600000000000050000300000000000003000000000000010010101030000000001010100050330000000000000004000003013101000000010002
000000000000011011111111111110111110000000000300000000010000001000000000000050000000000000100000001013110000000000011100000330000000000000000030000100110100000000000003
000001100000000000000000000000000100000010000003333330030000000000001133333333300000000100000000003000000000003300010000030000010000330333333031333000000033303033100010
000000000000000000000000000000000010000000000300000000000010005000040000600000000000000000000000000000000000000000000003000000000000000000000000000000000000000000000010
000000000000000000055500000000000000100000000000050000000000300000000500003000300000000000000000000000000500000010000000000000000000002000000000050030000000000000000005
111000000000001000011111110000000200000000000300011113000000010100001111111000000001110000000000010000000101110011000001600000000000000030100000003500601000000001000011
000000000000003000000000000000000000000000000010100000000005101306000000000000000001100000000000010010000000000000000000000000000000000050010000000000010000010003000000
000000000000333300000000000000000330000000001110130300000011011330000000000030000101060000000001000300033000303000000000000002000010000111000000000001010000000330300000
000000000000300000000000000000000300000000111110120000061011013000000010000001010110100000010111010001030000000300000000000000006000111111110000001111111100000600000000
333333333330000000033333333300350010100000000000436333330000000000003330333030000000330400300300003333000336333333013330000010000010000000000305000000000000330000300033
