000000000000000000000000000000001000300000000000000000000000060000000000600000110000000000100000000030000000000000000000000000000000001000300000160001000000000000100000
000000000000000000000000000000301000000000060100003000000000000000000000000000100000030010000000000000000000000000001000001000000000000000000000000000100000000000000000
000000111140155300303111111100300110100001030000311140051111111100000011410000010001000011000000001114010530000053033031101113000000000100010111111100000101140150000000
000000000000000000000000000000000000000000000020000000000000010000000000000000020000000010000000000000000000000000001000000000000000000000000060000100000000300000000000
000000000000000100100011000000000000000000010013000000000103000000010000000000000000000000000000003000000010010001001000010000310000000000000000000000000000000003000000
000000005000000000001111000000030030000000000000005005001110000000000000001000000000000303000600000500000000000100000011110000000000100000000110000000000000000003000000
000000000000000000000000000033300330000001200000010005100000000030000333303133000330300333300330000060000000000010000000000033333333332003330000105000000006000003333330
000000001100000000100000000001100000000000000000000000000000000010000000000000000100001010031100003001000000000000031000000000004000000001000000000002000000000000110000
000000001000000000100000000002000000000000300000300000000002000000000000000000000100000000001000000000000000000000000000000001000000000001000000000000000000030000000000
000000000100010000111114100000110000101111000000011410515000003000000010140155000115111111100100011141000000000011140101101000001000100000110000111134100053003030000001
000000000000000000000000000000010000001000000001000000000000000000000000000000300050000003000000000000000000000000000000000000000000001000000300050000000000030000000000
300000000000000000000000000000000000110030300000000000000100100310000000000000000000010000000000000000000350000000000000000000006000000000000600000000000001000000001300
300000000000000000000000000000000001110000300000000300000000001300000205000000000000011000003000003000000300100005000000000000000030010000003000000000000000000010003000
333333333003333333333333333333300330001000333331303330330000000031300000000003030033000000033003333303333303333300200000333333000000033333333103133033333300000003000333
