000000000000000000000000000000000300000040003000000000000000000030000000001000000003033300000006000000300000000000000014000000000000001000000000000000000000000000000000
000000000000300000000000000000000000003000333300000001100000000000510100000000000003033300030000000600000000003000000000000000000000000300300000030000000000000000000000
000000000000000000000000000001400050030000331300000000000000000000030000530000030010333300300000030000000000000000000000000300000000000003003300030000000000050100000310
000000000000000000000000000000100000000000033300000000000200050000000000000000000000033300300000030000000000000000000011006000000000030063000006000000000000000000000000
000000000000000000000000000003000300010000033300000000000000000000000000000000000010133350060000330000000000000000010033000000330000000060200101050000000000010000001000
000000000000000000000003000000000000000000330000600300000030000000000000000000000300333300010006330030100003000041013300000000000000000066000000000000000006000050000000
000000000000000000000033300030030330000000333303003030000333000000310000000003000300303303333303230000000033300033303330333333500000033033330003000000000003303020333000
000000000000000000000033300010300000000000010000030005000000000033300000000000000000003000003000000000000000003200400064300005013300010000000000000001100100000000333000
000000000000000000000333300001000300002000000000000000001000000333300000000000000000000000010000000000000000003000000000000030533330000100000000000000000000000003333000
000020000000000000003333300000000000000031003000000002001000000130000000000000000000015020003000000130000000000000000000000000303300000000000003000000000000010003334000
000660000000000000003333300030000000100003000000000006000000000303300000000030006600000060000000010000000000000003010000000000030000000003000000000000600000001033003000
000660000000000000033333300000000000000033000000000066000000001330300060000330006000000660000000000000003000000000000000100000333300000000003000050000660000000330030000
000660000000000000333333300000000000001030000000000066130000000300313010000030006600000660100000000000000000003000300005000000330000000000100000000000660000003003303100
333333333333333333333333303300300003303333000000033300033303303100303033333033330033303313303333340000056000000503330000000000333003300000000000130033330330333333133030
