000000000000000000000000000000000000000000000000000100000300000000033000000000000000000000000000000000505100000000000030000000000006300006000000030001000000000003030000
000000000000000000000000000000000000000000000000000000000000000000000000000000000410005000000000000000000000100000000000000000000333300000000030333000000000000000000000
000000000000000000000000000000000000400000000000001010000001000000300000000000001000001500000314000001000000000100010000000003003300000014000033000000100030000003000030
000000000000000000000000000060000000020100006000010360000000000006600000000000000000000000000000000000000000000000000000366000330300000000001031300006000000000000000000
000000000000000000000000000000000000000000000003300000000000001000003300000000000000000001000000000000000000000300000100066033333000000000003330303006003300000000000000
000000000010000000000000000000000000000003000603310000200000020006603300010040100000000000020000000000000600000000000500060033303300000000003030000001603300060000300003
000000000000000000000000003300000000000033333313333003330333300343033300000000000033000003333333003331303000000000000303333031033000003031303331000333030000000030300000
000000000000000000000000003300000030000000000300000003330010033000000000000000000000000103300010030000100000100000000000000040000000000000000000000000040000000003000030
000000000000000000000000333300000010000000000000000033310003333100000000000000000000000333000000000001000000100000000000600000000000000000600000020000000000000000000100
000140000010000000000003330000000100000100000000000031010333301030000000014000000000003331000000000000000000000000000000000000000000000013000000000030130000010000000000
000000000000000066000333330001000005000000000000030330003333303103000000000600003003303330000660000000000000030005000000000000010000000000000000000000000300100000000000
000000000000000066033333330300050000005000600000033333033303300000000000000000000000330300300160330000100000000003003000001004000000000000000000000000000010000000006001
200000000000200066033333300010000002000000000100033330000333000000004020300000000000133300000100330000000101103000010000050001000006000000200011000000002020000000000000
333333333333333333333333000000000003330330000000033000003330000000030103330301003000333000033333330000000000000000000000000000000000003303330100000003033133333330000030
