000000000000000000000000000001000000000600000000030000000000000000000000000000003000050000000003100005000000000030000000000000000000030000000000010000400000000000000100
000000000000000000000000000000000000000000000000000000000000000000001000000200000000000003000000000000000000000000000000000010000000000000030000000000000000000000000000
000000000000000000000000000030060000000000000000001000000000000000000000000330006600000000000000000400000000103000000000000000000000000000300030000000000000000000000033
000000000000000000000000000000036000000000000130000033301000000003000000000061030500000101000033300300000000000003000000000000030000000003106000000000000000000000000000
000000000300000000000000000000066000030200000000000333030030000000000000000003306601000000001330330000000000030000300000000000000000003333031030000000000000000000006300
000000000000000000001110000000066000020051110000000033000000000000030000000000000000010010000033001100001000000010000001000000000000003030400000000000000111000030000000
000000000000000000000000000033030330000010003000000030000005100000000133333333303300000060000030000000100333103300400000000000033333300030001000400000000000000003333331
000000000000000000000000000000000000000100000000000000000000000000000000000600000000010000000000000000000000000000000000000000000000030000000000030000000000000000000000
000000000000000000000000000000000000000000000000000004000000060000300000300000500000000000000000010000000000500000600000010005003000000000000000300000000000000030000000
000000000066000000033000003000000000000000000000000000030003003000100000130000000000000000000000000000300030060030000560000000000600000000010001000303003000006000000000
000000000066000000000000333000000000000000000000000000000000000000000000000000003360000000000000000000000000610000001000000000000660000000000000000000033000006000000000
000000000066000000000033333300000000000000010000000000000100000000000000000000003033000060000000000040000000660000000010011000000610000000010000000003300300063000000001
000000000066000000000030330000000010000010000200001000001100100000400000000010303300004000100000030000300000060000000000000001000660000005000000000030330000066000000000
333333333333333333333000300000000006033333303313300000000000000333333300000000000000000000333333330000000303333333330100000000333341300000003300133000000013313330001000
