000000000000000000000000000000000000000000300000000000000000330006033400000000000006000000030100000000000000000300000000000000000000000000000000006000000000000003000000
000000000000000000000000003000000000000000130000030001000130000000000000000000000000000010010100000000000000100000003000000000000000000000000000050000000000000000000000
000000000000055000000000000000000050333000000000000061000300000000000000000000000000000000030000050000000503000000013500000000501000001003000000000004010500030000000000
000000000000000000000000000000000000330300000000000000000000000000000000000000000000010000000000000000000000000000000000005000300000000000020000000000310400050000000002
000000000000000000000000000000000003300300000000300000000000300000000300030000000000000030000000000000000000000000000033000000000000000100010000600000000000000000000000
000000000000000000000000000000000003330300000000300000030000300410300300000530000000001000000000002020600000000040000030000000000000000000030000000000000000100000000003
000000000000000000000000000000000003233333300333300000003333030303333303303330060003333133300000000303333000030000303330000000000000033300330000000003000000000003333033
000000000000000000000000000000000000000000000000000000000000000000000000000000000000000000000000000000000000000000000000000000000000000000000000000030006100300000000000
000000000000000000000000000000000000000000060003000000000000000000000000000340000060000000000100000000030000000000000000000400000000000000000000000000000000000000000001
000000000000000333300000000001000000000000000000050000000333300500000000000000010005030330000000000000000000000001000000000000003330000000150000000003330030000005000000
000000200000000333300000000000000100000006000000000000000330300000000040000000000000003330000000020100000000000003100000000000000330003040000310000033330000000000000003
000000300000003333300000030000003000010000000000000000003033300000000000000000000000003330000000030000303000000000003000000000033030000000000000300313300100000030000000
000000300000033333300000030000003000000000030000000010003303130030000000000000000000330030000003030000000000000000003000000050333330000500000000600130300000066030000000
333333303333333333333333333303333550000000000000000000003301330000000000000011000000003003031330330000000000000033333330000060303333303500003513333330333303330340303000
