000000000000000000000000000000000001003000000000000000030010000003003300000000000000600003300014303000006000000000000000050000000000000000000000000000000000000300000000
000000000000000000000000000000000050000000000000000003330000000000033300000011000000100003300000000000005000000000000003001000000000000100000000000000030000101000000000
000000000000000000000000000000000000030000000300001005330010000000033300030020000000000033000000000000000000000000000000000000000000001000000000000100000000000000000100
000000000000000000000000000000000000001000000000003030330000000000533300000003001000030033300000000300000000004000000000000000000000000000000000000000000000000000000006
000000000000000000000000000000000000060000000000003330300000000031333300000600000000336330300030000000000000000000000000001000003001000000100000000000000000000300000066
000000000000000000000000000000003000000000000102000133310000000033330002210600000000033033000000600000000000010000000061000000616003000000001000000000000000000000220000
000000000000000000000000000350100003000000000060033333333333330333333333303330000000030333310040000033231000000000030000003333001000300000003130303000000030200003330303
000000000000000000000000003300000001000000000000030000000000010004000000030000100000010000000030000000000000000000300000030033000003000001000000000000013300000340000000
000000000000000000000000033300000000000000000000100000000001000000000000000000000000000000000100003010000000000000000000000330000000100000000000000010033010000000000000
000000000000020000000000033300000000003000000000000000020303000000000006000000000003000000000000000000000000000210000010003333003000000000020006000000033300000050000000
000000000000660000000030333300011000000000000001000002660000003000000002000000000000100000000000000000001000006000000000330303000000000000600000000030333300000000000000
000000000000660000000033333300000000000000000000000000663000000000000000000000000000000000000000500000000000000600000000333000000000000000660000000033333000000000000000
000000002200660000000033333300002000000000000000002200660001000000003000000002000000000000130000000510000022006600000000303003000001002200060000000031303000001000000020
003333333333333333333333333300330330000000330334330333330300003004000000000330033303000000000000033333330330333300033330333303000000030033030000003033000301333330000000
