000000000000000000000000000010000000000000050000000000000110000000000003006000000000000000000000000000000000000000060000000000000003000000000000000610000000000000000000
000000000000000000000000000000000000000000000003000000000000000000030000000000100000000010000000003000000000001000000000000000000000005000000000000000000000000000000000
000000000000000000000000000000000000000000000000000000000000000010000000000006000000000000003000000030000100000000100000060000040000200000000001000000000000001000000000
000000000000000000000000000000000000000000301000004000000000100000000000000020050000050001601000000000000000000000000000000000030006600000000103000000001000000000000000
000000000000000000000000000004000000060000100000000000000003000000000000000660000301000000600000000000000000000000000001000006000000000000000000001010001000000000000000
000000000000000000000000000000000660000000003000000004000000000030000000000660000300010006601000000000000000000003000000005066003000600000000000000000005000000000100000
000000000000000000000000000033333330300000000065033033330000000000000033103300303333333333000010003030333000010000000003333333333333330030333330433000000000000003333303
000000000000000000000000000000000000000000000000000300000000000000000000000000000001000000000030000000000003000000000000030000000000000000000000000000000000000000300000
000000000000000000000000000000000000000000000000001000000000000005000000000000000000000000000000300000000000000000000000000300000000000000000000100000000000000000000000
000000000000020000000000000000000000000000000000100000021000002000000000000003000000000000000000000000000000000000000010000000000000005540000000000001000200000030000000
000000200000660000000000000030000000000000000000000000666000060000006000000000000010005000000000020010002000000000000000006000100000300000000000300000100600003000000002
000006600000660000000000000030000030000000006000000000060000060530000000001000000000000000000010360000000000030000000000000000000100010000000000003000006600000000000060
000006600000660000000000000000001000000000000006500000600000006000000000000010000000000000000000660000000600010000000000005000000000000000000005000050004610000000000060
333333333333333333333333333300000000100000300333303303333333333000000000000003333033000000000333305000000303333333333300000000000000000000000000000333333300000003303333
