000000000000000000000000000003000000010000001000000000000000000000000000000000000000000000103100000000000000000000000000040000000000000100000000003000010000000000000000
100000000000000000000000000010000006200000030000040010003200000000000000000000000000000000000030001000000000000000000100000000000000030000003000000000000000000000000000
010000000000000000000000000000000000600000301030301000006600100030000000000000000030000000000000000003000000000066000000000203000050000000000000000000300000000000000000
000000000000000000000000000000000006000000000000000000006100000003000300002000011000000000000600400000000000100006000000000600000100002000000003000000000000552000000000
000000000000000000000000000000000000600000000000001000000630050000010000003030006000000000030066003000000000001366000030000600300000001000000000600000000010010000000000
000000000000000000000000002000002206600000010000000000006600006000002020000003006600300000011006000000000000000066000000023620210000000000000006600000000020010100000000
000000000000000000000000000000000003331333000000000000000333030000000033030300003303000000000003030000000000000500333633330133300331000003000000430000000030063300000000
000000000000000000000000000030300000000000100000000000000000210000000000000000000001000000000000000000030000000000000000500000000000000001000300000000000000000000300000
000000000000000000000020000000000001000000000055000000000060000000000000000301000003000000002000000000000000000010000000000000000000000000000001000000000200000006014000
000000000000000000200660000000002000000010000000000000030300000000000000000000100000000000166100000003000030020001000000000000000000000000040000006000020066300000100003
000020000000000006600660000000060000050000000020000000000000000000000000066030100000100000066000000000101000601000000100000000000430000000000000000100010066000030000000
000000000066000006600660000000006000010600000000000000000000000000000000064000000005000000016000000000000000660000000000001010000660000030000500000000560006000000000000
200000000066000026620660000000206200006600200300000000000000000000000000266200000000000002016000012110000010062000005000000000000000000010200000000002663066000000000000
330333000033333333333333333330330300003003330033000000000000000000000036330030010000000000030333133303330130036300003000000000000333300000000000050331303303333330000000
