000000000000000000000000000000000030000000600030000000000000000000000000100000000030000000000010030000000000003000000330000000000000000000003000100300000000000333001000
000000000000000000000000000006000000001000300000000000000000000000000000000000000003000000000300000000000000033300003000000000300010000000000000000300000000003330000013
000000000000000000000000000000000000000006000000000030000000000000000000000000000333660000030000000000000000033000000030000000000000000003300000000030000100003331000000
000000000000000000000000000000010300000000000000000000000000000300000000000000033333060000000000000000000003010300333330000300000000000000000000600000000000031330000000
000000000000000000000000000000030000030000040001000005000000000000000000000000030333660003000000000010000033330303330330000010000000000000000000000000000003003330000000
000000000000000000000000000000000000502003000000010000000000000000000300000003303303660000010001360200133330030333333030000000000000000000010002003000000033130300000000
000000000000000000033300000030000003033303033033330000300000000040003300300003333330330030630000000000000030333350333330000000033003300000003033033030303353033333303000
000000000000000000033000000000000000000030000000016000000000600000000003000000300000300000000000000000000000000000000000000000010000000000000000000030020000003000000000
020000000000000000333300000000000000000033000000002000000000000300000002000000000000300000000100000000000000001000601000000000000000000000000000010020000000000000103000
660000000000000000333000000000000040000333000030066000000100300000000036031001000005000000000000000000000000000060000000000000000010000000000000100606000003000000000000
660000000000000033333000000030000300033333000000066300000000000000000066000030000000000000000000000000000000000160000000000000000010000000000000000660000000000010000000
660000000000000333333000000000000001333333000060066000000306001003000060000000000000000000000000000000000010000063100000000000000000000000000000000660000000000000004000
660000000020033333333000000030000001330331000050006031000002113000000006000000000000000000000020100000500100000066000003003000000000000020031000600561000000000000000000
330033333333333333333033333300000003303303300000033003333333333033033333003003000051033331333003330000000000001333003133000000000000333330330004000332001300000330100000
