000000000000000000000000000000000012000000000000000000030033000060000000005000300000000003000000000000000000000000000000200003000000000000000000000000300300000000000111
000000000000000000000000000000000000000055000050000000010000000000000110000001000001060030000000001000055000000000000000000333000005000000000000000400033300000000030000
000000000000000000000000000000000000000000000000010000000000000010000000000000000000000030000010300000000010000000000000003303001000000011300000000000033300000000001110
000000000000000000000000000000030000000300000001030000000030020010000000003000000000000000030000000000000020000000000000030330000000400100000030005003330000000000000000
000000000000000000200000000000000003210000001001000000000000000000000000000000000200000000004000300000000000010060000053033000000000060000000000200330033000000000000000
000000000000000001111110000000600030000000000000011000000000130110000000000000001011030100000000030000000000000000000003303313000000010000034001110333330000030000000303
000000000000000000000000000300000003033333000000000003030000500000000303303000003000000001003330303300033001000033333303333333333333300330330000000330303030333301333103
000000000000000000000000003300000000000000000004300000000000000000000000000000000000005003300000000000000000010000000000500010000000000003100000000000000000000030000000
000005500000000000000000033300000000000003000033300004000000000000033300000000050000000033303000003030000000000000000000000000000000000000000000000000000500030000010100
000000000000000001110000333300100000000300100130060301130000300000333000010100000000000343300003000000000000000000000000006000010300000000000000000000000040001003000000
000000000000000000000033333300000000003000003303100000000011000033333000600000000030033333300000000000035000000000000000000010000000000001000000000000000103000030000000
000000000000000000000333333300002000003060333003300000000006000333033000000000030000333030000000000000000000000031000060000000000000000002006000000000000000000000000000
000000000000000000003333333300011110000000333333300000030000000033303300000330000000333313300000000000005000111101005000000000000300000011110130000000000000000000000000
333333333333300333333333333300000000100330333003303323033133030330333003303330000000333133300000031333330000000000000000000000000300000000000000003330033000000500500010
