000000000000000000000000000301030000000000200000000000130010000000000000000000000003020000003300100003003300005000000030100000000000000000000000033000000000000001000000
000000000000000000000001003111010000000020001003101030000000000000000000300000000000100020000000000003000000010000100310000000010000000000003000000000000000000001003010
000000000000300000003031000000000000000000001000000005000000001030000000000030000000000000000151000000010600003303000000000000000050050000000000000000500000000000000003
000000000000000000000000000001000000000000003004000000030000011000000000000000000000005000000000000000000000000003000004000003000000300000000001000300000000000000000060
000000000000000000000000000000300000000000000000000000000000000000000000000000000030000000000000000000000000000000000000000000000000000000000152300000000000000000000010
000000000000000000000000000002000001000000000000000000203000003000000000000001500000000000000000000000000300000000000010000103000000300010000100000000000000000000000000
000000000000000000000000000000000000000000001000000000300103600000000000000000003000030303003000001100000000000000000000000000000000000000000003000330333300000330000001
000000000000033000000000000060500000000003000000000000000000003000000000000003000000310000000000200000300601000300000000000000300300010000040003000100000000000000030003
000000000000000000000000000000030000000000000000000000006003031000000000300000010001000000000000000000000001000000000000000000000000000000000000001001000000100000010031
000000000000000000000000000000100030000000000000000000300300000000000010000000003000000100000000300010000031000000000003000003000001000000000460030100000000000000310000
000000300000000000000000000000000101000003000000300020000010000000000000030000000000000000000000000000003030000000300030000000000400000000000000100000000300000000300000
000000000000000000000000000000000001030000000004000000000000000000000000000000301001000000000000000000000000000000000000001000000600000000000000000010000000000000000000
000000000000000000000000000000000000000000000000000000000000000000000000000000001000010000000000000000000000000000000003000000000000610003000000000350000000000000000300
000000000000000000033330333300000333303333300000000000000000100104000033033330000003030000300000000110000000000030031630000000000003300000000000000000006001000000000000
