000000000000000000000000000000000000000000000000000000000000000000000000000000010030000000000000003000000000000000000000000100000000000000000000000060000000300000000001
000000000000000000000000000030005000000003000000000000000000000000000000000011010000000000000000000000000500000030000030000000000000000000000000001100000000000003300000
000000000000000000000000000000060000006010010000000000001110100011000000010000000000000000000000000000000660000001100000000020660000000000000000030000000000010006000000
000000000000000002000000000000000000000000000000000020000000000002000000005100300000000000010000000000000600000030000000001000000000000020000500000020000000000006600000
000000000000000000000000000000030000000000000000000001006000300010000000003000000000010000000000000013000660300031000000100000660000000000100000000000000000000026600000
000000000000001111101411111100000004101311000033010111010003000000033000000001111101000000000030004110111660102000003000000000060000011111010000000000100001000006000020
001000000000000000000000000000100100000000330000200003003333000030000033330330000000000000000000000000000330033333003200010000030033300000000000000000000030303303000333
000000000000000000000000000000000100030000000000000000000000000100000000000000000000000000000000000000000000000000000000000000330000000000000000000003000000000000000000
000000000000000000000000000000000010031000000000000000000000000000020000000000000001000000000000000000000000000000000000000000100000000303000000000000000023000000000000
000100001100006600000111110000000016300000111000000000000000000000000060000000000000600000001000000001600111010010010000000000330000011111000101000020050010101000000000
000000000000006600000000000000000046600300000000000000000000000000000066000000000040000000000001100000000100000001000100000003000000300000000000000000210000000000000000
000000000000006600000000000030000000600000000000000000000306000000000111000000000000000000000003000000030000000003000000000000000000000000000000000000000000000000000000
000000000003306600020000000000000006000000100001000000000111111000000060000010000000011110000003000000000000100000000003000016411011000000000000330111010140300004111110
333333333000003300333333330000000003300333033000033133030000000001000033003330000000000010003000003033033633300030330033000000000300033333001300000000000330333000000000
