000000000000000000000000003000300000000000000000000000000000000000000000000003000001000000000000000000004000050000000000500030000000000000000000030000000000000001000000
000000000000000000000000000000000000000000000000000000000000000000000000000000000000000000300000000000000000000000000000000000030000000010100000000000000000000000000003
000000000000000000000000000000101500000000000000356000000000001000000300000030300000300000000000000001000033300000000000100000000000000000000000010000000300000000000000
000000000000000000000000000000000000331330000000000000000000000000000000000000000000000000003310000103000000000000000100010000000000000000001000000000003000000000010500
000000005550005550003000000005550000000000000000055500035550003001000000000000505000000100000000000250030000040005050010010000555000000000000000000000000005050000000000
000000003330000000000000000003330000000001000000000000000000021000020000003000333030000000010030001333000000000000330030000000000500000001000000000000000003130000000000
000000000000000000000000000010000003331040033333300000000010000333333300001000006000300300333000000000000000000100000000000000100000003130000000030333030000000000303030
000000000000000000000000000000000060000300000000030000300000000000031000100000000130030000000200010005000000003000013600000300000000000000003000000000001000001000000000
000000000000000000003000000030000300000000000000300010000000100000000000000000000000000000100000000000000000000000000000000000000000000000050000000000000000005001000000
000000003333000000000000000300000000333000000001030000040401000003000000000006300140000000000000130000000000000000001530333100000000000000010000000000000003133300000000
033333000000000000000000000000004000000000000100003000001000020000000000333300000200050000000000000000000000000000000000000000330303000000000333330000100600000000010000
000000000000000000000000000002000003003000000300000000000000000000300000000000003000000000000000000001003000000000000000000000000000001000000000000005000300060000010000
000000000000000000000000020030000000030053000000000000000000003000000000000000000000000000000002000300000000100000102000000000000000000000300000001000000000000000000000
333300000000333303333333333300000000000033030306000300000030030330301030130030000000000000003333330000100000000033333333000033333000000000003033060000000000040030000030
