000000000000000000000000000000000000000030000030000000000300000030000000000000000000500000010000000000000060000000000005000000000003000000030000000000000006000000000000
000000000000000000000000000000000000000000000000000000000003000000000000000000003310000000003000000000100000000000000000000000000000000000000000000000000300000300000003
000000000000000000000000000010000000000400000000000600000000000000000000000020000400000000030110000000000000000210000000000010000000000000000000000000000200660001304400
000000000000000000000000000000000000000000060000000660000000000000200000000660000000000001000000000000000000003600000003000010000000000020000010000300000100600000010000
000000000000000000000000000000000000010000000000000610000000000000000000000563000000000000000000000003000000006600010000010000000000001000000000000000000100366000050003
000000000000000000000000000000000000020000000600010000000000000000000030000600020032000000300000000000000000006600000000000000000000303000000000000000000600660030020002
000000000000000000000000000060300033333303000000005333030000000333313333300303333333000000000000000000003313133300000000000000000000033333110000000333333300333333333334
000000000000000000000000000000300000000000001030000000000000200000000000000000000000000000000000001000000000000000000000000000000600000000000003000000000000000300040000
000000000000000000000000000000000030000400000000000000000030000000000000000000000000000000000000300000500006000000003000000000030301000000000000010000000000001000000000
000440000000020000000006600000001020003000000006100000000006000000000000050000000000000340000060000000000000000000600000004000000000000000000000000000000000000000000000
000000000000660002000006600000001000002100000000000000000066000000300000000000000100000000000360000002050000010000600000000000003000100000160002000000000000000000000000
000000000000660000000006600003000060000000000110000000000066000000000000000000000000000010000060400030000000000000603000000000000000000000003003000000000000000000000000
002000200000660000000006600000000610000000000000000100000060030000001000000003000000002000200660000100000000400000160000000002000000000300600010000000000000000001000000
333333333303333333333003333333403333330306000000000000000000303000000000000000000100333330300310333300333000300000036303013333500000030303303313033000000000000000301000
