000000000000000000000000000000000000000000000000000100100000000000000000000000020000300000000000000000300000006010000000000300000000000000000000001000000030000000000000
000000000000000000000000000000000000000000000000003000000000000000000000001000000005010000000000000001000020000000000000002001000000000000000000000010004000001100103000
000000000000000000000000000000000000000000110600000000000000000030000000500020111100000000200000000130000060000010010000000000000000000000500300000000003000000000000002
000000000000000000000000000000100000000000000040000000000000000000000020000600000003200300600000010006000600000000000000000000000000000000000303600000000000310002000006
000000000000000000000000000000000000000000000000300000000000300300000000003060000300000006603000000000000660000000100000000000000000000001030000000000000000000010000066
000001000000000011100000000000003000000010000000000030000110100000000002003663001004000060601000100000000060000000000000011100000000000133300000000001114000000000060666
000000000000000000000000000000000000000000033303300300030000000000000033033333303133333333300000000000001000002303333330000000000000033033000000000000000500000013333333
000000000000000000000000000000000000000000000000000000300300000100000003000000000000000000000000000001000001000000000000000000000000000000000300401000000000000000000000
000000000000000200000000000000030000000001020000000000100000000000000002001000000000030000360000006010000000000000000000000000000000002000000201000300000000000000000000
111100000000006600000000000203000000004000640000000000000000000000100060000000000000000000040000001013000000000000000020000000010000066000006600000000000010010000000000
000000000000006600000200006600000660013000660000100000003000000100000066000001010000000500000000000300000000300020035660000000000000006000006600000000300000000000000000
000000000033336600000000006600000000000000300001000033330004000000303366000000000000103003300000000000000000000000003610000000000000066000006000000000000000000000003331
000000000333306600000000006600000660000000660000000333003050110003303005000000000000003330000000000000000001110000100660000500000000066000006600000006000000000000036333
333333333333003300033333333330313330000000330003000303000000000333331030000330000000330300000000003300030000000033350310000000000000033000333300003000000533303353331000
