000000000000000000000000000006000000000000000000006010000000000000000060000000300000001000010000000000010000200000000006000000000000000000000000000000001010000300000000
000000000000000000000000000000000000000003000300001010000000000000000010000100000000030300050000000000004010300000000000000000000000030000000003010010000001000000000010
111111111000000000000101000000000000210000101000001000000300000121000000000000000040121000011111110010103001000001000001110111001000000000000060040111111010000001010000
000000000000000000000000000000000001003000000000000000000000000000300003000000000000006003000100000000000500000310000000000000000000000000000000000000000030000000000030
000000000000000000000000000000000000030000010110000000016000000043000000000400001000300000000000005000000000000100000000000100010000060005000000100000000000000000000000
000000000000000000000000000000000000000000000000000000006000000000000010000000000000000000000000000003005000000005000000000000030000060000000000000000000000000000000000
000000000000000000000000000033333333030333100005000001003333213303330033333333330333033333300000000003000100030000000001000000001000003330300333333000000000000001000005
000000000000000000000000000000000000050000000000000003000000000000001000000000030000010000000000100000100000000000000000000000000000000010000000000000003000000030000000
000000000000000000000000000000000000000000000000000000000000000000000000000000005000000000000000000002000300000000000300000000000010000000000000000130030000000000400000
000000012100000000000000004030000001111011000000030000001100000000000000000301111100060000010000000000040000000012100300100000000000000000400000000000000102003010000300
000000000000000000000000000003000301000000000000000000010030130000000000000030000000000000000000001000400000000000000400000000000000000000000030003000000600000000000000
600000000000000000000000000000000000000000600000000000000000601010000000000000000010000000000000000000000000000000003000000000000000000000006000010000000000000000000000
600000000000000000000000000000010000000000600000300000003000303000000000000010000010000000000000000000000600000000000000000000000000000000006000300000000000000001000060
333333333333333333333333333313333330000000353333300000001000000000000000000000000150330333300000000333013333333303333030000000333003333333333333330000000033333033313333
