000000000000000000000000000000043000030000000060000000000000000000000000010000000030000000100000000000000000000000000000000000000300000000000000000000003000000000000000
000000000000000000000000000000000000000000000001000020000003000000000000000020000000103000104000000130000000000000000301000000000000000000000000060000100000000010000000
000000000000000000000000000000000000000000000000000003001000000000000001003030000000000000000000000000000000110000000000000000000000002030000003000000000000001000030000
000000000000000000000000000000000000000000000003300001000000301000100000000000600030023000000001000000000000000000010000000000000000003300000101000000000000000000000000
000000000000000000000000000066000000000000000000000000000000000000003000000000300000660000000000000000000660001001000000000100000000030000000000000000000000000006000000
000000000000000000000000000066010000000000000010030302542000000300000000000000000022060000000000000000022600000000000000020000660000040000223000000000000000000006600000
000000000000000000000000000033033303000000000000033300303303200000000000000403333333130003000000000333333333303300020001000000333333303300330000000000000050010000303333
000000000000000000000000000000000000000000000000000000010000000600030000000000000000000000000000000000000000300000000010000000000000000300010010000010010000300030000000
000000000000000000000000000000000000000000000000000000000000000000000000101000000000300000000000000000000000000000000000300000000000000000000000000000003000000000000000
000000000000000000000000000000000000000000000000000000001000013000000000000000000030000300000000003000000000060000100000000000050000000000040000001050000300000010000010
020000000000000000000000000000000000000001000000000000000000010000000000000000100000300000000000000000000000000000000000000000001000000000000000000000000000000000000000
660000000000000000000660000020100006600000000000000000006000000000060000000006600010000000000000130000000000005006000000000010000000000000006000000000010000000003000000
660000000000222020200660000010000006600000000032200000003600000300005000000003000000000000020100000010056000003066000002020230001000000000000600000000000200000002020000
333333333333333333333333333300300003300305033333000000000333033010000000000003333313000000003333330010000000021033003033333333000120000000003333333303533300000000303030
