000000000000000000000000000000000000000000000000000000000000000100000000000000000000011000000000000000000000000000000000000000000100040000000000000000000000000000000000
300000000000000000000000000300000000000003330000000000000000000300000000000103300000300000030004002000000000000010000000000000001010000500003000000000000060000000000003
000000000000000000000000000000000100000010003000003000003003300000000000000330000000000000060000000000010000000000003000000300001000000303000000000333330000000030001000
000000000000000000000000000000000100500000003330000000000000000000011000000300033330003003000050000000003000000000000100000000050000000000050000000001000000000000000000
000000005555555550000000005500555530000105000000055000000000000000000000000000000000000000000000005550001000000000050550000100555000000400500000010000000050500005001055
000000003330003300000000033303030000000300030200033000000000000000000001000000000000001000000000003300000000202003300000001010330000000003030000000000000003000000000333
000000000000000000000000000000000000003000300010000001000000003003000033353000000030300010010000010000000030000000230005000300000010000000004000001003000300000000000000
000000000000000000000000000000000000000000000000003030100000000030000300000000000000000003000010000000000000000000005000000000000000000305000000000000000000000030000000
330000000000000000000000000000000030000003000030130001000000030000000300000000000000000000310000100000000000000030000000000000001000030000003100300000003000000006000000
000000033333000000000000003301000330000000333330000000000030000001000100100000000000003000000000330000000313330000000003333300000000310000000000000000000010000000000030
003333000000000000000000000000000000000000030500000000000000000000000000000000300000000000011000000000000600000000333300000000000000021000000310030030000000000000000040
000000000000000000000000000000000000000000000000000000005000010300005555500000005515000005503100030505555000000000600001300000000300000300000000000000000000555550000000
000000000000000002020000000000010010000020000000000000300000020000033333030000333010000003000002000303000000060000000000000000000000000003100110000000202003000000000000
300000000000033300300333330033333000000000000000300000000300300000000010001000600000000000033303050005000000000330004000000003333330000000003000000031030000020003303000
