000000000000000000000000000003000000000000000010000000060000010000000000000000000000000000005000000000000000000000000000006000000000000000000030000000000000000100060000
000000000000000000000000000000003000005000000000006000000100030033000000000000000000000000100000000000000000000010000000000000000000000100000000000000000000000000000000
000000000000000000000000000000000000000000001000030000000100040001000000000000000000000001000000000303000000400000000501001030000000000000000000000000000000000004000300
000000000000000000000000000000000000000000400000000000000001000300000000000000300000000000000006000033330100000000000000003330000000000000300010000000000000000000000000
000000000555550500000000000000000600000000000000000000000000000003000003555550500300000000000010000010000005555100000000000000000000000505500000000000000400005550000200
000000000033330000000000000300000010000000000100000500032202000000000000033330000300000000000100000000000001333330000000063000000000000003302202001000610000033330030020
000000000000000000000000000000000000000000033033300000003003030303333000000060000000000030000000003100000000000300000003300003000000000000000333000333333300000001333333
000030000000000000000000000000003003100030500000100000000030000000000000000000000030000000003030001000500000000000000000001000003030003000000000300000000030500000010000
000000000000000000000000000000000000000003300000000000000000010000000001000000100000030000300000000000006000000006000000000000000000030000000000000000000000000000000000
000000000000000000000000000000100000003000000000000000013000000000000100000000050000000000000031000000000000000010000000010000000000000000000300000000000000000000003000
003333040000000000000000000000333350000003000000000000000000000003333000030000000000400000000000000001000000000000000000000000000000000100000003300000000000000000003000
000000000000000000000000000000000000053555000000630011000000650000000000100000000000000000000100000000000000000000000030000000000000015300000010200050100100000000000300
000000000000000020020220200003000000003133000000000200200050003000000000200200000000000000022060100020020000000022020000020000000000000000000000010015000000000030000000
330000333333333333333333303033000000050000333300033303330000000533000303333030000000300333333030303330333000000030330003333333330333300000000300003000000000000000000000
