000000000000000000000000000000000000000000000000000000000000000000000000300000000000000000000000000010000020300000000000000000000000000300000000005000000000000000000000
000000000000000000000000000000000000000200000330101000000000000000010000000000010000003000000310000200000000000000000100000000000000000000000003000020000000000000000000
000000000000000000000000000000001000000000000000000000000000000000400000001000000000000000000000006000000000000000000000000000000000000000000000030660000030000010010003
000000000000000000000000000000000000010000003600010030000000000033660000000000000000010004000000006600000000100000000000000000000660000300000000000660360000000000006000
000000000000000000000000000000000000000000005660000005000006001033630000000000000000000000000000006600060000000000000000000000030650000000060000000600000000000000036600
000000000000000000000000000000000000030000033660000000000060010030660000001000000000000000000100006600000000000000000000000000033630100000000000000600030000000000306602
000000033000000000000000000003000000000000033331300000100000000030230301000003000000000303300000003001330000000000000300000100303033333000000600003330333000000000333330
000000000000000000000000000000000000300000000300000000000000000000000010003003000000000100000000000200000000000000000000000000000300010000000000000000000000000100000000
000000000000000000000020000000000300000000020000000100000000000000000000000003201000000050000100000000300000000002000000000500010000000000000300000000000010000000000000
020000000000000000000660000000300000010000600000000000000200000030000000000006103000300000000000003200000005003066000000300000000000002000030000000000300000000000200000
660000000000000036600660000066000000000000600000000000106600000000030000001000610000003030050000006600000000000000000041000000000000006000000000000001000000000006000000
660000000000000336600660000066000000000000020000400000006600000000000000000006600000030610000000006601000300000066000000000000000000066000000000100000000000000066300000
660000000000000336602660000066000000000000600000000000006000000000000001501006000300033600200011006603000000001006000000010030000000060000000000010000000000001006600350
333330000033333333333333333336333000003303333333301000003133000330000000033333333333033533310001003133006000000033333600003333000000033333000200000000333300000003133300
