000000000000000000000000000010000000000000000060000000010000000000106000000000000003000000000000000004000000000000000000000000000000000000000000000000001000001000000000
000000000000300000000000000000000100000000000030000000000000000010000000000000000000000000000000400006003010000004000000020000000000004000300000000100000000000000000000
000010005000000000000000000030000000000100010300000000000000000000006030300000000000010010030000000000000000000030000000000000000000005003003000000000000000001000000001
000000000000000000000000000010003030000000000000000000000000000000000000000000000001000000000000000000000001000000000110000000000000000000300000033000000010000000003000
000000000000000000000000000000010000000000000100000000000000600000000033310001000000001000000000000000000100000500000060000000000006000000300000003001300000000000000000
000000000000000000000000000003000030000000000003000000000000000000003030030300000100000000003000030000033010000000100030000000000000000003000300063000003300000000000000
000000000000000000000000000033000300000000003333300000010303000033333033313333333333000000033000330003333000030033300330000000033330300001003030003003330300000003303313
000000000000000000000000000030000000320000000000000000000000500004000000000000000000000010300600000000000600000000000000000000060000000100000000300000000040000100010000
000000000000000000000000000000000000000000000010000000300000000000000000000000000030000010000000300000000000100000000310000000000000000000000000000000003000000000000052
300000000000003330000000000000500003330000001000005000000000000000010000000110500000050000000000000000000333331000000003130003003000000001000000000050000000000003310000
000000300000003030000000000010010003030340000000000000000000001000000000000000000400000000000000000000000313000000000003030006000000000000000000000000100000000000010030
000000300000003330000000000000001010030003000000000000000000000000000000000030000000000001000100000000000330000000000000300100003000000000000000100000000000000000331000
030000300000333333000000000000000003330000000000000000000000000000000000000030000000000000000000030000000333300100000313333000000000000000000001000000000000000003330000
333003303333333333333333333333300333303333000000000010000003000000000033300330000000000003010000003305333000330303334330313330100000000000000000000030001000000303303333
