000000000000000000000000000000000200000001001000000000000000000000000000000000000000000000000000000000000000000000000000000001000000200000000000000030000000000000000000
000000000000000000000000000010000100000000110100000000300000060000003000000000000000000000601000000000000000100000000000000000000000000000101111000000300000000000000001
001000000000000000000000000000100001000000101000000003300330000000033000000000000000000000000000000000330000001000001001000000000401000000000011000200000000000000000210
000000000000000000000000000000000003000000000000350301300000005003330000000000000000100000000000000033030003000000000016000301003000000633300000000000000000300000033330
000000000000000000000000000000000006000000000001003003330000000003030300000000020000000000000000000333333000500000000106000031020000001033330000000100000010000000333330
000005055500000000000000000000000002000000100000030303000000000330330000000005350001555600001000003333100003000050000001000000003000003300000000000000000000000000303310
000000000000000000000000000000000000333300003330333330603000000333330000000010000000000000200000003233000333003300000000003300003333306303003333333300000000000003333000
000001110100000000000000000000000000000000100300000000030000000101010000000000100010000000000000111000000101000010100000000360100000001000000000000000003000000000000000
000000011110000000000000003000000000000000000000000000000000000101100001000000010000000000010000000000000111100011000000000000000300000000000000100000000000000000000000
100000000110000000010000033000000000000000000001000100000010000001100000002005000000001000000000100030000000100000113000000000000000000100000030110000000000000000000000
300000000000000030000003333000000000003000000000000000000000000003000000000000000000000000030000000000000000000000000000004000001400000000000000000000000000000000000000
600000000000000000000033333300000000000000100001010000000000000000000000000106000000000000160001000000000000001100000000300000000600000000000000000000000060000003000000
600000000000000030000333330055500041100000003000100000100000050000000000603006000000000001060000000000001050000001000005550000000300500040510000000555010060000000000300
333333333333333333333333330000000000000000300330000000000000000333333330333301333333031001033310000030000033300033133330000000000000000000003333033000000033333030000000
