000000000000000000000000000001000300000000000000300000000000010000000000000000001050000000000000000000100000000300000000001000000010050000000000001003000000030000000000
000000000000000000000000000000020000000000030000300040000000000000000000000000030000000200000100000000000000300000010000000000001000000000030305000000000300000000000000
000000000000000000000000000000600000001000000000011110003300000000000000031100000000014600000005000013000000000000030004111000000000050000001111000030000000000000000000
000000000000000000000000000000365000000000000000000000005300010000000030000000000000006000000000000000000000000000000005000000000000000000000000000330000000300000000000
000000000000000000000000000000660300600000000004000000003300100000000000005000000100006600002530000000500030001030000000000030000000000000000000030330000033000000030200
000000014141000100000000101120660000100000111410000000003300020010003000010000000000200600000001000001100000101100010000000000000000034101000000000330020000010103014100
000000000000000000000000000003300000100000050000033333033033003051000033133630000000330033000000003333303000000043333330333331000000000300000300333030033000300000000000
000000000000000000000000000003040000000001000300000000060000000000000000000000000000030000000000000001000000050000000100000000000000000100000000020000000010000000000000
000000000000000000000000200000000300000000000000000000000000000000200000030000000000000000000000000000000000000000000030000000000000001003003003000000200000000000030000
000300011110003300000006600000030003300000000000010000001110000006600000000000030000011100300000003305000600000033030000000600006400000100000000000006610400000000003030
000000000000003300000006600000000003303000000000000000000000000000600000000030000000030103000000003000001000300103000110600003001000000000000000000006600000000030000000
000050000000303300000006600000005003000000030300000000000000030006000000000000000000000000000000003330000600000033000000000000006600000000000000000006310000000000000500
000100000000003300220206600000010003300000000000000010110000000200600211141000021011100000301005006300220141430000000003011011206600001030006000000206600001000000001000
333333333333333333333333333033333300533133000000000000000333030033003001300000600000333332300000000033333000000033333330000300300300000000000000000333033100000003330033
