000000000000000000000000000000000000000000300000001000000000000000000000000000000000000000000000000000000000000000000020001003000000000030000000000000000000000000000000
000000000000000000000000000000000000000000000000000000000030000000000000000000300000000000000000000000000000000000000000000000000000000000000000000100000000000001000000
000000000000000000000000000000000500010000000000030303300000000116000000000003330331110000031333300000000000000000000000000000600000033331530000000000100000000000010000
050000000000000000000000000000000000500000000000000000000000000000300000000000000000000000000000000000000003000000000000000001050003000300000000000000001000000000000004
000000000000000000000000000000000100000000000001000000000000000000000300400000000000100001001000003000000000000000000003010000000000600000000000000000003000000010000000
000000000444004000000000000000000000030000010000000000000000000000010000000100000030000000000003000000300000000000006001200000000000000010004000050004400010000000200000
000000000000000033300000000033330000030000000000030300330033000300003303030003030003333000331300300003000330360133303003303333502000030100330033300000006033301003331331
000000000000000000000000000000000000000000000000000003001003013000000000000130000000000000000000000000010005000000000000000000000000000000000000000010000000300000000000
000000000000000000000000000000000000000000000200000000000030000000300000000000100000000000000001300000000001230000000000000000000000000300000000000000000000000100000000
000000033333311100000000000000000000060000000000001010000000000000000000000000000000100001000000010000000000000000000000000001100000000000000000000333000105030001100000
000000000000000000000000000000000000100000000000010000000000000000000000000010500000000000000000000000000052000000000000000000000000000000001000000000000005000003000000
300000000000000000000000000030000000000000000000000000000000600300000000000000000003200000000000000010000110000030000000000001000300000041000000001000000000000000330000
120000000000000000000000000000044301000000400100000010000000000120001000404000000000000000000044001200000002000000000000040400000000000000000000000000000000000000000030
333333330300333333333333330000010003333333003330003333030000000033333300000000000000000000000000000300303600000000000003000000013303360330000000000303013300000001333033
