000000000000000000000000000000000000000000000005000003006000000000000000011000060000000000000000000000030000000000000000000000000000000000000000000000000000000030000000
000000000000000000000000000000000000000005001110000000000000000000100000000001000000000000000000000000000010000000100000000000000000000000000000401000000000000100000000
000000000000000000000000000000000000300000030200000043000004000000000003000000000000000000000000000030001000200500000000000000060000000000000100030000200000000000000000
000000000000000000000000000000300000000300006600300000000000040300000000001000000000000200010000000000000006000000000000000000030000000020000000000006600000000410000000
200000000000000000000000000000100002000000006600000000000000000000000020000000010010006604000000000000100006600020000000000030000003000060000000000016600000000000000000
000000000000000000000000000000000000000000000300000020000002303000000000000000000000006600000010100000000006600000000100000000000000000060600000010006600000000200000010
000000000000000000000000005500000000000000030306010303300330033000030000000000010000333333300000550000000003030300000000000000610001033003000000055333303033033130000000
000000000000000000000000000000000000000000000000000000000000000000000000000000500000003003000000001000000000000300011000000110001000000016000000000000100000000000000001
000000000000000000000000000000030006000003000500000000000000000000000001000000000000001000030000000303030000000000000030000004000000000000000000000006000000060000000000
000440000020000000000000200500000000000000000000000000150002005000001000000030002000000100000020000004400000000000000000010000003200500020000000005000000000044000000000
000000000660000002000006600000025000000000030003000060010006000000600050000000002000000000001600110000005000006300000000000300006000000600000006000000000000000000000000
000000000660000066000006600000600000000000000000000660000066600006600005000000006000200000000660000000000000000000000000000000006101000660000006000200100000000050000000
000200000660000066020006600000660200000000000001001660000160000006600000000000066010000000000000000002000000100000020000000000006100000660000006000000000000020000300000
333333333333333333333003333333330330000000000005500031330011333333330300000503033333000000015303303303333001000033333330000055003033333333330033333000000033333300000030
