000000000000000000000000000000000000000000000006000000000000010000030000100001000000000000000003003000020001000000000000000000000000000000000000000000000000000100000010
000000000000000000000000000000040006400300001000000000000000000000010000000000000000000000000000000006000000000000000000001030500000030000000000000000000000000000600030
000000000000000000000000000000000000000000030000306000000000000000000000003000000000000000600000000000300000000000000000300000000000000000000000000000000000000000000003
000000000000000000000000000000000000000000000000500000000000030000100000033000000000000020000300000000300000000030002000000000030000000000000001000000000000000000000000
000000000000000000000000000000000000000000000000000000000000000000000000033000006000000000000000000003316000500000006030000100000000033000000000000000300000000000000000
000000000000000000000000000000000000000000000000000010000030000000000320030102006600201060000001102003300000000020366000000000000000030000000000000000000000003000000000
000000000000000000000300000030000005000000000000030331310030000300000033033133323330300330030000000330333033333333333300000000000000031303330030000000300400010000000603
000000000000000000000550000005000000301000000000000400000000000550000000000000000000030000000000000000000000000000000000000000000000000000105110000000000000100000000000
000000000000000000000300000030000000000000000030000000000000000300000000000000000003000000030000000000000000000000600000000000100300000000003000005000000000000000000000
000000000000000000300000000000000000000000001030030000000000004030003000000000000000030003000000060000003003000000000000005310000000020000000000300000030000600100000000
000020000000000003300000000000060000000000000330000002000000010000000000000000000000003000000000030030000300000010100000603300000000000000000001000000330000010000000200
000660000000000003300330000003000000000305000330000006000000000330000000000001000000000000030000000300003000000000000000003303000000000000000300000000330000000000006600
200660000000002003300330000033000000000000300030000000030000000330000000000300000000000000031101000000300000003000000003003500000303001000003300000000000000000000006600
333333033333333333333333333333033030000000333333330333105000000333030330333330000000300000013230330000005000000000000003330003000000033333003330333333330003000333333330
