000000000000300000000000000300000000000000000000000100000000000000000000051030000000000003000000000000000000000000000000030130000000000000000000000000030000030000000010
000000000000000000000000000000000004300000000000000200000300000000000000000000000001000000000050000001503000000030000000030000000014000000210300000050000002300000001310
000000000000000000000000000000000000003000000000000000000030000400100000000200033300000000000003003033000013300000000010103330000000035350000000000000000000003300033000
050000000000000000000000000005000000001300000000000001000000330000000000000000000001000000005000000030000000600000003030333000010000000000000000300000004030330000005000
000000000000000000000000000000000000020000000000000000001000003000010000030030001000000000000300000000000000001000000000000000000001000000000000060000000000000000000000
500055500000440000000000334350005000000000000104000000010000000000055503000000000000000004400005550110000000060000000003000000010004400000000000000500005500000000000000
300000000000000003000000000030000030060000000000000030000000000300000000030040000000000000012001000100000000000000010000000003300000000000003000001300000000000030000000
000000000000000000000000000000000000000000000400000001000000000000000000000000300030000000000300000000000000000300003000500000033004300000000000003000000000001000020000
000000000005533300000000000000000000000000000000000335510000000000000000005530100000030000003000050000000000000000100010000000000030000300003100000000000000003530300000
003300033330000000000030333000600000013030000300033030000030000034330000330000000000000030030000000003000000300000000000000000000000000000100000000000000000330000000000
000000000000000000303333300002000003333000000000000006000000000330500060000010130600001030300010003103000000000000000000500000000000000000200000000000000000000000000000
000000000000000000000000000000000000100000003000000000000100000000003000000000000050030300000000000000000000000000000000000000400000000000000000000000003000000000000000
000000000000000000000000000000033030000000000000000000000003043000000000000000000001000000000000000000000000334500000001003555000330300000000003053330003000000000000000
000000000000000000000000000300400000000003000000000000000000000200033300000000000000003000000031000003403000000000030103000000000000000000000010000000300000003000000000
