000000000000000000000000000010000000000000000000004000000000003000000003000000006000000000030000010000100000000000006000000000000000000000400000010000000100000000000000
000000000000000000000000000000000000000000300050000001000000660010000000000000002000000000000000003000000000000010000000000500000200000000000000000000000000000000022000
000000000000000000000000000000000000000000000000110000000000000005000000000005006000000000000003000000000001000000000000001111000400000000000000000000000000000000044000
000000000000000000000000000000000000000401000000000000000000000000000000000100006000000000000000000000000000000000100050000001000000000000000000000003000000000010000000
000000000000000000000000000000010000000000000000001000000100300000000400000000066000000000003000303000000000000004000000000000000000000000004000000000000020000050000000
000000000000001000000000000000000000000300000000000000000000000000300000000001006000000000030000500000010003000100003000000000500100000000001000000000000000600000000000
000000000000000000000000000010000000005000033033360000000000000030303300001003332030363333300000300000000000000000000003003303330333300000000010000000000033333330003330
000000000000000000000000000006000000000000000000000000600000000000000000000000000000000000000005000000000000100030000000000003000001000050000000106000000000000000000100
000550000000000002000000200000000000000000000000000020000060000000000000000000005503000000000020100005500000000000000000000000000000000000000010000000000000000000005500
000111100000000066000004400000000000000000300000000660000004000000000000000000001111016604000440000001111000000000600000000000000000000000000000000000000000660050001101
000000000000000066000000000000300000500000000000010660000000000000000000000000200000306610000000000000000000000060660000000000100014003000000000003000010002660003300000
000000000000000066000000000000000003000000000000000060000000000000300053000060000000006000000000000000000000601020600000000003001000000300000001000000003000660000000300
000000000000000066000000000000000000000000000000000660060000000000100000000000000000006600020000000000000010600000600000000000000000010000000000000001000000060000300000
333333333333333333033333333335333330000030333353030330333333333000000000000003333330003303303333333130303000000033330333333333000000000000330000100010000033030303003300
