000000000000000000000000000300003000000000000000010000030000000000000000000030000000010000000000030000100320010000000000040000000000000000030000000000000000006000000000
000000000000000000000000000000000000000000000000000000000050000000000000005030000000303000000010000003000000000000000100500000000000000005000000000000000000000000000000
000000000000000000000000000040000100000030000000030000000000000000044400030000000000000000000000000000000000010000000000000000000012000000000000000000000000000000130000
000000000000000000000000000000000000000000001000020000000000000000000000000000400000000100000001000000000001000000000000000000000000000000500000000006000000000000003001
000000000000000000000000000000000000000000000000000000000000000000000000000000000000000000000160000001000000001004000000000000000000000000000000000000000010000000010004
001000000000000000000000000000000100000000001000000010100010000011003000003000000010000000000300000000000000000000000010000020611000000030000000030003010000000010006033
000000000000000000000000000000000003003333000300000000000330030330333300000000110000000000000100003333330000000000000003333300313003000300003303303000000330030300333333
000000000000000000000000000000110000000000000100000000000000000000000000000003000000000000030030000000000000000300000000000000000000000000000000000000001000000030000000
000000000000000000000000000000000000000000000100000000000000010000000000300000000000030300000000300000003000000000000000000000000000000000000000000030000000000000100000
000000000444440000000000000000000000000000000000000444400000000000000000000000010000000001000444040000000000000000000000044404000000000000003000000004440000000000000000
000000000000000000000000000000000100000000030000000000000000000000000000000300000000000000005300000100000000000000060000000000030000000000000001000000000000000001000000
000000000000000000000000000300030000003000500000100030000000600000000000000030000000200000300000000000010000600000000030000000000000000000006010000000000000000000000000
000002020000000000000000003300000000100000000001020000000031000001000000000330010000000000320000000000000000002000000030000000001005000000001000000200000000000000000000
333333333333333333330033333303113330010000303333003330330000000030300003330333333303003330330033300030000333333303333333333333002000000000000000000030313300010000000000
