000000000000000000000000000000000006000000000300030510000000000000000000000000000000000000000000000000100000000000000300000000001300000006000001000000000100000010000000
000000000000000000000000000000000000000000000000000000000010000000000000050000000000030053000000000000003000000000000000000000000003000300000000000000000503010000001300
011000000000000000000000000000100000000000220000010000000000000001000100003000010000000330301100000203000000010000000000000000120000000030031110000000000000013000303303
000000000000000000000000000000000000000000200000000000000000000000100000001000000300033330000000001000005000000000003000000000200030003213000000000000000000000030033300
000000000000000000000000000000000000003005000000000000000000000000030000300000003003030333000000010000000000300000000000000000000000033030000000100000300000000003303330
000000000000000000000000000000000030003000300000000000000000000310000000000100003000300003001000003600000300300000000000000000100000030333300010000010000020040003033030
000000300000000000000000030000003031303330330000000003000000300000000000000000300303330033300001033000000030133300003003000000330000003333330000003000000000003003030331
000000000000000000000000000000000000030000000000000000000000000000000000000000000000003000001000010000000000000500000000060000000100003000000000000000005000000000000000
000000000000000000000000000030006500003000000000000000000000000300000100000000000000000000000000001000000000000030000000000000000000000000000000000000000000000300000000
020000000000000003333000000000003330000000011000000000100200000401000020400000003333000000001000000000000000000000000000110000000001000000000000000000001001000010000050
200000000000000333300000000003311000000000000000000000002000000000003000003003003330000000000000000000003001000003000000000000000000000000000000000000000000000000001000
000000000000003333330000300013333000000000000000000000000000000000010030000003033030000000000011006300000000000000000500000000300300000000000000000300300010500000006000
300000000000033333330000300030333000000030300000000000003003000000000100000033033130000003000000000000000000000000000300000000000300010000303000300000100010000000000003
330000000333333333333030333333023000000000000000300000033300000000000000303303303003000030000333030000000000000000131330000103030336301000003300000030303300000300003335
