000000000000000000000000000000000000000000000000000600000000000000000000000000000000050000000000000000000000000005000000030000030000000000600000000000000000000002000000
000000000000000000000000000000000003000000000300000000000000500000100030000000000000000000000000010000000000000300000000000000000006300000300000030000000000000000000001
000000000000000000000000000000000010003000000000001000000000000000000001000000000030030000000000000000000000000100000010000000000600000000000100001000000000000010000100
000000000000000000000000000000000000000000000000000000000030000000000010000003000000000000000000060000000000000506000000000000000000000150000000000000000000000000001000
000000000000000000000000000050000000000000000000000000030000000011000106000000000000000000001000000000000030000030300000000006000000003100000000000000000000000000100030
000000000000000000000000000000000103000030000000030000200000000010000000000000000000000000001000000000000000000600100200000000000000001000000000000201000203000000106000
000000000000000000000000000000000100000430330033330630030000003330353300000000000000100010043033300000000000000033003300004000000000030103330500000303331300000003333330
000000000000000000000000000000000000000030003110000000000000300000000000000000000000100000000000105000030004000000000000000000000300005000000000010000000000300005000000
000000000000000000000000000003000000000000000000000000000000100000000000000000000300000000000000000002000000000000000000000000000000010000000000000000000000001000000000
000000000000000000000000000000000000000000040000000000000000000010300300000000000000000000000006000000000000000001000000000000000000000000000000001000000000000000001030
000000000000000000000000000000000000000000000000000000500000000000010000000000400000000000000000000000030000000300000000001000000000000000000001000000000000000301000000
011000000000000000000000000000000000000000000000001100000100000000000000030000000000000000000000000000000005000030000061000000005000030006050000000130300000300600000000
010000020020220000020000002000000005002022001000000000000000000000000000000202000020000002000020220000000000000000000001001020000205200000000000000000000400000500003020
333333333333333333333333303300000003303333000000033333033333030000000033333333333300330133033303030100000333303300000000333030333333300000001000000333333300000003303033
