000000000000000000000000000000000000000000000000010000000000000000000000000000000000000000000000000000030010000000000000003000000000000000000000000000000000300000000050
000000000000000000000000000000003000000000000000000010000000000000000000000000000000001000060001000000000000000000000000000000300000010000000000000000000000000000000003
111111110000150000000000000000000003000444000000040000000000000000000000000004000000000000100500000000444000000000001000010000130001500504430040000300000000004401110110
000000000000000000000000000000000000000000000200000000000002000000000060000000000000000002000000100000000200030000020000000000000000000010000000000000003000000000100000
000000000000000000000000000000000000000000106600000505000063050000000000010000000000000004003060000000000500000000660000003300300033000000000000000000000000000000000000
000000000000000000000000000000000000000200006600000000000066000001000000000000000000000000000060000100000200000000660000000001000000000002000000110000061000002001000003
000000000000000000000000000033333333330333003301303003330333033000000000000003303330003000030333003300333033333333330330000010300000033333033000000333333330333030000000
000000000000000000000000000000000000300000000000000000000000000000000000000000000006003000000001000000000000000000000000000000000000000000000000000000001040000000000000
000000000000000000000000000000000000000000000100000000000005000000000000100000000000000000000000000000000000010000000000003000000000000003100100000000000000000000300010
000000040000000000000000044400000001111000000003010000100000404100101300340301111310103031540000201101111000000040002001100511000000000000000001000000011500000004300000
200000000000000002000000000000500000000000000000000000000000000000106020000000000000000000000000000000030001000000000030000000000000020000000002000000000000000000000000
000000000000000066000000000000030000000010000000000000000000000000050000000000000061300000000000000000000053000000000000000036000000000030000066000000100000000060000000
200000000000000066000000020000100000000050003000000000100000200100000000006030000000001000001000000000020000000000000005000000000000020000000060000060000000000000000000
333333333033333333333333333300000000000000001000000000003330333002000333333030000000000300033033340000000000000033033001010000000000030333003003313000330000001003303333
