000000000000000000000000000000000000000000000000000000000000103000000100000001000000000000000000020000000000000000100200000000000000050000000000000000000006000000060000
000000000000000000000000000050000000100000000000000000000010000000001003050000000000000000000000000000000000005303010000000000000000000040000000000000000000050500002010
000000000000005000000000000000000003440000501000000000000100000000000000000110300000100000200300000000500000001050000000000003000000310001100000006000000010000110041150
000000000000000000000000000000000000000000300000000006000000001000600000630000000000001000100000003000000300100030000000000000000000000600000000000000000050000000011110
000000000000000000000000000000000000003000000000000100011200000503000000001000000000100000004030000000000000000000200000100003000000000000000000000000000000000000011013
000000400000000000000110000001000000000000400000001001500000000116000000010000000004000000011000500000000000000000000001100000000000400000003100000000000000000000011000
000000000000000000000000000000600003303033010010400000003300303000000030333300000000333335000000000000000033333300000031000000100000033333300000000000000030333533333003
000000000000000000000000000000000050000000000003000000060000000000000000000000000000000000000000000000012000000001003000000000000000000000000300000000000000000001000030
000505000000000002000000000060000000015000000000000000000000000001000000005030000000000000000000000000000000200100000000000000000000000020000000600000000000000300000000
000001111000020011110044000000011100000011510000200004000011110044000000000005000010000000050010000440000011101010000010400000000102000011100440000110000200000000300000
300000000000010011110000000000111103010000000000100300000011100000000000000000000000000000000010000300030011111000010000000600000003000131100000000000000000011000000000
000000000000000011010000000000110100000100000010000010000011010000000000000300000000000000030000000000000001001010000000001000000001003110100000000000000000003000000000
000000000000000011000000000000010031000000000000000000000011000000005000000015000000000000400000000010000001100000000000000001001000000010000000000000000000000000000004
333333333333333333033333333343030003333333330033100000000033033313303300000000000000000000000100003333333333303303330033333333000300033330303333100030333300000000000100
