000000000000000000000000000000000100000000000000000210000000600000010000000000030000000000500000000000000001000000001000010000000000060300000030000000000000000000000000
003000000000000000000000000000000100030000000000000300000000000000000000000000000000000000000003003000000001000000030010000010000440000000100001000000000300300000000000
000000000000000000000000000000000000000000000000000000000000000000400000000000002200200000000000000000000000000100001000032000000000000000000000000000000050000000000000
000000000000000000000000000000000000000100300000200200000000000000000000000000166000000000000000020020000106600060003000006000000000201000000000000000000100000000000000
000000000000000000000000000003000000000000000000000000030000000000005030000000006510000000000000000000003003601000000030000000000200000000000000000000000000000000001000
000000000000000000000000000002006000000000000203011000060000000020200000000000060000000000005000600000000006100000000000066000000003010000000200000100000000000000000000
000000000000000000000000005503333330000000033303100002330060055333300300000000333333000300000033330000033330333300000053301303033333000000003333300033333000000000300000
000000000000000000000000000000000000000000000000000000000060000050000000060300000000000000000000000000100100000000000000000000000000000000300003000000000000000000106000
000000000000000000000000000000000000000000000300000000000060000000006000000000030000003000000000000000000000000000303000000000000030103000000000000000000000000000000004
000400000020000000000000000000200000000000000000000020000000000000000000000001000000300000000000100000000000400000000000000000030400000010000060001000000000020000000001
000000000660000000002002000000001000001000000000110660000000000002000001000000030000000000000000000000000000000000000001003000000000030000000000000002000000660300000000
000000000660000000000000000303000500000000000000000000000005000000000400000000000000000000300000000100000000000300000000000000000000000000030000000030000300060000100000
020220000660000000000000000605000000005000000000010160000000000001000000000000000000000000000000000000000003220600500000000000020020300000060000000150000600030000000000
333333333333330333333003333300010000000300000005533033316000000001333303331330000000000000000000060400005033333100000000300000033333300300300000055000333356003010000101
