000000000000000000000000000000000000003000005000000000003000000000001300010000006000000100000000000000000000000000000000000000000000000000000100000000000000000000005000
000000000000000000000000000000000010000000000000000000020400000000000001000000000000002300000000001000010000000000000006000030100000000000000000000000000000000021000002
000000000000000000000000000000000310000000000000000000600000000000000000000630000020033000000004000000100000000000000660000000006000000000000000000000000000000660000606
000000000000000000000000000000000000000000000300000000060000030003050000000000000033003300100000000000000002000303000610000010100000000000000300000000000500000660030060
000000000000000000000000000000000000000000000000000000160000000000010010100060010003003000010000000000000050000000000060000000003000000300000000000000000306000660000066
000000000000000000000000000000000300000000000000000200660000000001000000060100400010310300000000000030000100001002200661000100000100000000000060000000006000200660220060
000000000000000000000000000031333030000000000000333330330000000030000033333330000000333333300000033303030000000033330031001300000003033303330000000000000003330333330330
000100000000000000000000000000000000000000000000000010000000003000000000010000000000000000000000000000000000000000000000001000000000006000000000000000060100000001001000
001100000000020000000000000200000020000000000000000113100000000000000000110000300022000000000000020000012000000100000000010000000000200001000500000001100000031000000020
033000000000660000000000006600000065030006500010003600000000000000006600300000000066000000000000000000060030000000000001530000000106600060230000000033000303100000000000
033300000000660000000000006600000060000030000000603330000000000000016603310000001066000000000000600000060040000000300000333000000006600000000000000030300030100000000000
033300000000660000000000006600000060010010000000003300010000000000006603050000000066000000000001600000066000100000000000303000000006600000000000000030300010003000001000
333300202200660000000002006602200160001000101000003310020000000022000033331020020060000000002000660020066000000000000003333000002006602000000000000333300000000003000000
333333333333333333333333333330330000001000000000033333330000000333303300333300303333000000033331333333333000000000600000303333301303060000003330330333333000000000000000
