000000000000000000000000000030000000000000000000000000000000000000000000000000000000000000000000000000000000000000000000000000000000000000000000000000500000000100000000
000000000000000000000000000000000000000000000000000110000000000004000000001010003000000030000000000000000000000000000000000600030000000000000000100000010000506000000000
000000000000000000000000000000000000000000000000000000110000030000000000000000000000030000000000000000000310000000000000030000100000003000000000000000000000010000003003
000000000000000000000000000000000000000000300000100000000000000000000000000000000000000060000000000000000002000000000000000000100000000000000300000000000103000000001000
000000000000000000000000000000000010500000000000200000000000000000000000000000000031000003050003000030000100000030000000000000003000000000030000000000060000000000003000
000000000000000000000000000000000000000000000000000000000000100000003000100002000033000003000000000000000000000000000000000000060000000000030001000003020000000000000000
000000000000000000000000000033303330000000333333000000000030000333333005000003333313033333333333330000000333333303333333305160000010003333330000000000000033301330000000
000000000000000000000000000000001000300000000000000000000000010000000000000000000000000000000000000000000000001000000000000000010100000100000000001000000000600000000000
005000000000000000000000000033000000030100000000000013000050000010300000000010000000005000000000000000000000000000003000000000000000000000000000000000000000000000000001
000000000000000000000030000000000000300000000000300000006000000000000500040000000000030000100300040000000000001000001011000000000000000000000000000000000003001000000000
000000000000000000000000000000000000000000000050000000000000000000003000004300000000000003302000000000001000000003005000000000000300000000000000000000000000000000000000
000000000000000000000000003300010010000033000300000005010000000000000000000000000000100000000010000000300000000000000000000000000003000000000000150000000000000130000000
000000000000000000000000003300010000000003000000000000000000000000000000005300000000000000000000000000000000010000020000000000000000000000000000000003000000000330000000
333333333333333333333333333300006003303333303031300000003330003303330330000000000000333300300000000000100000000000010000100000010130033333310000000033033333330333033303
