000000000000000000000000000000000000000050000000000000000043000100100000100000000000000000001005030000000030003000000200100000000000000300000000000000000000000000000000
000000000000000000000000000000000000000100010000000000000000100000000000000000000000000000000000000600000000000010400000030000000000000000000000000000000000000000000406
000000000000000000000000000000000000030000100000000000001000000000000100000000000000040200000000001000000000000000000000002000000000300000000000000000000000500000000000
000000000000000000000000000000000000000000606600000200000000030000000300000000000000000600000000000000000000000000000000066000002000000000000000000000000010011000000000
200000000000000000000000000000033000000000006603000300030000000000001000000000002000006600000000002000001000000330000000266000000000100000000000000000000050000002040000
000000000000000000000000000000000020040000006630000000000000000000000000000000000122006630000000221000000000060000000000060000003510300000000010001000030000000000000000
000000000000000000000000005500333300000000333303333300301000001333333301000500330333033333000300330000000000001500000000033333333033000333331333303000005500001000000000
000000000000000000000000000001000000000000000000000000000000000000000001000000000103000000300000000030000000000000001000000000000000000000000001000000000100000000300000
000000000000000000000000000002000000000000500000000000000000000000000000000600000000000000000000000200002100200000000000000000000000000000000000000000000003000010000000
000000000020000000000000000310000000000600000003000000000000000000200000030030000000000000000000006100000000000000000000000000030000000000100001000000600000000000000003
000000000660000000000002000010000000000000000000000000000004100006601000000000000000100000000200000001000011000000000100000000030000101100000000040006600000000000060000
000000000660000000000003000320001003000000000001000000000000000506600000301000000000000000000300030000000010000000000000000000000000000010001020000006600000000000030003
000000000660000000022003000300030000000000000000000300000002000006600010000000000000000000000300030000000000000000000001000000000600000000000033000006600000000000030040
333333333333330333333333033300000000100000033333300000010001000336300333303030000000350303303303330030100001000000000000000055333000300120000033303033333300300103330333
