000000000000000000000000000000000000000100000000003003000000000000010000000010000000500000000000000000013010000001000000100000030000000000000000000000000030300000000000
000000000000000000000000000000003000000000000000000011000010000010000000000000000000000000000001140000001300000000030000000110000000000000003103010000000000600000000000
000000000000000000000000000030604040000000000001100000000000000330001000000000001030000000000000000000000000000003003001010000330100000001003300000000000033130040000000
000000000000000000000000000000000010000050000000000000000000000000001000000000000000600001002000000000003000000000000005200000000000000030001000000000003000300000000000
000000000000000000000000000000000000000000000000000000010000000000060001000000000000000000000000600000403100000000006600303001000000010500000000062000000000000000000000
144444414000000000000000000000000001000000144340100000001400000000066600030001010000000000000300000000300000000000006060000000000000000000000000663110000000006000300100
000000000000000000000000000030332330010000006000033333300000000003333330303330000000000000030000303333333000600000336003330030333333133003300003300000000030030330000000
000000000000000000000000000000310000000000000000000000000000000010000003000000000000000000000000000040000000000000010100000000000000000030000000005000000000000010000000
000000000000000001111110000000000000000000000000010000010001010000000000000000000000300000010000000000000000000000010000000000000000000000600001111000030000000100000000
331100400000000000000330000000000000000000000500033000000320000330100400000000000100300100433000500000000000000000000100000000000000000000010000000000000000000000000000
000000000000000200000000000000001000000030000000000000000300100000000000000000000000000000000000000000000101030000000000000000510000001000303200000000000000060000000000
000000000000000000000000066000000000000000000000100000600003060000000000000010000000000000000006000000060000000000000000000000000000000000000000000001000010010000000300
000000000000000000000000066600000000000000000000000006660000000000010014434440000010010000000006660000000404444005003001000000104444400010000030000004000314140041400000
333333333333333333330003333360000000002010333330300303333333330300303300050000000000633333301003330000000300000003000530000000000300000000003103330331333300030000000000
