000000000000000000000000000000400500010000000035000002010000010000100005000000001350003030000000003000000000000000103000000000000006030000000010000000000000000030001350
000000000000000000000000000300030000000003000000000100000000101000000000600300000000000000000300000003000000000000000000000003000030001000000000000000000000000000000000
000000000000000000000000000000000000000000000000000000000000000003000000000000000000000000000000000000001000000000000000000000000001030300000000000010000000000000000000
000000000000000000000000000000000020330000000000003000000000000303000000000013000000300000000000000000001000300030000010000000000000410300000000050110000000000000030006
000000000000000000000000000000500000000000300000000000000005000333033600000030000000303000000000100000000000000003030000000500000000033300300003000000000000000003000000
000000000000000000000000000000000000000100330000000010000000001333303300000003001600300000300000000000000000000030000000000010000000633030330000000000000000000003000000
000000000000000000000000000000333300003000000003300000000000000300000003333330000033000000300000033330303000000000030330000000000000033330003133311000000000000000000033
030000000000000000350000000000000003000000030000000000000000050000000001000000000000000000000000000300000000000000000000000000006000000000110000000000000003000000010000
000000000000000000000000000000000000100000000000000005000000000000000000000000000000006000003100030000000010000040000000000000030010000000000000000003000000000000003000
003000000000000000000000000000100000000000001000000000300000000000000100000000030000000000000000000000000000000131000000000300300010000000000100000000030000300000060005
303000000000033000000000000200000000000000003000000000000003000001000000000000200003000000100005003030000000000000000000000000000000300003120000000030000030330100010003
333003033000033000000000000000000000300003033003000001000000000011000000000003300010300000300000000130230000000000000000003000330000300000000000000006000033000303300003
333303333303333000000000000000000303330333301303001000000000000000000300000003330330300003330000103333011000000400000050100000333033300000000000400403000030330033330330
333300000000030000033333333300000000000003000300610000000001000000010100000000000003000000000000053030000000000000001000000000000000330333330000000000000033030000000003
