000000000000000000000000000000300015000000000030000000000000000000000300010000000000000000000063010000030000030101010000303000000000000000003000000000000000000000000000
000000000000000000000000000000506000000000301000100000000000000000000000000000000003000010000000013050010000000000000000000000010000000000033000000000500000000030000000
000000000000000000000000000000000500000000000000000033500000000060300000000000000030000000000000100000000000033000000000000000006100000300030300000100030000103330500000
000000000000000000000000000005100000000000000000000033330000000000050000005000003133000000000000000000000000333330001000000000000001000033333330015000000000033330000000
000000000000000000000000000030000200000020000003001336000000000000000000000000030033000000000000000001000000303300000000000000000000000003033300000000000000033330030000
000000000000000000000030000000000000300000000000003330300000020003000000300500036333030003010000000000000003333303000000000000300000003333313030000030000000303330000300
000000000000000000000333000000000003300010003333333333330010003303333300000003233330303000000000000000000033330030300000033330001000033330333333331333005033333330000000
000000000000000000000300000000000003000000000000000010003000600000000000100000000300000000030000000000031000000000000006000000000000000003000060000000000000000000000000
000000000000000000003300000001000003000000300000000000033001100000010000100000000000000002030030005000000006300000000303001000006000000000000000000001000000200000000000
000000000000000000333330000000000003300000500000000000003300000100000000000000000000000000033000000000000000000000010003300000000010300000000410001000001000000000000000
000000000000000003333333000000000003300000000000000000003330000000000000000000000003000000033300000000000000010000000000300003000000000000000000000000000000000000000000
000000000000000033333333000000000003030000000010000000000330000001000000000000100000000000063000000000000000060030000003330000000000000000000000000000000000000000000000
200200000000000333333333000000000003330000200230000000353330000260200000003010000000000000330300000000000200000020020000300000000000000000000000000000000023020000000000
330333300333333333333333333300000000333003330003300000003333333330000033000000035003000000033333030030333330333330030033033333000000001000000000300000050033050330033313
