000000000000000000000000000000000100600000000000000000000000000010000200000000300000034000000100000000000000300000000300000000000000003000100000000000000000000000050500
000000000000000000000000000003550012000300000320000000000000001000000000550000000001000000003000005000000000000000000000000000200000015500006000000000000000030000000000
000000000000000000000000000000300000000000000000000033000000000000000300000000000000000300000000000000000000006160000000016000000000000000000000000001000000000000000000
000000000000000000000000000000100000030000000000000000000000000000000000000006000000000000000000000000000000000000000010000000000000100000000000000000000020006000100000
000000000000000000000000000000000000000600010000000000000000000000060000000001000000000000000000030000000000600000000000300000003000000000000000000000000000000000000000
000000000000000000000000000000000000000000000020010001000000200000001003000000000000000000000000000000002000300000000000000000000000003000030000000000000010002000000000
000000000000000000000000000031330303033303300333300000003333333000000013300303000040000000000000003333333303333300000000000000633333333300030000000333333333300330300300
000000000000000000000000000000000000000000000000000000000000000500000000000000003000005000000000003000000000000000000300004000000000000100100000303000000060000006000000
200000000000000555000000000000000310000000000000000000062000010000001000000000000000200000000000000100000000500000000000000000003000000600000000000055500020000100010000
000000000000000000000000000000050000000030000000000000000000000000000000000050405000000000000040030000000000000000000000000000000000000000000001000000300000000000000000
000000000000000000000000000000000000000000000000000000000000000000000000000000000000000000000003000000000000000000000000000000000000030500000000000000010000000000000000
000000000000000000000000000010000000000000000050000000000000000011000000000000000000003300010000003300000000000000000000000000000000000000100000000000000000000000000000
000000000000000000000000020000000000000000000100000000000000000000000000000000000000000000010000003000000001000000000000000200000000000000000000010300000000000000100000
333333333333333333033333333333333330000000000000000010000233332001000033330300300000033130300000000000000333303313333330303333000000000000000000000333303303330030000000
