000000000000000000000000003003000010000000000000000000000000000000000000000000000100000010000000000000000000010000000000000000000000000000030000000000000000000003005000
000100000000000000000000003000000000000000000000100000000000040000000000000300001000000030000050000000000000000000000000300000000400000000300000000000000000000000010000
000000000000000000000000000000020000000200000000030000003000030000000000002010000000300000010000331000000000000000000000000100000003000000030000000000103360000002000030
000000000000000000000000000000000000006603000000000001300001000000000000066000100000000000000000030001000000000000000000200000000300000000060006600000000000000000001000
000000000000000000000000000000000000003000000000003000000001000000000000066300000000030000000000000000000000000010100000000000000102000000000006600000000003000000000001
000000000000000000000000000000000001006600000000410000000010300003000050066000000000000000000001000000100500001000000000000000000010000000002006600000001000000000000001
000000000000000000000000000033333333033333501000000000003033330000000033303330000030000200035353303033333006000033330300100000633333000000006331330333310020000000000000
000000000000000000000000000033300000300000000000000010000000000000003000000000000100000000000010000031010000003000000100000000001010000000000000000000000000000300000200
000000000000000000000000000000000000001000000033100010005000000000003000000303000100000000000010100000000000003030000000000000000000000000000000000001000000000300000000
000000000002000000033330000000401000000000000000030000000000000000000000000003300050000020003300000000000000000000000003300000000000001000000301000000000001000000000000
000000000066000000000000000000000000000300003000001000000000000000000000100000000000000600000000000000000000000001066001000100000000000000000000000000000000030004000000
000000000066000000000030000000000000010000000000000000030000000000000000000000300000000661010006000000000000000000066000300000000000000000006300000030000000006050000000
000000020066000000000000000000000000000000000100000000000020000000030000000000000000200060030000000000000000000020164000600000000000300000000330000000000000000000000000
333333333333333333330000000000000003333300000000000000000313033000030000000001010000330303300000000010000001000033610300000000000000000000000000000033333300000000000000
