000000000000000000000000000000000000000000000000000000000000000000000301000000000000000000030000000000003000300000000000000000000000000000010000003000000000000000000000
000000000000000000000000000000030000000051000000000000000000000000000000010000000000000000000010000006001500000000010000300000000005000000000000000100000000000000000030
000000000000000000000000000030000000502401000030000000000000000000000000400000303001000044100300001003000000000000000000100000000244100000000001100000000000000003001000
000000000000000000000000000000001003030000000000000030000000000000000000000131001000300000100000000000000000000000000030000000300000000000030000030100000000000000000203
000000000000000000000000000000000003000000000000000000000000000000000100000300000030330000000000000000033000000000000000000000030000003000000000000000000000000050303333
000000000000000000000411111000305010000000300000040161000131110000200000000000013030000000000101000003430000100040000050000000000000000000304101311063600000000000000000
000000000000000000000000000006000101003333000001000000000000300000100300000003030300003303300000003303330000000000100003333033003330300030000200001000000000000000300000
000000000000000000000000000001300000000000000000000000000000000000000000000000010000000000300000000000000000030000000010000000000000000001000000000000000000000600010200
000000000000000000050000000000000000000000001000030000000003000000000000000003000030000030000000000000000000100000000000010000010000030000000000000000005000000000010000
333300000000000002441111000000000001033000110001000000000000000311000000000000000441111000100000030000000000000003330000000000000030000300000000000000144130030000110003
000000000002033000000000000000002060000000000000000000000000003000001000000003000000000000000000000000200000000000001500000030030000000000031000000000000000000000000000
000003003033333300000000000000033033000000000000000000000303331003000000000003300000000000000000000000333020000000000100000000000000000003300010000300000000000000000001
000333000000000000000000000000000000003030000000000000000000000005010000000000000000000000000000000000000000000000003300000110000000000000000000000006000005033300000000
333333000000000033333333333300050003336300033303303000000000300033330300100000030333313333300000000010050000000033303300300000000000000000000000000043333333333303330333
