000000000000000000000000000000003000000000000300000001000000000000000000001000000100500600000000000000000000061000000000000100000300000000000000000000100000300000000000
000000000000000000000000000000010000001000000000000000001000000001000000000300000000006000100000000000000000000030101000010100000000005000000000000000000000000000000000
000000000000000000000000000000000000000040000000000000000000003000000060000010003030000000000000000000444400000000000000060000000005000003000000000400000000000000000144
000000000000000000000000000000000000000000000005000000000000000000000010030000000000400000000000000000000030000000000000001005000000000000000000000000000000010000000000
000000000000000000000000000000000500001000000100000000000000000300000003100000000000000000000013100100000000003000000000010000000000000000000000000300000000013000030000
000000000000000000000000000000000000000000000000000000000000020000300000000000000000400000000000000050000000222400000000000110000122000000000000003000022000000000000000
000000000000000000000000000004303333333333000000000000003033033000000000003000330333000000000330336333333002330300000000303353333331100000000000000303313300000130333003
000000000000000000000000000000000000000000000300000000000000000033000000030000000000000100000000000000000000000000000000000000000000000000000000000000000000000000300000
000000000000000000000000000000000030000006000000000000000000000300000000000100000001000000000000000000000000000013000000000100000000400000000010000000000350030106000000
400000000004444400000000000041100110000030400000000000000000000000044444000000000001010300244000000000000000000006000000000444030000044000001000000440000000000000000000
000000000000000000000000000001000000000040060000000000000000000000000000000050000000000000000000000000000000000300000000000000100000030000000000000000030010000000003000
000000000000000000000000000003000030010000000000000000000030010000000000000000000000013000000300000000000030010000000000000000000003000000000003100000000000000000000000
000222000000000000000000000000000001000001500202000000000000000000000000000000000000000000000000000000000000000000000000000000000000000000000300000000000000000300000000
333333333333333333330033333303003000010000330330300000000000605003313303330300000000000000005300300001000000000000000003330303000000033303300000000333330100333000000000
