000300300000000000000000000000000010000000000010001000003000000000300300000000000000000305001000030030030000000030000300000010000000000000000001000000000000000000000000
000000000000000000000000000000000000000000000000000001000000000035000100000000000300000000000000000000000000200000000000000000000000100300000020000000000000000010000000
000000000000000000000000000000100000201000006010000000500660000000000000000000000011000000010300000000000003000003000000000000000000000300000000011066000000000000000000
000000000000000000000000000005000000000000066002200000020060021000000000050000000000000000000000000000000003000000000020000000066010200103000000000066002200000020000001
000000000003000000000000000000330000000000060033000000663001310000000000003000500000000000000000001000000000000300000660000300366033300000001030000366003300004660000000
000000000000000000000000001100300000000000360100300000630620020020001000000010000000000000000000000000001003000000000600000000360005300000000000000300003300000660000061
000000000000000000000000000033303300000000333003003333333330013001200000000003030330000100001000000004000313330333331300000000313013300000006333333303003300333330000000
000000000000000000000000000003000000030000000300300000000000001000000000000010001000000000003000000000010000050000003030000000000010000000000000000000300330000000000000
000000000000000000000000000000000000000000000030300010000000000000000100000000300000030000000000000000000000000000000000000000000000000030000500300060030010000030000000
066000000000000030000000001100000410000000000001000000000001000000000000000000000000000000000000111601000010000010000000000011000100000300000003000000000000000000000000
066002200000020030000000000004030000000600000000000000010010050000000200300000000000000000200000000660020000000600000000000000000003000300000000050000000100000030000000
366033300000660030000000000000000000003000000000000003000000000000006000000000000000000106600000000660503000030000000000000001000000000300000000000000030000300000000000
366003300000660030000000000000000000301005000000000000000000000000000600300000000001000000600000016100136000000000000060000000000001100300000010010000000300300000000100
333003333333333333333333333333333330000000000500000003000000000033303333333300000000303000333333333330033000000000000003330333000100030333330003000000000003333330010000
