000030000000000000000000000000000000000300000000000000000106000030000333000000300063000000000000000000000000000000000000000000000000033000000000000000000035003000000000
000000000000000000000000000000000000000000000000050000000000000000000033000003000000000000000000000000013000000000000000300000000000030000100033000000000003000000000003
000000000000000000000000000000000000010000000100000000000000500000000030000000000000000060000000000000000000000000600000000000000000030000000030000010000013000000000000
000000000000000000000000000000000000000000000100000060000003030000000030300000000000030013000001000000000000000000000000000000000000003000000003300000000033000000000000
000000000000000000000000000000300000000000000000000000000000000000000033000000000000020100000030000000000000000010000000000000000000033010000030330000000033000010000000
000000000000000000000030000003000000000030060000020020000360000000000033000000000000030000000000000000001000205000000000000000000000035000000363000000000030000000001000
000000000000000000000300000030000000000030003400133330303000000000000033030030000000300000000000001003303333333000333300000000000030030000301033030320000030000330000001
000000000000000000000330000033000303000000000000500000000000000000006000030000300000000030000000000001043330000000000000000300000000000000000000000000035000000000000000
000000000000000000000330000030000000020003100000040000000000000000000000000000100003000000000300000000100030000000000030000000000000300300000000500600000001000030000000
000000000000000000300330000033010000000000000000310000000000000010030000000000000000000000000003000000000330000000000100000000000030310000000100000000100000000000000000
000000000000000003300330000030040000400001000000600006000000030000310000000002000000120000000030000000000300003000000000000000000330000000000003000000005000000000000000
000000000000000033330330000010000000000000103333000000000000000000333000000010000000000000000333200000000000000000000000000006001303000000600000010000000000050300000000
200200000000000333300330000033000000000000033210000000005000030003331000000002002000000000003033000030000330000003000000000010033330000520000000000000000020020000000000
333333000333333333330330003333000300000000303030003000000033333333333006100000330130000000033033300000003030003300000000000000033003033303300033333000000003336000000000
