000000000000000000000000000001000010000000031000000050000001000303003000000000010000560000000000000000000010000033300000000000003003000000000003000000003130300000003000
000000000000000000000000000000000000500010030104100000060000001030000000000000000000000006000000000001000003003003000000000000000000100000000000000000000033300000000001
000000000000000000000000000000000000000000333000000000000000000333000000010030000200000000000000000020003000000131300000000000000000000000000000000000000003300000000000
000000000000000000000000000010000000000000303200000006000005000333060000000030000605500000000000030000033000060003100000000000000003303100000006600000300363300000001000
000000000000000000000000000000000003000000333300000066000000000033000000000030006600000000000500000000063100160003330000000000000000000001000006000000000033330000050000
000000000000000000000003000000000000000000303100020030000000000330300000000003306600001000000000000000003200600333100000000020010000300600000006600003000033000050000220
000000000000000000000033000000000000000000300000003333330000000300000033330333003333000100000000003033333333333010030003331033030333303300003030033003001030020000303030
000000000000000000000333000000001000000000000000000000000000003000000000000000000000000000000000003005000000000000000000300000000003000000000030000000030000000000000000
000000000000000000000333000000000000000000000000000000003000000000000100000000000000000000000000001330000000000001000000000000000000000000000000000000000000000000000000
000000000002000000003333000000000000000000100000000010030003000000000000300003000000000104500000003330000000000000000000000200004000000000301000000000000000100030030000
000000000066000000033333000000000000000000000000000015330000000000000000300300300000000000000000003330003000000000000003000600000000030000000000000330013000000330000000
000000000066000000003333300000000000000000000000000000000000010000000000000000000000000000000000003333000000000000000000006600040301000000100000000000000000030030000000
000022020066000000003333000000000000030000000022000000030030000000000000032200000000000022000300603330000001006000000002006600000000000000000000000000000000000000000000
333333333333333333333300300000000000333000303300333333330330001000000303033130000105000330300000003303000033000000000003330030000100010000000000000000000033330030000000
