000300000003000000030000000000001000100000000013000030010010011010000000000300000000300000300040300000000000000000000100000000000000100000001000000003003000000000000000
000000000000000000000000000000003000000001300000000000000060000000000000000005000000000003000020000000000003000000000000000000300050003001000300000000000000000000000001
000000000000000000000000000000000000000441000000000000000000441000000001001000000000000000000000000003000000000001000003000000030041000001000000041000000000000000000000
000000000000000000000000000010000003000030000000000000000000000000000000000000000000000000000100000300000000000003040010000000000603003000000000000000010000000000300000
000000000000000000000000000000001100000000000000000100000040000000000103100000000000005000000100000300000000000000000000030300500000000000000000000000000000000004000000
000000000444004000000000000000000000000000000010005000000300060000000045000000000000000000000500000223200000000000000000210200010000000000000100003400000000000000044400
000000000000000000000000000030133330331333000000000000003331303034333003000200000000000006000000003303033000000053133133330333333333300000053030133000500003033330001100
000000000000000000000000000000300020000005000000000000000000000000306000000000001000000000000003000060000000003000000000001300000000100000300006000000011000000000001000
000000000000000000000000000030000300000000000000000000010000000000000000500000000000000000000000000000000000000000000000101000000000005000000000000000000000000030000000
000000000004411100000000000000000000000000110000000000000000010001040410000003001003110000001000000000300000140100001060000006110000000000000000000000000011000000000000
000000000000000000000000000000001000003000400004000000036000001000600000000000000000400000000000060000000000000000010000000000003030000000100000000000000000000001000000
000000000000000000000000000000010000000100600000300000003000000000000001010000000000000060000000000000303000600000000000000000000000000000030000140000000000003000000000
022020000000000000000000000002202000001000000000010400000320030000000000000000334000004000300004000000000000000000000000443400000000040000000000500023020000300001000200
333333333333333333300030333303363330300000303300000600013333343000000033033000000000303330000000000303303333333100000000000000333330000000400000000333300013030000001000
