000000000000000000000000000000300000000010400000000003010000000000000000001000000000000000000000000000000000000503100000000000001000000000000000000000000000000005000000
000000000000000000000000000000000303330000000000000103000000002000000000030003301000000000333000300000000000000000000000300003600000000000000330000000000000000000000000
000000000000000000000000000000000003330300060010000000000000000100000000000003330000000300035000000000000000100030010003302000000030100000003460000000000000000000000000
000000000000000000000000000000000003340000000020000021010000000000000500000003310000000000033000000000000000450000000003330003000000000020003330000000000000000000000000
000000000000000000000000000000000040000000000050000060010000000000000600000000300000000000003300000000000000003300000003330001000000000660003330000000000000000000000300
041100000000000000000000000000000033030000000004000000500411100050000000000033330000041100033300000000000500333300000003330001031104010660303301000000000003300000300000
000000000000000000000000000000000003303003030033333333330000000000500000010003330033000000033336330000000030030300000303333030000000030303333330003010001000000000303003
000000000000000000000000000000000006000000000000000010000000000006000000000100000000000000000000000000000000000000003000000000000010000300100000000000000000000030000005
000000000000000000000333000000003000001000000000000000000300000002000000000000000000001000000010000000000000000000000300000000000000000000000030100000000000000000300003
000000000000000000000333000000000000000000000000000000000000003000000000000000000000000000100000001000000001000100001000000000000100000000000000000000000000000000001001
000020000020000003003333000000000000000500000400000000000000230000000300000030000030000000000000030003000000200000030000000000000000000000000002000000300300000030000004
000000000660000000033333000000000003000000000000000000000000000006000000000300013000000000000030050000000010600000000330000000100000000000000000300000003300000000000000
000000000660000003333333000004010000030603000000000030350001010006600000033330000301000000000000303030000006600000033030000000000000000000000006040000333300100001311010
333333333333333333333333303300000000003000000000033333330333333330333333333330060000000000003033333000000333330330333000000000000000333333333536033113330300000000000000
