000000000030000000000000000000000000000000000000000100000000010000000000000000003000002000000000000000000000000010000000003000000000001010000000000300100000000000000003
300000000003300000300000000030030000030000005000000003003000010000000000000000000300000000000000000000000000003000000000000330000000010000000000000300000000200000000000
000000000030100000000000000000000001000031000000000000000000300000001100000110003010300301000000010060030000005100000010003010000000000004000000110000000000000100100001
000000000000000000000000000000000000000003000000003003000000000000000030300000000000000000000000000000000000000000000000000000000000000000000010000000000000000000000000
000000000000000000000000000001000000000000000000000000000000000000000000000000000000000000000003000000000000030000000000305000000000000000000000005000000000003030300003
000000000000000000000000000000000000004000000000000000000000000023000000000000001000000000000000000000000000000001000000100000000000000000000200000000001000030000030000
000000000000000000000000000000000001033303000100030333030000000033333300321030001000000000300000000000000003333300333330000000000010030000003333333000300100060000033330
000000000000000000000000000000000000003000030000000000000000000030300000010000600000000000300000000000000000000000001000000100000000000030100000010000300000000003030000
000000000000000000000000000010000000000330000036000300000000000000010000000000000000000000001000000001300100000000003000000000000000000000000000003000030000000000000300
000000000000000000011000011100000000003010000000000000010000000000000000000000003200010000000000000000000000000010000000000130000000000030000000000000301000000000000000
000000000000000000000000000000030000300000003100003001000000000000000000100000000300003001000000000000000000000000000000000000000000030003003000000000000000000000100000
000000000000000000000000000000000000000100000000000003005000000000000030000000000040000000000000130000000000000010000000000000000000300000000000000000500000000000000000
000000000000000000000020000030400000000000000000032000000000000000000000000300300000020100400000000000000000000003601000200010000000000000000000000100000030000000000500
333333300000000033333333333300010000000000000000033003500000000633303300000000000000333331300000000000000303303300000003333033333333300000000333333000020000000000000000
