000000000000000000000000000010000000000010100000000003030000000200000000000000000000000003005003330100000000000000003333000000000000000000000003333000000100000000010000
000000000000000000000000000000000000000000000000000030330000001030000003000000000500000000000033300300000000000300033300000300000000000100000300333006000000000000000030
000000000000000000000000000010000000000000000000000303030000000000001200000000000000000000000303330000002000000000300300001000000000000000000031303000000000000100000000
000000000000000000000000000000000003000000000000000330030000000000030000000000030000000000000330310000000000000003330330000300200000000500000333303330100000000000000100
000000000000000000000000000030000010000000000000033103330000000000200000000000011300110301030331300000000000000033331330100000010000030000003303300060000000000000000000
000000000000000000000000000000300000001000000000033333300000000322000001000000000000000000033330330020000000000003333130000000000000000003003330303000000000000030000000
000000000000000000000000003300300330040000000000033333300000000130033000000330031330000330333333301033010100000033030330000100000003100000003300233000003300030030000300
000000000000000000000000033300000000030000000001000000000000000000033300000000001000000000000000000000000003010000000001000000300000000000000000060000103000000000000000
000000000000000000000000333300030000000301060000300030000000003000333300000000000000000000000000000000000000000004000000000000000050000000000005000000000000000300000000
000000000000020000000003333300000030010000000000205000000051000003333303000000004100000000000003300000005000600000000000000000000003200000003000000000001000000000000002
000000000000000000000033333310000000000000100010000000010000000003303300000000000000000000000000000000102030000000000000000000000000000000000000330000000000000000000000
000000000000000000000333333300000000000000000000030000000030000333133330000000004000000000000000005000000000000030000000000000000000001000300000000010530000000000000000
000000002200000000003333333300000000000003020000000000000000000333033300100000000000000000000000000000000000000000000030000000022000000000000300000100000000010000200000
003333333333300333333333333300000000330033333331000003330050000353303300010000330003000000000010030000100033333333333330000000033330000000000250000003335300000003003330
