000000000000000000000000003000000000000000000000000000006000000000000001003000000000400000000000000000030000000000000000003200003000100000006003030000000000000300000000
000000000000000000000000000010000000550000000000420000010555000000000000003002000000000000000000002000000000003100030000000000200000000000000001000010000020000000000005
000000000000000000000000000001000000000000000000100000000000000000000310000000000000000000000500000000000000200000000040000000004000000000000000000600010000000010000000
000000000000000000000000000001000000000030000000000000000000000000050000000000000000130001000000000002000000000003000000000000000000000000000100003000000000300000000000
000000000000000000000000000000000000000000000000000003000000000000000000000000000000000000000000000000000000000300000000000003000003000000000000000000000100100000000000
000000000000000000000000000000000100000000000000000300000000010000000300003000600000000000024000000000000000033300030036000013000000000000000100000000000000003000130000
000000000000000000000000000033033333030033001000030333333330030100000033303313333303303303300000003333300333333300000003333333333003033333030000000000000033033330000000
000000000000000000000000000000000000300000300000000000300000000001000000000300000000000000000000300600000000000000000000000301000003000000020000005000000000000000000000
200000000000000555000000000000100000300000000000000000000600000000000300010000300030355500000000030000001000000050003000000000000000011550000000000000000000000000550000
000000000000000000000000000030000000000000000000000001000000001001000000000000000000000000100030300000000000000000030300000000000000000300000000060000000001000000000001
000000000000000000000000000000000000000005000000000000000000000000000000000000001001030000000000000000000000000000060000000006000000000000000000000010000000300000006000
000000000000000000000000000300000000000000000000300100000000005000000300000000000030000000000000010000000000000300100000000003003000000000000030000000000300000001000000
000000000000000000000000033300001000000001000003303000000030000000003000000000000000000000000000030000000000000030060000004000600000030000000000000000003300000000000000
333333333333333330033333333300000300000000330333300010000001010303330300000000000000013003310000001000000000000003000000000000000000033300330020000333030333000033300030
