000000000000000000000000000000000000000000000000000001000010000000000000000000000000000000000000310000000030000000003000000000000000000000001000000000000000000000001100
000000000000000000000000003000000000000000000000000000620000030301000000000000010000000000000003020010060000000000000300130510000000203100000000000300300200300000000000
000000000000000000000000000000540000000000000360000003660000000000000000000000000000000010010000661000000100000200000000030000000006003000001030000100006600000000300000
000000000000000000000000000003000000000000000330000010660000000000000000000000000000000000000030660000500000006600006000030000000006600000000000000000006603300060000030
000000000000000000000000000000000000500000000000300000060000000000000000000000000000010000000000360000000010006600000000330066000006600000000000000000006105300000500000
000000000000000000000000000000001000000000000000002000600000100000000000005000000000000000010000660000000002006600000000330006020006000000000003100020036606300660000000
000000000000000000000000000000000000000000333333333333031000300000040004000000000000003000033030333033331333333300000000331203033003200000003333130133333330333330000040
000000000000000000000000000000040000000000300000000000000400000000000000000000000000000000000000000000031000000000000000000006000000000100000003000000001000060000010001
003000000000020000000000000000061000030001050000000000000000002003000300002000000100000000000000000010000000000000100000000000002000000000000000000001300000000000000003
003000000000660000000000000200000100030003000000000000000300006003000000000020000000000000000013000030000000000000000000000000000010230000000000300000000000000006000000
033000200000660000000000006600000000300002000006000000000000066003000300000660000000000030000000001333302001000000000000000000000006600000000000066000000000000000000000
033006600000660000000000006600000000330030000020600000000000006030001600010660050000000000000000000330060000000000003000000000000000630000500000066000000000000000000030
033006602000660000000002006600000000330066305006600000003200066030006600200660000000000000000000000330066000000000001000003010002000000000000020066000000000000010000000
333333333333333333333333333300000003333333033303000000003003330033333330330033330333000000400530000433333010000033336030000000333033000030003333333001000000050000000031
