000000000000000000000000000000000500000000000042000000000000000000510000300300000000006000000030000000000000000001000000000001000000000000000002000000000000000000001000
000000000000000000000000000000000300000000000010000020000000000000003000000000000000013000000003006000060000000100000000000000000000000120030060000000000010005000000000
000000000000000000000000000000000000104111000000000011000003100000000000000000000000100000000010010000113000000010100000000301100000100101000005000000000000010000011040
000000000000000000000000000003000000000003000000000000000000000000200000300000000000000000000020000000000000000000000000000000000000000000000000000000000000000000000010
000000000000000000000000000005000000003000000000006300000000000006600000000000000000001000000060000000000000000000000000000010000000000003000066000000003000000000000000
000000011000000000000000000001000000201300030000300000000000100000300000220001100001001000030360050200000000000000000000200000010000000006000006003110000000000000000000
000000000000000000000000200500003103333300000000033303300000001033333333330130000000333303333333033333313000000000320051030333300000030303333513303000000001000003303033
000000000000000000000000200000000000002000000000000000000000000000001000300000000000000030003000000000000000000000020000000000000000000000003000000000000001000001000000
000000000000000002000000000000000000000040040001000003000005000000000000000000002060000000000000000000000000300000000000000000000000100053000000000000000000000000000000
000411110000000011100000000010000000030000000000100001000004100000000000001000001100000100100000000011000000000000000300000000100000000030001000000003000000041100000000
000000000000000000000000200000000200002000000000000000000500000031000000010000305000000000000001300000000000000000020000000000000000001030300000000003000001000000000000
000000000000000000000006600000003000006001600000100000000000000000000100000000100000000000000030010000000000000000030006000030630003000000000000100000000000060000000000
020000000220000000000006600503220000066005000000003000000300000000010000000000000000110000000100020004000000000000630050000001000203000000010022000000000002000000100000
333333333333333333333333333335303003030330000200000000003133333000200500000003333303000000300000051330330000000003330330000000333053300300000333333030000033330332002002
