000000000000000000000000000000000001000100000000000000000000000000000000000000010001000000000000000000000000000000000003010000100000000000000000000000000000000000000000
000000000000000000000000000000000000000000000300000000000300000000001005010000000000000000000000300000000000000000000005005000000000000000001000000001230000002000000000
000000000000000000000000000000000000000001000000000000055000000000000000001000100000030000000000000000005000000000000000000000000000500020000000000000010500066300050000
000000000000000000000000000000000000360000000000000000000000000000010000003340006000000000003000040000300000000000660000000601000000000000000000000000103000066000000000
000000000000000000000000000010000000000000000000000000030000000010000000000000506300000000100000000000000000100000660000000000010000000000000000000000000000061000000000
000000000110000000000000000000000010100000000100000000000000000000000000000000060020000000000000103000030003200100660200051100000000000220100000000000003000066000010010
000000000000000000000000000000000000000000000103000353330000003000000000300330333333000000000000000030003333333001300320000000000130313303330000000003033033360334000000
000000000000000000000000000000100000006000000000000000010000000000000000000100000000000000000100000000010300000000000000000020000000000000000300000000000000000000000033
000020000000000000000000000000000000000000000020000000000000000000303000000100000000000000005000000000200000000000002000000000000000000000000000000001030000000000000000
000660000020000002000000000500020010000000000660000020000000001000000000066000001000000201600000000006000000004000006000000000000001004000300002000000200000000004310000
000660000000000066000000000000000000000000000660000664000000000000000000006000000000001600000000010000300000000000066000000005001000000000000066000000000011000000000000
000660000000000066000000000000000000000000300660000060000000000000000005066000000000001600000000000006630000000000066000000000000000000000000066000001510600000000000100
000660000220000066020000000000200000000000051660000000300031500002230005066003000001006302000000000000600000100000006000030000000000000006000066023300200101000000060000
333333333333333333333003033333033330000000300053330300330000000333333330300330000300333330300000003333303000000033303331000000000000000000003333103133333300000030000300
