000000000000000000000000000033030100000000000000003500053033000000000000000000010003000000001000000000000000000100003000200030000000033030030000000030000000000000400001
000000000000000000000000000033333000000000000000000000033303340000000010000000003000000000000000000010000000000000000000000000030000000330000000000000000015010000000303
000000000000000000000000000033303106000000000030000000303333300000000000000000000000000000603000000000033000000000003000000000000000003033101000000000000000000100500003
000000000000000000000000000003303000200000000000001033033330300000000305000000200000060000300000000003331020000000000000000000010000033033000000000000304000000100204333
000000000000000000000000000030130003000000000000030330333300300000000000000003000100000000003040030033332300000000000300000000000000033033000000006000000000000000033330
000000000000000000000000300033333003000000000300003033303113300000000000000003000000000010000000000330333000000100000000003000000000333033000000000000350003000000333033
000000000000000000000003330033303303001033003300030333303333633003030043133333303303000000000010003333330030333320000000033100300333330133300000000060330000000003030300
000000000000000000000333300000000000000000001000013000050000300001000000000000000000300000030330000000000000000000000000000000000000000000000030000000000000000006033000
000000000000000000003333330003000000000030000000030001000000300000100000000030000003000000003305003000000000000000000030000000000030000000000000000000000130000000310300
000000000000000000033333330000100060000000000000000100000105300000000000000300000600000000000033000000000000006030200000000100000300000030003000000000000000010003330000
020000000000000003333333330030003000006300003000000000000000000000000000003030000000000000033330000000000000030000033330000000000300000000000200000000000000000003333300
300000000000000033333333330010000000000000000000501030000000006000000000333000000000600000033333000003000005100001333336000000000000000000000000030000000000010003034300
300000000000000333333333330010000000000000000000000040100100000000000033330330000000000000030330000000000000000003013300000000100000000000003000000000000000000003033300
330333333333333333333333333300111000000000333033331000000000000000000033363040010000000003031330333033003003300033333330000000200000033034030013330333330300000000333303
