000000000000000000000000000000000000000000000000003000000000000000000000000000000000000000100000500000000000000000000000000000000000000000000000000030000000300000000000
000000000000000000000000000005500030010000300000000000000000000000000005500000000003035000000000000000000000000000000000000000055000000000000000002355000000000000006000
000000000000000000000000000000300000000003040420000000000000000000000000000000000000000010000000330440400010000000005300000000000000000000330000033000000000000000000000
000000000000000000000000000000000010004000000000001000000000000000006000000000000000000000000000000000000000000000000000000000000003000000000000000000000005000000000000
000000000000000000000000000000000000000003000000000000000000000000000030000000000000000000000000000006000000000300000000000000000000000000000000000000000000100000000000
000000144414000000000000000000000300010001200000000000000000000000001006000004001400030000100000001000000000203003000000000000000000000000000023000030001000000014441000
000000000000000000000000000031333300000000330030031000000010000000100000030300300000033333333330003300300333333330000000000000333003333600003033031300333000000000000000
000000000000000000000000000030400000000000000000003000010000000000000000100000030000300000000060000100300000000030000000000100000000000000010020000100000000000000000000
055000000000000000000000000000000030000000000000000000300000000400000000000000000030000500000000000000000000000000000000000000004000000000000060000000006000000000331000
000000004444000000000000003300300000000000000003300000001444000000003300000000000000000000050000000000000000030030000000000000044440000010000000000000030000000000414430
000000000000000000000000000000003000000000000000000100000000000000000000000000000000000000000000000000300001000000000000000000001000000000000000000005000000001000030000
000000000000000000000000000000300000000000000300000000000000000000010000000000003003000000000000010005000000000000000000000001000000000000000000000060020000000000000000
000000000000000002020000000040410000600000010000000121200006000000000100000000002020000100000000000000001010000100023200000000000000124011000300000000002000000000000100
333333333003333333333333333000000010000000333333633333303300333030033000000003331303000000000000000000000000000033030330001000330033300000050100000330331300000000000333
