000000000000000000000000000003000000016030000000001003010000000030000050000000000000100100000000006000000000000000000000100100000000000030000000000000000000000000000000
000000000000000000000000000006000000000000000000300000000000000000000000010030000000000000030600000030000000000000010030000000000020000000000000000000300303000010000000
000000000000000000000000000000000000000000003000300020001000000000000000300030066000000000000020000061000000000000300030000000000660000660005000000003000100020000000000
000000000000000000000000000004000000000000003000000060000000000000000000000000006002000000400000000060002000000003303030000003000060000360020000000003000300600000000000
000000000000000000000000000004000000000000330300300600010000000000006003000000066066000000000660000060066000000033300030000000000660000460660000000003000300660000000100
000000000000000000000000000200000000000000050000000600100000000300000033300030066066000000000060000066066003100033304000000000000160000060360000003333000000600000000000
000000000000000000000000005300300000000000330300333333030060000000000003000013330300000000033333333653330000000003000030000000333333313033300000000330000033330330000000
000000000000000000000000000000000000000000000000000000010000000003500000000000001000000000000000000000000500000000003000000005030000000000100030000010000000000000000000
000020000000000000000000000300002000000000000000000000040000000000020000000000000000000010300000000010200000000000000000030013000000000000000000000000000000002000000000
000660000020000066000003000300010100000000000000030660000000000000660000020000000000103300030000000006600000000000000001000030003200000000000000000000030000060000066040
000660000660000066002033000300066000503000000000060660020000060000600000660100030005033000301000000000602000000100000000000000006630000000000000000000000003066000066000
000660000660000066066333000300066000000060000000500060600000000000660000660003000000303000000000000006600000000000303000000100006600000033000000002000000000006000066106
000660000660000066066333000000066000000005003600000060660000002000610000060000003000003000000000000000000001000230006000000002006600000120003000000000000005000000006000
333333333333333333333330000303333330000053000000003333030000050030033333030330002000330000000000003333333000005300000000000003333303360000100000000000005033003300330301
