000000000000000000000000303000000000000000000003000000000000000030000000000000000000000303000011000000000300000000030300000000000000000100000000030000010000000000003000
000000000030000000000000000000030000603000000000000000000000000000300000000000000000000000000000000000000000300000000000000001100010000000000000000001000000000000000000
000000000000000000000000000000000060050034000003300000010000033000010100000100000101000000030300033300003000000000050000000033300003000000000010000300003010000000001000
000000000000000000000000000000000000055301000001000000000000000005000600000000000000000010000000000000000010000000001000000000000000000360000000000001003001000003010000
000000000555555000000000055550000000005355100000300000050000000005050100500000000000000050500000000000001015055030005050003010010000000000000000555000000000010000030000
330000003333303000000000033330000000033330000000000000330000000033333000000003300000003033000000000360000035103006003300000000000000033000000000033300000033000000000000
000000000000000000000000000000000000000000000000000000000000000000000010000030000000000000000033000000000300000000000340000100000000000000010000000000000000000000301006
000000000000000000000000000000000000000000000000000000000003030000000000003000000000000000000000000000000000000000000003030030000000000100001000000000000000300010000000
000000000000000000000000000000000000000000000002000500000000000100000000400000000006000300306000000000003400000000630000000000001000000000000000000000000000001100000000
000003333000333000000000000030000300000000300000030000030000000330003300005000000000000000000000000000300000003000000003000000000000000000000000000300000000000300000000
000000000000000000000000000000000010000000300000300010000000030000200000000000003000600000020000400000003000000000000000000005000000043000000000100003000001000030000000
000000000000000000000000000000000000030100006000000000000600055000000000000600000000000330000000000000000000000000555551000000000000000051005000000000000000000000105555
000000000000000000000000000000000003000000000000000000000000232000003000000003000000000000030000003300000000000303330300000000000000000000000000000000000000000000030000
000000000000000003300000000300100000000010013330000000030000000000000000033000000000060000000000030000003000000000001000000300000000300000000000000000300010000000000000
