000000000000000000000000000000000004000040000100000000000060000003000000000000000000000000000000000030000000000000000000000000000000000000000010000000000000600000000000
000000000000000000000000000000000000000001000000000000000000000000000000000000000000000000000000000000000000000000000000000100000000000000000000050000000000004000000000
000000000000000000000000000000000000000003000000013600000000000101333002000000000000000033032000000000000000000000006000300000000000000000000000100030000300000000000000
000000000000000000000000000000000000000003060000003000000000000003333006606300300000131333063000000000000000000003130000000000030100000000005003600030300000003000000000
000000000000000000000000000000003000000000310000003000000000000133030066000000000000000330066000000000000000000030000003000000010000000000006602600030100010000000000000
000000000000000000000000000003000160000000660500003100001000000310103000000000000303333030050000003000130000020300000030000000103100000330306600000033500000005030000000
000000000000000000000000000000020000030000333000300303330000003333300003330336303330303330033333030000000303333033603300000010033303330000003333331033333003300330000000
000000000000000000000000000001000000000000000000000000000000000000000000000000100000500000000000500000000000000002000000000050000500000000000000030000000000000000000000
000000000000000000000000000000000000000000000030000000030005010000100000000300000000000300000000500000050000000000000000000006000003000000000000100000000000000000000000
020000000000000003330030000000500000003330000100003000000000001030010000000000000100060000000000000001000100000000000000000310000010000310000003000000000000030300010001
660000000000000333330030000030000003330330300000000001000000000000000030060000000000000000000000000000000400600000000010333300000000066000000010000000000003030003300000
660000000000003333300030000000000000333300000010000000000000000030300000000060000000030000030060000300000000000030000000333300000010066000000000001000300033333000000000
660000000002033333330033000000000003330330000000010002030000000030000010050000100000103000000030000000000000000000000003330330003000066000000000000040000033033300000000
333333333333333333300033333300030000331300000000033403330003000030333300000000010030033034300000002000105000000000300003033300000000133333300000000400000033033000000000
