000000000000000000000000000050000000000000000000000000000000001000000000300000000000000000000000000000000030001000000000000000100000000000000005000000000100003100600000
000400000000000000000000000000000000000600110130030000000000000500000000140000300000000000000000000000000000000001000000010000000400050000000000000010000010040000000000
000000000000000000000000000000000001300000000000000000100000003000010010400060003000000000000301100000600000000000000030000000000000000000100000000000000300000000010130
000000000000000000000000000000000200000000000000000330011000000000000000030000000000000000000000000000000000000000000030000000000000000020000000000031000050003000000003
000000000050000000000000000000000000005000003000000000000000000500030000000005000000000000000000000005000000600000000000000000000010000050000005000000000000000500000010
000000000000000000000000000000000000000000000000000000000002320002002500000000000000000100000000000100000030000010023200000000001003000000000000000001222000000000000000
000000000000000000000000000000000000030000000000030300033333330333333600050100000000300000030333330000000000000033303030000100000000300026001000010033333000000003333303
000000000000000000000000000000000000001000000000000000000000000000000000000000000001000001000000000000000000000300000000000003000000000000000000100000000000000000000000
000000000000000000000000000000000030100000000000000000000000000000000000010000000050000000000001000000001000000000000000000000000002000000000000000000000000000000001000
000000000001100000000000000310000000000130030500300000000001000000000000000000000000000000303000000000003000020000030000000001000011010100000000000000000000000130003000
003300000000000000000000000000000100000000506000000000000033000000600000000010000000000000001004000000000003000000100101033000010000000000000000000003300000000000000000
000000000000000000000000000000000060000000000000003000000000000000000000050000000000000010600000100000000000000000000300006000000000000000000000000000000000000000000000
000000000000000020020000222000000000000001000322000000200000000000000000000000000000300022000550000023020003000000000000000000030000000203200030000000100000200500000000
333000333333333333333333333300000003310300330303303031331330003000000000000001333303033333300000213330333303000300010003330003330333333333130030100133001333330230000000
