000000000000000000000000000010300000000000000000000030000000000003000000000000000000000000000060000000000000010000001000000001000000000001000000000000003000000000000000
000000000000000000000000000300000000000000001000030000000000100000000000000100000003000000000000000002000330500000000000000501000000000000030004000000400000003100000003
000000000000000000000000000000440010000000020000000000001004000001000000660010000000004300000000000066000300120000001000000000000400010000002016500000000000000000000001
000000000000000000000000000000000000000300000000000000000000000000200000660000000000000000000000000060004000000000300000000000001000000000000066000000000000000010000050
000000000000000000000000000030000000000000000000000010005000000000000000660050000000000000000000000060000000000030000000000000000000000000000036000000000500050100100000
000000000000111100000001440000200001000000000000100000100030003110000000660000014400032000000000110006000000000500001000000011002000000044000060000000001111000003014000
000000000000000000000000000003333035333030000000000000003133333000100033530330000000303033000030003330003633363330333300000000333333300000503303333030020003000000003000
000010000000000000000000000000000000010000003000000001001000100000000000000000000000000000000500000000000040030003000000000000000000000000000000000000010000060300000000
000550000000000002000000000005020033030000100000300055400005500000000000005000000300000003000002000000000010000000000000000000000100000000300000030000550000000000000000
000111000000000066000004400000660000000000000000001014000001110000000000013000010000000000000000000000000000000000003001003060000600000000000000000000111000440000000000
000000000000000066000000000000010000030000000000000000000000000000430000000006003400100000000000002000000000000000000000000000006100000101000300000000010001000000000000
000000000000000066000000000000060000000000003000010000300000000000000000000000000010000100060000000300000110000000000000030000006600000000000000000000000000030000006600
000000000000000066000002000000060003100000001400000000001000000000003100050000100000000000000041001000010010000000000000000000001600310000000000000000500000000000000000
333333333333333333333333333333033310000000000000033300330033333300300100000003333330000000100000430000030303031033333300000000333333300000030330330330333035333330000000
