000000000000000000000000000000000000000000000000000200000030000000000000000000000000000003060000000000000060000003331000000010000000000000000000000002010000005033000000
000000000000000000000000000000000000300000000000000005550062001000000010020000001000000200003000000000000000000000000000000000000200020010000000400000000000000000005555
000000000000000000000000000000000000000002000001300010110004000000000000111101100000001111000000001000000000000000030500000000604400000101100000000000000300400000300311
000000000000000000000000000000000010000000000000030030050000000000000003110100000000001101100000000000000000000000000000000002000000000110000000000003000000000000000000
000000000000000000000000000000000000010500000000000000030000000000500001110300000000001100000000000000000010000000000000010010006000300110110000000000000000000000000000
000000000000111111000000000000000001111101000000000000005000000006000300000000004000000000011100000000011000000000000001510030000000000000003003000111100100000000000003
000000000000000000000000200000000000001001000000033333430330300000200031300003333300333000000000110000000050000000020000010000003003033000000002000000000003003303333330
000000000000000000000000000000000630000000100000004003000000020000000000000000000000300000000000000000000600000000000000000000000000000000000000000300000000000005000000
000555500000000002000000200000000000302000000000001000000000000000510000055550000002010000000000000002000000555500000000005555000331000000000000000301001000000000002000
000111111000000011110004400000000000004000110000000161106000010000000000010053000000110000000000000044000001011100000300011010310000000000000000000110000000030000002100
000000000000000011010000000000000000000300000000000130100003000000000300000000001000010004000000000000000003000000030000000000000000000030000400000000000300000010031010
000000000000000011010000000000000000000000000000500110100000000000000003000000000000000000000000000000000000000000000000000000100000000000000000000000000000001000011000
000000000000000000000000000000000310010004000000000000000110000030001000000040000011000000050000300000100000100010000000000006010000000000010000031000000500000000000000
333333333333003330000033333000010000303330333330033300000000000000000033303330000000303030000000000300100333333360000003333303330330000000000300000003330000003000330000
