000000000000000000000000000001000000000000000000060000003000000001000010000000000000000100010000100000000000000000100100300200000001000030000000000000000000000000000000
000000000000000000000000000000000000010000101000004300100000000000000000101110003000001000010000300000000011010100000000000000000000000000000000000000000000100000000000
000000000000000000000000000001005000000000100000100030000000000030000400000000000000000000011111000000000000003000000001011000000000010000000000100000030301000001110000
000000000000000000000000000000000000000000010000000000000000000010000000006010000000100000000102000000300003000000000010000003000001000000100000000030000010000000000000
000000000000000000000000000000000000000000000000003100000000000000000003300630503000000000000000000000000000000000000500000000000100000000000000000000600000000000003000
000004414000000000000000000000000040000000000000000000000000003000000000000000000044040000000000000001000000010000000440000003000000016000000033000003000100010000000000
000000000000000000000000000000033000000000031313300000000000000333333003330000000000000505003333350000000033300000000003303303000001001000000000000000000033031303333330
000000000000000000000000000000000000000000030055000000000000000000000000000030000000000000000000000000113030000000000000000000000000000010000000000000000000000000000000
000000000000000111111111000000000000000000011010000000000030000000001011503000000000000000011630000000000000003600000000111101000000011500000000600011151000000000000000
031000411111000000000000000003100001111100000000000040001110100000030000000000001000000000000001500010000030000003100000030010000003000500000300004000000000103000000000
000000000000000000000000000000030000000000000000000000300000000000000000000000000000000000000000000000002010000000000000000001000000330000000000000000000000000000000000
000000000000000000000000000000000000000003000000006001000003000000000000000000100301000000000000000000000000000000000000000000000000400000000000300000001000010000000000
000000000000000000000000000030030000000000000000010000000000000000000000000000000000030000000000000000000000000010000000000010000000000000000000000000000000000441000000
333333333333333333000333333300333030333033333303001000003333333000300033330340000000000000033333333033333000000003333333333000000000033033300136033333330000000003000000
