000000000030000000000000000300000000000030000033000030000000000000000000000403003000000050000000003000003000001000301000003000000000000000030050000100300004000100003003
000000300000000000000000000000000000010003000100003060000000000000010000000000000000000060000003000000000000000040300000000000000020000000000006000000000000000000000001
000000000000000000000000000000000003001032000030011000010000400000000000000000000000000000033300001001000000010010000030000000000000000000003333000000000011000030300000
000000000000000000000000000000000300000000000000000000000000030000000000000000004000000300000300010000000000000000000000000000000000300000000500000000000200000000000030
000000000000000000000000000060000000000000000000000000000000000000000000000000000000101010030100000000000010000000000000000000000000000000000000000000000000030000000000
000000000000000000050000000010000003000000000000000000000130000000005000000000030300000055000000000000400010000000000100000000000005000000003000010000000000000000000000
000000000000000000000000000000300031000000330330300003030000000000060000000000000006006130000000000000030601000000000030000000000000000400030000000000000001033003000000
000000000000000000000000000000000000003000000000000030406000000300000000061003000005000000100000000000000000100000100005006100000003000000000010000000001000000000000000
000000000000000000000000000000000000000300000000000000000010003000000000000001000010000030503000000000100000000006000030000000003000000300000601000000100000000000100100
000000000404011100003333300000000000040000333300000000000000400303300030000000100003000005000003010000000100000300000000000003333300000404010000402000000300030000000000
000000000000000000000000000003000500000000000001000000000000000000000006000000000000300000000000000000000000003000000000000000000000000000000000000000000000000000000000
000000000000000000000300000000100000000500300000010000000000000300000000000000000100000000000000000000003000000000000000000000300100000000100000000010000000000000100000
020000000000000000000300000000000500000000300005030000000000000300003032100001000000000000000000000300000000030000000000200000300000000000000300000000005000000000000000
333333333333330003303000000000000003303333000000000050003300333000050030303000003303000000033333303103333000300100000003333333000016033330333033303000000033103331000000
