000000000000000000000000000000000000060000000000303000000000000003033301000300000000000000100000000000000000000100000001000000000003600000200000000000033300000000001010
000000000000000000000000000000000005000100000010000000000000020000300313010100000000100100000000003000000000000010000000000000100000000000000000000000003100001000001000
000000000000000000000000000000033010000000000010000000000040000000030300001110000000000000400000000003000001010010000000000111001000003000000000000000030100000003610000
000000000000000000000000000000000000000300000000000000000030000030003300000000000000000000030010100000000000000000000006600030000000000000010000000000033300000000000000
000000000000000000000000000000000100000005000000001000060000000033333000000000000000000000000000000000030000000000000000050000000000000000000000000033130000000000500600
000011100000000001000000000000000030200500000011000000002001000030303300000003000000100100000000300200060000300002000000000000030000000000000000000030333300000010000000
000000000000000000000000000333331303030330000000000000000000000333333333333330001010065000000000033333333303330303333333333331303130300000000000003103333350006003000313
000000000000000000000000033310000000000000000013300030000000000000300000300000100060000000000003330040000030500000010060000033000000000000000000003000000000000000000000
000000000000000000000000000300300000000000000600001000001000000000000001010000000000100000000000003000000000001000000000000003000000050000000000300000000000000000006000
000011110000000010000000030300000000030000000030000000001000030000003000000000000000030061100003030000000000000000000000000303300000000000000000000000000000001111000000
000000000000000000000030033300000000000000030133000000000000000000000000010000000100000000003003330000100003000000000100001033000000000000000000000000001000000000010000
000000000000000000000033333300000000000000033333300000000010000001100000000000001000034000000333330001000600000000000000003363000000000000000000000011560000040000300000
000000002000000000000030333300011000030000030130300300000000000000000000001010601003000000000033330003111000000000000000303333000011103000400300000000000000000000200003
333333333333333333333333333300060003333033333033300000003133333000000000000004303333333303333333300001000000000000100003333300000000000000000000000000000033333331331333
