000000000000000000000000000000300000000000400000010000000003300000000000040000000000000100000000100060000000000000003310000000000000030000400300000010000000010000000000
000000000000000000000000000000000000000000000030000000000330010000000003000000000010000000003000000000001000000000000000000000003000000000000000000000060000000000010000
000000000000000000000000000000000000000300000000000001003303300000030000000000000003000000003020010000000001000000000000000000000000000000000030000000000000000030000000
000000000000000000000000000000000030030000010000000000000333300000000000000003000003000000000660030000000000100000600000000006000500020000000000001000000000000000000000
000000000000000000000000000000000130000000000000050060003033300500000000001000000303000003300666000050000000000000000000000000000003100000000300000000000100000000010030
000000000000400000000000000000000333000000000000300000003333300052000000000000300333001033300600200600040000530400000000000000000033000000400000000000000000000400000000
000000000000000000000000033033330100000000300000000003303503003000000033333330333333330333303030300000000000000000100000033033300303300000003031303000000000000000000300
000000000000000000000003330000000000030000003030000000000000300106000000500000000000000001000333000000000000000000000200033000000000000000000000000000010000000000030300
000000000000000000000033330000000000000100003334000000000000000000000000000000000000000000003030000000000000000000000000333300110000000000000000000000000100000000333300
000000000020000000000333330040020000000000333330053000400000000000200000000000003100000000030133300000001000000000000003333300003000000020000000000000100000020003333330
000000000660000000003333330000600300000600033330100000000200000300600030000000030000000001030303000000000001600000000003333305001000000060000000003000000000660010331300
000000000660000000033333330030660000000000303300000000010000000006000000040000000010000000033331005000300050000000000303303300150003000661000000033000000000600003333300
000000000660200000333333330000660200001060001330000000000000100306602000000000000040000003033303000000000300000000000003300300000000000060200000333000000000063003033304
333333333333333333333333300300333330201000363300303310330000000303353400003300000000331333010330030000330000000000003003333003200100003333300000303000005033333313003003
