000000000000000000000000000000000000000000000000000000000110100000000000000003000002000000000500511000000033000000000010030000000000000000000000011300000000003500300000
000000000000000000000000000000000000010000000000000000000000000000000000301000550105000000000000006001000100000000100603000000000000000000000005000055000530033000000000
000000000000000000000000000000500003000000000000000100000000000000000000000050500000000000030000050000003000000000030001000000204000000000000000000000000030000003000000
000000000000000000000000000030000003330000000000030000030001000000000300000001100002000000336000100000000000000000000000000000001000000000000000003000000030000003000000
000000000000002000000000000000001000000101000000130000030000001300000306600000000000300000330000050000000000000050000160000000000000010030003000033000060030030003330101
300030000000000000000000000031003003000006600000033330330000000330033305000000100100333530030000000000000000000000030000000000300000000000003330030000000230000000330003
000000000000000000200000000000010003030000000000000030030000000003031060000000303333001033300000030000000000000000002033000000000010030000010033330033303300000033030000
030000000000000000350000000000000100000003000035000000000000030000000000000005000350400000403000000000000000001000000000000000333001000000000000050000000000000000000000
000000000000000000000055000530000000030000000000105500050000000000000000000000000000000000030000000550006000030000200000000000000030015500050000000100000000003000000005
300000000000003000000000000000000000000000300000000000000400000000100000000300001000000000030000000000000001000000000006004000300000000006000000000000030000000002000000
333000000000033000000000000200000000001000300000000000020000000333000000000003000000000000333310000000000006000000000000000003303000300000040000000001000000500000001000
333000030000333003000000000000000000005000300300000000000000000330000020004003003000000000001300000000000000000000000003000033333000000000000030300200000000000000000000
333000333333333000000000000200000000000000350030000000023000300333000000010303000003300030000200000100002006000000000003333300333030300000020000000000000000000000000301
333000000333330000033333333300000000000200000001313333330000000330000100002000000003000000130300043303333000020000000000035330303030033030030000000310020000000000000030
