000000000000000000000000000000000000030000000000000000000000000000000000000000000000030000000000000000010050000000000000000000003050000001000000001001600000000000001000
000000000000000000000000000000000000000000000000000000600000300000000000003000000000000130003000040020000000100000003000001000000000000000000005000035030000000000000000
000000000000000000000000000000000000000000000000000000000003300000000000000000000030003330000000000000000000000000300000300000000000000000600500003003330000000000000000
000000000000000000000000000000002001003000000000000000010530302000000000002000000000033030003000000010000000000303336000000200000000000000000000200033330030000000000000
000000000000000000000000000000006000000000001110000000003333000000000000066000000000030330000000000000005000000033303000006000000000000000000000000333330000066000000001
000000000000000000000000000000066600000000100000000000003033300003000000066000000000333330050000031000000000000033303000006600000001300000000000000033330000056102000000
000000000000000000000000000033333300000000500000000050003330000000000030303300000000030300003333330000010000000034300003335303330303300000000000000333000033333013333333
000000000000000000000000000000003000000000000000400000000010000000000000100000003000000000002000000000020000000000000000000000000000000000001600300000004000100000000000
000000000000000000000000030001004000300300000000000010000003000000000000000003003100000000300050000000000000000030000000000000001000000000000000000000000000000000000010
000000000000000000000003330000030000033310000000000000000100000000000003000000000000000100000000000000000000000000001000000000030000010000000300000000003000000000060000
000000000002000000000033330000000000330303030000000000000000001000000000000200000000000000000030000000000000020010000000000000000000000000000000000000000000000020000000
000000000066000000000333330000103003030304000000000000000000000000000002000000000003000000000000000000000000000000000000000000000000010000033000000000000200000000000005
200000000066000000003333330020000303303303000000300000000000000200000023005000101003000000020000000000000000620000000000000000010000000000100000000000000300000010000300
333333333333333333333333300030000300003000333331100000000000000033333000000103303333000000033033030003000333331630330340000000003000000000000000000303333300000000000000
