300300000000000000000000000000000000000000300300000000003101000020000005000105000000000000030030000000000000000030030000000000000110000002200000000000000000000003000000
000000000000000000000000000000100010002000300000010000000000000000001000000000000300000000200000000000000000000000040000000600000000000000000000000000030000000000000000
000000000000000000000000003000000000000000000000000000000000001000000600000000000000000000000000400001401002000000000000060000000000000000000000011000101160000000000000
000000000000000000000000000003000000000030001000000000000000000000000000010060000000300000000000000000600000000500000000000000000000000000001002000000000001000000000000
000000000000000000000000000000000003000003000000000000000000006030000000000000000300000000000000000100000000000010306000000000000000000000000066000000000000000000000000
000000000000000000000000444411000000000000000100000000000000000005000000001300000000000000000000010200000000060000000000000000000005000030000060000022020010000000000000
000000000000000000000000000033313330000333000000000001000000000000033300000003333330000000100000003333333230033160100000000001330333300003333303033333313301000000000000
000000000000000000000000000003350000000000000000000000000000000000100000000000000000000000000000000000303000001060000010000000000000003000006000010000000000000000000000
000000000000000000000000000000000010000000000000000000000000000000000100000000000000000000000000000100030040000000000000000000010000000003000000000000000000000000000000
000000000000000000011000141100000010100000000001000000000000003000141000000300000001000003010000000002000000001000000010000200000003000014000000000600000000000000000030
000000000000000002000000000000020000000030000000000050001005000000000000000010000000000000100010300000000000200000020400000000000000300000000000000300030000000000000000
000000000000000066000000000005300000000000000000000100000000000000000000000000063003000000000030010000000001600000160000000000100000000200300000000000000000000000001000
000000000000000066000022020000660000000000022000000044440000003001120100054041036301000440400030000000300006600000660000010000000034000200100000000000000000005000004444
333333300003333333333333333333633330000000303331300000100300000333300300000003333303000000300003330100000033033331033330000000000000033330330000333000330033331330013000
