000000000000000000000000000000000000000000000000050000005000000000100000000001000000000000000100000000000300000060000010000000030000150300000000000000000000000000000000
100000000000000000000000000000000001000000000000000000000000100000000000000000000000000000010000000000000003000030000000000000000000000000000000000000020010000003000000
000000000000000000000000000000000000000000000010000000000000000000000000000004030000000000000000000030000000000003000003000030000000300000001000030100060010000004600000
000000000000000000000000000000000000000005000000000060000000300000050000000000000200000000000100000000000000300550005000000000000000035000000000000000660130000040040303
000000000000000000000000000000020000000300000300000000000200000000000000005000000000000000000001010000000000000000000300000000000000000000301000010000660000000000000000
000000000000000000000000000000000000030001000000003000000000100000300000000300030201000100000030000000010000000000010000002200000000000500000000000200660000000000002000
000000000000055000000000000000000050000000000000030001303033301500000033333033030303000000000000005500000333033301000053330333000000333033333103331333333300000000333331
000000000000000000000500000000000000100000000303000001000040000300010000020000000000000000000000000000000500000000000000000000000000000000000000010000000030046005000000
000000000002000000000000000000000000000000000030000000000000000100000000000000000100500000000000000000205000000000000000000300000020000000000030000000000000000000000000
400000000066000000000000000040000000000600000030000000000000000000000000000000006600400000000000000006003000000000000000000000050660000000000000100000000500000000000000
000020000066000000000000000000002000000000000000003000000000000000000000000000006650000000000000000036600000300000000060000000000660000000000200000000100100000150000005
000000000066000000000000000001000000006600003000000300000000010000010000000000006601000000000300000003600000000000000005000000000660000010110000000000030000000000000000
000220020066000000000000000000020001000600000000000000000000000000000000000002006600000200000000001006600030030000000000050000200660010000000010000010000000000000000010
333333333333333333333333333333333333333333500000033130030000000000000000100003303330303300300000003333333333333300000003333303333333060000005000000000000000000303333333
