000000000000000000000000000000000000010050000000000003000000400500000000000000000001000000000100000000000000000000000503060000000000001101000000000000000000000000010003
000000000000000000000000000000300000003000000000000000000030000000000050000000010000600003000001000000000500030100000000000000000001000000000303000000000000000000000000
000000000000000000000000000000000000030300310000100000000000000000000000144400000010000200010040000000000000000010000000000000000000001000010030300000000000000100000000
000000000000000000000000000005000000000000000000000000000010000000000000000000000000000000000000100000000000000000000000000000300000000000001000000000000000000000000000
000000000000000000000000000000000000000300000000000000000100000003000000000100001000000000000000000063000000000000006010000000000000000000500000006000000300000000000000
111100011111100000000440000000000004400010202200000001001111110111100000000000200000000500000000000020000011100016100000020000140600000220600300000020000111111104011000
000000000000000000000000000033303300000000300333000100000000000020000000500333333303333030033333330333330000000000000003133333000000003333033330333330333300001000000061
000000000000000000000000000000000000000000000000000000500000000000000000000003000003000000000100000000000000010000000000000000000000000000000000000000000000000000006000
000000000000000000000000000000000000000100000010000000000000000000000000000000000000000000000000000000100130000040000303000100000000000000000300000000000000000000000000
011000100044400000000000000000001000000440000000000000000000000000000001200010000000000000000000003000000111000000000000000000000444000000000000500031000001000030000001
000000000000000000000000000003310000000300000005050000000000003000030000000000001000000000300000000000030000000000000000020000000000000000000010000000000002003000000000
000000000000000000000000000000000000030003000600000300000000000000000300000000006000000000000000003000000000000240000000000000000000000000000000000000000000000000003000
202200000000000000000022000000200000000001111110010100004000000000010120101000043000011111000000034430000202200000000000000030000010000111100000000000000020220000000300
333333333333333333333333333333303333333033530000003000000000000000000033303003330333000030000100000000000033313300030003333300300303030030000000000000030036030303303333
