000000000000000000000000000000000100000000000000000000000000005001000000000000000000000000000010001000333000000000300000005000300033300005000000300000000300000000003000
000000000000000000000000000000000000000000000000000000010000000000000000100000030000010000000000000000300000003000000000000010001303300000001000000300200000000000000000
000000000000000000000000000000000000000100000000000111000000004000000000005000000000000000100000000033333000000000000013006000003333300111000000000001110000001000000000
000000000000000000000000000000000010101000000005000000000001300000000000006000000000000000000000300033133000000000003000000000003303600000000000050000000000000000100000
000000000000000000200000000000002000000000000000000000001010000000000000000003010010001000000000000330303000020000000000000000333300000000000010000000300000000000100200
000000000000000011111000000300000101000000000000300000200010000000000004000000011151000001100220003333333001111100010130000000333303300000430000003100000300000000000001
000000000000000000000000003300000053330333000003403333000000000023033300000000000000000000000333000033333000300000000000000000300330303033330000633030333333333300300000
000000000000000000000000033300010000000000000000000030300000000000103000000000000305000000000000000000000000000000000000000010000000000000200000320000000000000010000000
000000000000000002000000333300000000000000450000000030130000000000000000020010013333000000000003000002000000000100000000000000100000000000000003033030000000030000000000
000010000000000011100003333300000000001000000510060133300003000000000000111000013030000000000000000011100000011000000000030110000000000000000033333001330000001010000000
000000000000000000000033333300000000000010000000003330330000000000000000000000330303000000000000000000001000000000300010000000010000000000000333033000000361030000000000
000000000000000000000333333350500000000000100000033333330000001300000000000003330333110000000000000000000000000000005050300000000000000000003333331000000000000000000000
000000000220000000023333333300300000000000002200033333030022000010000301000203133300000000000000030000003000000001000000000000000000000000333333333002000000000000000000
333333333333000333333333333300000000000000336330033303333033310010000303133333130336000000000000330303331333333033331000333303010000000000333333333336330000003000000000
