000000000000000000000000000000006000000000100000000001000000000000000000000000000000000000000000000000000000000000000000000000000600000000030010000000000000000000010000
000000000000000000000000000030003003000000000030000000000000000004000000000000000000000000000000000000000000000000000000000001000000000000000000000000000000000010110000
111110111340000000000000000030000104000000110400311111010304000100000130000000000001000000004000001011101000000000000014301000113400000004000000001440000010115010000010
000000000000000000000000000000000020000000010000010010000000000003000030000020000000300000200000000000000000000010300000000000001000000600000030000000000000000010000000
000000000000000000000000000033006000000000000100101000000000000000000034000004000000303000000400000000000600000000000000000000600003030000100000000000000000010030000000
000000000550000000000000000033000030300000001500000000000055030003000013000020000000030000200000000000100000000000300110000000005000000300000030001300000000300500000000
000000000000000000010000000031333330333003000000300000000000000333333333300330000010300303333333030000000000010033333333300033010000000300003303303333303140000000303300
000000000100000000000000000000100000000000100000000000030003003000000000000000010000000011000000000300000001000000100000000000000006000100000000000000000020000000300101
000000001110000000000000000001111000000000000001000000000000000000000000001000114000000000000000000000000010100001110001000000000000000000000000000000000010000030000000
300000000000000000001440000030000000000001000000000600004400000011110100006100002060000005100000000134000000000000000031011101000000030010001004000300000030000000000000
300000200000000030000000000000000000030000000000000300000001000000000000000000000000003030500300000000000000000000000003000000000000630000020000000300000210000000100000
330000000000000000000000000000000010300000010000000000000000100000010010030000000000000000010000000000000000000000000003000000000000033000000000000330500000000100000000
330000200000000030000000000000000000000001000405000000000000000000000006000000000000003000000003000050000000000000000000000000000000033000010005000300000000000000000010
333333333333333333333333333333333333330333000000000000103333333000010000000003333030333303300000100000100333003333333330000000000001003033330000000333303300000110100020
