000000000000000000000000000000000000000000000000300000000000000006000000060000000000000000000100000000000000000630000000000000000010010000000000000000300000000000300000
000000000000000000000000000000300000003000000001000000000000300000050000000000000000000000000100000000030000004001000030430000000000000000000000000000000000000000000000
000000000000000000000000000000003000000000000000000000000000000020000000003000000100000000030000000000000000000000000000300000000000000000000000000000000000000000000000
000000000000000000000000000000000003000100000000000000000005000600000000000300000000000000010000000000000000600000000300060000005000000000000000000000000000000100000012
000000000000000000000000000000000000000000000000000500000000000663000006600000000000000000000000000000000030000000000000000000000000000000000000000000003000000000000000
044000000000000000000000000000000000300000220200004400000000000060000000000003440000300200000000000000000000000200000000000001040005000010001000000000000020022000060000
000000000000000000000000000000000031313300031030300000003333330333333300000000000000000003033303300000000003333303000202003300000000030000000000000000033136303330000000
000000000000000000000000000000001000000000000010000000060000000000000000010050000101000000000001000000060000000000000000000300000000000000000000000500000005000000001100
000000000000000000000000000000000001000000000000000000010000000000000000001003030000000000000000000000000005000230000000003000600020000000000100000000000000000000000000
000000000000000000000020000000000000240000000100000000000000003000000000000000000300000000000030000203060000000002005000100053050000000000000000000010000000003000200000
000000000000000000000660000000000006600000000000000110000000000000000000000000000000000000000000300600000010000056000000300000000000000000000000000000000000000006000000
000000000000000000000660000000000306600000000000000000010000300000000003010010030000000000000000006301000000300066000000000050000000000006001000000000003000000000000000
000000000000022202200660000000000006600000010001100000020202000000000000000000000002000000050000006600300000220066100000000000000000022022000000310000000004400006600000
333333000033333333333333333300000003003333000030100033330333030000001020000000303333000000030000033033303333300333333330000000303330033330310001000333360000300003033130
