000000000000000000030000000000000000000000000000000000060030000000004000000000000000000300001000000100000000000001000000000000100003000000000000000000000000000300000004
000000000000000000000000000000000000000000000000300060000000000000000000000000000000000000000300000300000000006000010100000030000000000000000000000000000000000100100000
000000000000000000000000000010000000000000000003001000000000000000000000000000000000000000000000000002450010000000000001313030000000000000000000000000030000100000010000
000000000000000000000000000000000000003300105000000000000000000000000303000000000003000130000000003000000000030000000000000000000000000500000000000000010000000000060001
000000000000000000000000000000000003030300030000001000000000000001000000100000000030033330300000000000000000000000030000000600000000000000000100000000000000100000000000
000000000003300000000011111100000000333001010033001011000030000000000303111100000330033330000111100000000000000000001000000000030000001110100000030000000030003000000000
000000000000000000000000000030333333303000000000000000000000000033000000000000000000633300000000000333330330100000000003330333000000000000000030005000000000000030333330
000000000000000000000000000000110000000303063003001000000000030000000000000000000000000000000000000000000000000013000000000003003000000000100000100000000000005300000000
000000000000000000000000000001000000100000000000006000100100000000000000000001000010000000010000000000000000000000000001000000000000000000000033000360000000000000000000
000000000000000002400111000030000000000000000000000004000100000111000000000000302000000000001100000000000000000000000100000000000000000024030000000000000000000000002000
000330000003333300000000000000033130000000002000033000000010000000000000003030300000000000000000000000300001000000630000000333000000133000100000000000010300000000300000
333333000000000000000000000000000000005030000000010350000000000000000030330300000000000000000000000000500000000033033300000000000000000000003313530000000000000000000000
033333000000000000200000000000000000000000001000401002000000000003000003003300003200000000000500030000030000000003333030000000000103000002000333330000000001001110000200
333330033330000333333333333333330000000000000000000033030000003013330303300000333133000000031303330000000000000130333003033000500000003330033033300033300005000000030333
