000000000000000000000000000030000000000000000000000000000000000000000000000000000000010000010000000000000000000000000000001000000000046100300000000000110000000000000000
000000000000000000000000000000000000010000000000000000001000000000000000000000000100000010010000000000000000000010001000000000003000000010000000600100000000000000000002
550000000000000000000000000000000010300000000000000001000000000000000030001610000000030000000000000000033553000003000005500000100006030000010030000000000055000001000016
000000000000000000000000000000000000306000000300000000000000000000030330000000300100030003000000000000303000000003000000300000001006630000000000000000000000000000000366
020000000000002200000000000000000300300001200000000000000000000000300300000000000000030001000003000003033023000003000300223000030006630000000601001220000000000000000066
100000000000000000000000000000000000301000000000000000403000000333533030300000300000130000000000003333333000000003000001000000000006130000000000000000000010000000000001
000000000000000000000000000000100100330303000000030000000000000303330330003333331333330030000000010333333400000033303030000003330330330003030000000000020000000003333313
000000000000000000000000000000000000000000000000000000000000000000020000000000000000011000000100000000000010000000000510000000010000000000000000010000000000000500000000
000010000000000000000000000200000000100002000000000000000000000001000000000300000000000000000102020000000000000000000303000000000000000006000000000000030000040000001000
030000000000333000001100006600000051000060001003355000001000060000000000100000500000000000000020660000000300000300300000000000000003300000303000030500013303001400000000
030000000003333000000000006600130000300066000330300000000000006000000000000000003300001050000000660000030300000000000000000006000000000000000100303000000300000000000000
030000000030333000000000006630000000000060000303302000030000006020000000000000200000000000000103060200030300000022000600000000000503300000000000000000303303100000000000
030000033333333000000000006605000030000066030333010110000000006000000000000001003000000000001000660000000300000000000000000000013333000100003000000333330301000000000000
333033333333333003333333333330003303333033333333000000003333303000300000300000000000000000013333300000000300013300000000300000030333500000000000003333300333300030010000
