000000000000000000000000000000000000300000006004000000000600000000001000000000000000000000000000000000000000000030000060040000010000000000000030000030000030000000000000
000030000000000000000000000000000003000000000555300000303000000000330000000000000400000430000030000300000300030000003000003001000550300301000006300330403000000000100100
000000000000000000000000000000000000000000000000000000000000000020000000000050000000010000000030001600000000001000000000000000000031000000000500300500000000000000000000
000000000000000000000000000003000000000000000000000000000000000000000000000000000000000000000000000003000000000000000000000000000000000000000030000300000003033000000530
000000000000000002000000000000000000000000000000000020000000003000000000000000000100000000000050000000000000000003001000000000000001050000000010000000000005000000000003
555500000000000000000000000000000000000000000000000000000000000000000160000010555000000000003000001000000555500055501000000000000000000000005000000001000000000005535004
000000003330000000000000000003030100130333000000300000000303003000300001000000000000000000000130000000000300100000000000000000000010033030000000100033333331000030100000
000000000000000300000000000000000040000000000000000000000000000000000000000000000000030000000000000500000600000000005000300000000000001000000000200000010000000000000000
000330000055533300000000000000000003000110030033003603000005500000300000030000000010300000320000030000553060000000000003000000000000000000001020001000000000000000005553
000000000000000000000000000000100500000500100000001035002200000000000000000003000000000300003003000000000000000000000000000000000000000030000000000000000000000000000000
000000000000000000000033333403333310003000030000000000000000000133333400000000000000000000000003000000000033331400000010000000003331410000000000000000000000000000000000
000000000000000000000000000000000000000000000000000000000001000000050030000010002000001600000000000000300000003000000000000031001000000020000000000000300000020000000000
000000000000000000000000000000300001000000505500000000000000000000000000000000000000004003000000000000000000100000030000000000060300001003100000000000000000000000000000
000000000000000333333300000330000030000000000000000000000003000000000103000000000000033300304330000000000300000300000000030003300030300000000000000003300100000100010000
