000000000000000000000000000000000003000000000000000000000000000005000000000000010000000000000000000000100000000500001000030000000000000000006000000102000010000000000000
000000000000000000000000000000000000000000050000002000300016000000000000000601000000000000003000000000030000000000000000000000002000000030020020600050000000000000000300
000000000000000000000000000000030000000000000000066000000000000110103410030000000000000000000000000000000100030000000030000000110110400000001011114000000000000000000000
000000000000000000000000000000010000000005300000066000000000000000003000000000303000010001000000100000000000000000000043000000001000000100010030000000000000000000000000
000000000000000000000000000000030300000000000300060003010000000000000000000000000000000000000000000000000100000000000000000000000000000000000300001000000000001000030000
114444410000000000000000000010444440000030000001066000000030000200000000000101140404010000010000001143000000000000000000000002200000010000000000000001000200000000000000
000000000000000000000000000000000000000010030033305333031000003333303330033330000000000040000000000010000300303300000000333330303033002001000333333333333300000003000100
000000000000000000000000000000000000000060000000500010000005000000000000000000000000000000000000000000000000003000000000000000000000000000000000000000000000401000000000
002000000000000200000550000000200000000000000000000000000000000020030035000003000000320100000000000500003002000000003000000000000000000000000000000000000000000300200000
111111410000006600000000000001151140000000100000015000000310000600000000000000000000160000000000000000000111301400000000000001000000066000000000000000000000000006600000
000000000000006600000000000000000000103000000000100000000030000660000000010000000030660000500000000001036005000000000000000000012036060030600000000000000000000001600050
000000000000006600000000000000000000000000000000000000000000000660000000000000000000560000000000000000003000000000010000000000000000066003000000000000000001000006600000
200000000000006600000000000220000000000003000003010000000006000660000500000001000000600000000001000000000202000000000001144404000000060000001003000114404400000006010000
333333330033333333333333333330333330000000300033300000500000000303300333033330000000033333300001006033333033333330033030000600000000000033330000000000001130003033330333
