000000000000000000000000000010010003000000000000000000300050000000000000010103000000000000000313000000000000000020000000000000000000300000000000000000000000000000000000
000000000000000000000000000000006000003010000000000000030000100000000033000000000000040003000000000100000010100000000310000000000000000000000000003000100000000000000000
000000000000000000000000000000001000000000000000000000600001000000000000000010003305000000000001000000630000000000010000000000000000000000000100000000330000000000301000
000000000000000000000000000000000000000002000000000000000010001000000000000000003000000000000003030000002000000033000000000000100100000000020030000002300000100000300000
000000000000000000000000000000000000000066000000035500000000000000000000000000033300002000503333003030066000000033000030000000000000100000060000000033333000000003303300
000000000000000010000011110000000000000006003000000000000000000011130000000000030030001000003333000000060000000033000000000000103000000000600000000000333001110000100000
000000000000000000000000000000000001333333000000000020000000000001000000000003333333000000016330000330030100000000003030000000000003033036330000000330313300000000000303
000000000000000000000000000000000000000000030000000000000000030000000000400000000000000000001000000000001000000000000030000000000000000000000000000000000000000000100010
000000000000000000000000000000000000000005000000006000000000000000000000000000000000000000000000000000000000000000000000020003000000000030001000000010100000000000000000
000330000000003301000000000006030000000000000000030010000100001010303003010000000000000000010000003301030000300000000000000000000100000003000130210000000000000000000000
000300000003333300000000000200030000000000010010333000000110002000000003000010000333300000030000003300100003300000000100000330000000000030001000000040033000000020000000
003333003333003300000000006600303300000000033331063000000300066000000003000000303300000000000000003000000003033000000000033300000300000330300000000003330100000660000000
003333000333003300000000006600330360111003003100303000000000006000003033000300030300300000001101000000000013333030111000031360001000003333000000000003000010001660013000
333333333333000000333333333303003335001400333335003003033033030000000010300303313300000001000000030003333030330300003033133300000100033333300300000333300033033300000000
