003300000000000000000000000000000000000000000000000001000033000000010000000335000000000002000000000133000000020000000000000300003000030000000000600000000000000005000000
000000000000000000000000000000005000200001000000000020010000006000300300000000000000000213000000000000000000060000025000000030000000100000000000000000000000000000000000
000000000000000000000000000000000000000000000200000660003000310000000000660000000000016000000000000000000000660000660000300000000101000020300066000000000000020000000003
000000000000000000000000000040000000000000006600000060000000000000000000660000000000036600000030300003000000600000600000000000000000000661000060000000000000660000010020
000000000000000000000000000000000001000050003600100660000000000000000000661000000000006600000660000000000000010300660000000000000000000660000066000060000000603000000000
000000000000111000000000000000000110000030000000030660100001001000001400640000000000006600000660000000000000660000060000030010000000000663000000000003000000620000000000
000000000000000000000000000010000003300000336333333333030000006000000033013300000000033333333330330000003333333003333330000000000000033333303333031330201033000300000000
000020000000000000000000000000330100360300001000000003000000000000000000003000000000000000003000000000000000000000000030000000400000005002000033001000000000000000000000
000660000000000000000000200000000000600600000000060000000000000000000000006010000000000000000000000000000000000060000000030000000005003066000000030000000000000000010030
000660000000000002000006600000000000006600001003400000000000000300000000166000002000000000000000000101000000000000600002000010300000000066000000040000000000066060001000
000660000000000066000006600000030001006100000000000000000000000006000000016010066000006000000200000000000000000000000000000000000000030060000300000000000000066000000000
000660000000000066000006600000000000006600000010000000000000000000000000066010066000000000000000000000000003000000006030030000000600003066060050000504000000066000000000
000660000000000066000006600000000000006600300000000000010000000010000000066000060000000100000000110000000000000010000000200000000000000060000300000100000000060030000010
333333333000003333333333333300000003333300000000000000010000000303010013333313310333000000000000000000000000600000000000000010300000033363300000000000000033333330003000
