000000000000000000000000300000000000000000000000100000000003000100010000000003000006000005000000100000000100000030000000000000000000000000031000000000000300300100000006
000000000000000000000000000003000000060000000000000000300050000006000000000000000000040030000000300003000000000000000000003000600000030000000000000000030000000060200000
000000000000000000000000000000000000000333000000010353000000000000000000000000000000300000000000000000010000000000000003333031000000000000030000303000000000000003030001
000000000000000000000000000010000000000000000000000000000000300000000000000000000003002000000000000000000000000000000003000000030000000000000200000000000000000300006000
000000000000000000000000000000000000000000300000001000100000030100000000000000000100300000000400010000000000000000000000000000000000003000000000000100000300100000000060
000000000000000000000000000000000000000000000000000000000000000003000000000030000001000000000300030000000001300000000030010001003000000000000000000000600000000000005010
000000000000000033300000000002000000333000333335323330130000000000000030303330000000033030300303000000000010040000000100300033003330000030000003003331333300333003300033
000000000000000000000000000000000000000000001300001010000000000001000000000000000000000001000000040600000000000000000000000000000300001000000000000003000000030000000050
000000000000000000000000000000000000000300300000000000000000000000030500000000000021000000000000030000000000000000000000000000000010000001000000000000000000000000000000
000000033333311000000000033300000003330331000000300010000000200300333100010330030000100003000000333303300000000000000000040001000010010000000100000100000000300000000000
000000000000000000000000000000650000001000000000103000000000000000000000200000300000030200000010000000000001000000000010000000000000000003000000303000001001000000100000
300000000000000000000000000000000000300000000000000000000000000020000000000003000000000000000000000000000001000400000000030000053000000060000300100000010030000000000000
000000000000000000000000000000036060000050600000000000000000000000030000000010500000000000000001000000000000000000000010000000000000030000000000000000000000000000000000
333333333000333333333030300000000003300033003330100000030030300330003300000000300303333333303005003300033000030013333030000000000000033033300000000033333002000000000100
