000000000000000000000000000000000000030000000000105100000000000000000000000000000000021000000000000060003000000000000000000000000000000000000000010000000010000000000030
000000000000000000000000000000000000000000000000000000000000100000000000000000000000000000000000000000000000000050300000000000010000000000000000000000000000000000000000
000000000000000000000000000000000000000000000000303002000000200030000000000130000000600030000000001000030000000000000005000010000000000003000030000000000000000000000000
000000000000000000000000000000000000000000000000000166030006600000000000050000000201003300000602000010000030000000000000000000600050000030000000200000000000000010000600
000000000000000000000000000000000001000000000660000304010001600000010000000000006600000330000056000000000000030000000000000000000000000000500000300000000001003000006600
000000000000000000000330000000000103300000000660000000000006601330000000000000006600000330130006000000003300000000303000000010001000000033500000600000000133000000006600
000000000000053000000660000000000006000000000333110330333000300060015000000050003033330333000033300000000160000500000000000000300000033330100003303310000066030003031033
000000000000000000000660000000000000001000000000061000310000400060000000100000000000000003000000006600003000000000000006600000000000000000330000000000100066030000005000
000000000000000000000660000000000000000000000000066100000000030660000100001000000000003000000000006600000600001000000006600000000000000000000000000030000066000000000000
000000000002000000300660000000000000600300000000066000000000100660006000000001001300000000000002010600040000031000005006600000000000000002000000300000000066000000000000
000020000066000003300330000000000000000300300000033000000060400331000000000000003300300000000066003300010000000000030053000000000020000066000103060000001013000000000000
000660000066000003300330000000000000003300000000033001300000000300000000000002003310000000000066003310000000010000000003300000000630000066000000300000000003000030000000
000660000066000003300330000000000030003300000000003005000000000130000000010000000300000000000000103300000000000000000013300300000660000066000003300000000033000000030050
000333330333333333330330033330000003331330000001530033330030000331030330000000330330000003530033333000033000000000000003300053000332300313303300030000000530000320000000
