000000000000000000000000000030030000000000300000000100000000000000000000003000000000000000000100000000000000000000000600000200000000000000000000000003000500000000000000
000000000000000000000000000000000002000001002000004000000002400000100003002000000000000000006001000002040000000000000000000006000300000000000000000000000000000500002000
000000000000000000000000000000000000110000000000000000000131100000000001000040310000000000000030004000000000000000050000000000000060000300040000000300400000000000111100
000000000000000000000000000000000030053000000000300000300000000040010000000000003000000000100300000000000000000000000000000000000000000000000000000000300000000000000000
000000000000000000000000000000000000003000100050000000000000010000000000301100003300000030000000000000030001000000300000600000000005000000000000000000330000000000000000
000000000111100100000014111100000000002300000022001411012120000000002001011111003000000000001011110010100040000000300000000111000011000002000000226000330006415112020000
000000000000000000000000000000003003333303333133310000000330330243301300000003300003000000000000000011000000000000000000000000000000030300333031303333030300000503303300
000000000000000000000000000000000000000300000000000000000000000000000000000000000000006300000000000000000000000000000030000000000000000000000000100000000000000000030000
000000000000000000000000200000000000000000000000000023002000001000003000010400000000001200000000000000000000000000000010001000000200000000000010000000000003000100001104
000300000001000000000011110000000000000100000000001101000030000000000000300000100001001110000033000000000000010000030000000000011100000061000000300000101030000201000000
000300000000000000000000000000000000000003000000000000000000000000000000000010000000000100000100003000000003000010000000002000000003300000003000000000000000000000000000
000330000000200000000000000000000000000020000001000000000000000000032000000000000000000000000531050300000300000000030000000000000000000003000000030000100000000000000000
000330000000000000220202000000000000330300011111020200000000000000000000111100100000200000001033010000220000000000030300100000203000000000000101000000000001100000001110
333333333333333333333333333010000003303333000003130330340000000333333030000000100000303303033330030333003330330303331330100001333333033033330000000000000603003330000000
