000000000000000000000000300000000000003000000000000000000000000001030000000000000000003000000000000000000000000000000000100000000000010000000000000000000000000000003000
000000000000000000000000000000060000000000000000000000304000000000000000000006000030000000000000000000000310400000006000000000001000000304000000000000000000000000000000
000000000000000000000000000000103000000000000000000000000330000000000000010010000000000100000001000040000000000000000000001000000200000000000000000000000000020000000002
000000000000000000000000000000000000000000000000000000000000000003000000660000100000000000000000000066000000050000000000066005006600000000000005000000000000060000000000
200000000000000000000000000000000006030000101000000040000000000000000000600000000000000000100000000066000030000000500000061000006600000000000001000200000000660000000000
000000000000000000000000000000000030002000000000000000000500030006000020660000000001000000000010000060020000003200000020066000000000000000000000000300000020660030000000
000000000000000000000000005500000000000055033303300000000000000600000033333330000000000000033033303030330033303333033330333330003300000000003333033000000030333030000055
000000000000000000000000000000000040000000000100300050000000000000000000000000000000000000000001000100000100000000000050003000000003000000000000000040000000000000000000
000000000000000000000000000000000001000000000000000000000003000000000000000000000200000000000000000100000000001000000000000000000000030000000000000003000000000060000000
000000000020000000000000200000020000100000000200000000000000000000000000000000000000000000000020000000000000000000000000000000000300001000000000000000000000000000002000
000000000660000000000006600000060000000000006610001000000000000000000000000000066000500000000600000000000000000000500000000000000050060000010000001000000000000000066600
000000000660000000000006600000660000000000006600020000000000000000000000000000060010200000000000030000000000000000100000000000000000023000002000000000000000000000600000
000000020660000000002006602000660000000000006602000010000000000040000200000100066020000000020600000001000000000030000000000000000000010000000000000030000000000000066010
333333333333333333333003333303333335333103000030300000003303333030033000000550030333000000033333000000000005015503300330000005000000000000000502010000000033300330030333
