000000000000000000000000000000000000005001030000400000000000300000000000005530000000000000001000000000000600000000000000000000000030000000000000000000000000001000060000
000000000000000000000000000000000000000013000000000000000000000001100100000300000000000000000030301011001000030000001010000030000001010000001000001000030000000000000000
000000000000000000000000000000000000000500000000000010140000300000000011111100050000000000000001000000000000010400000600000000300000003000000000000000000000000000000000
000000000000000000000000000000000000000000000030000000600000000000000000000600000000000003000000000000000000000000000000000000000100000000030000000000000000000000000030
000000000000000000000000000000000000000000000000000011000003000000000000000000000000000000000000000000000000000010000060000000000000000010000000000000000000000000000000
000001111100000000000000000000000111110000000000000000000000100000000000000000000000000000000000010100000000400000000005410000030000100020000500000000010001022004000000
000000000000000000000000000000000000010000100000033303003033333333333333000300000006004000000005000363333333033300000000000000100000033303330000000000000033130330000000
000000000005500000000000000000000603000000000000000005500000300300000001000000000000000000000050000000550000000000100000000600000455000000000000000000055000100100000000
000000000000000011001100000000000000011001000000500000000000001000000000000000030000000100010000000001000000000000000000000040000001000110000015001000000006000000060000
000001411111100000000000000030000000000100000000211110000000000100000000000000001000000000000000150000110000000000000143000000110111300000000043000100111000100001000214
000000000000000000000000000000000000001000000000000000006000000000000000000000003000300000000000000000000400001000000000000000000000000000000000000000000000010000000001
000000000000000000000000000000100000000000000010000000000000000000000000000000000000000000030000000100030000000000000000030000400001000000001000010010000000000000100000
000000000000000000000020220002002000030000000000000000001110000000000001022000000031000001103160000030060101000060000010000000000000000000000500000000000600000110000000
333333333333333333333333333333333333313303000000030300330000020000002033330030000000000003233003033331333000000033003300003000300303003300133303333303330300001003333333
