000000000000000000000000000000000030000000000600000000000000000000000100000000300000000000000000000000000000000000300000000000000301000000020000100000060000300000000001
000000000000000000000000003000200000000300000003000000000000000000100000000010000000000000000153000000000000000000300000000000000001000000000000000005003000003000100000
010110000000005000000000011000030000001000000011000000000101100000000050000000000300050000030001000000000014010001011010000000000000000100000000000030011001000000301100
000000000000000000000000000003303300000300000100000000001000000203000010100000000000000000020000000000000000000000000000000000000000000000000000010300000100000000000000
000000000000000000000000000003313000000000001000000000000000000300000050000000006000600000000100300000000000000000000000000000000001100000000000000000000003006000000000
000000000000000000000000000033030000303300000000000000001000030200000100000000000000000033020030000000000000000000000001000001200000000000000000330000000320034000000000
000000000000000000000000000033330033303033000000000000000000000300301000040000100000033333033033000010000000000000000000000303053333100000003333331000000033333300000000
000000000000000000000000000000000000000000005000010000000000003000000200000000000000000000000000000000000000000001000003000000000000000000000000000300000000000000000000
000000000000000000000000000000000000000000000500003000000000000000000000000300100100003000003000000000000000000000000000000030000000000000000060000000000001000000000030
000000000000000003330000000050000003000000000000001011030040000000000000000103001030000031000010001000000000330000000000000100000333000000000000000500000000033300000000
200000000000000333300000000000000000000001000000000000000000001000000000001000333300060000000000000000000030000000000001000000033300050000000000000300000003333000302000
000000000000000333300000000000000000000000000000000000000000000000000000003000333000000000000000300000000033333000000000000000033330000000000000000000030003330000000304
200000000000033333300000030000600002300000000000300000000000300200000300010003000300000000000040030100000100630000003000000000313300000000000100003000000033302000000000
333333000033333333333333333300000000033330000000330000003333330000010300000000333333000004300033030000000033333300033300300000433333300000000001333000660030300300000000
