000000000000000000000000000000000000000000000000001000000100000000000000000000000002000030000000000000030000000000010000030000000050000030000000000000000000000060000001
000000000000000000000000000000000000000000003000030000000000000000010000000000030000000000000000000300000000000000000000000000003000000000020000000040000000000000000000
000000000000000000000000000000000000000000000000000200000030000000400600000040000000000003000003000000000000130000000010000000000000000050000100000006000300000001000000
000000000000000000000000000000000000600000001000300010013000000000000500000100003100000001100000000000000000000000000000100000000000100000660000000000000000000000000000
000000000000000000200000000000000000000000000000300000000005000033000000000000400200000000010302030000100001001030000000000330000000000000660300000000000000002010000000
000000000000000001110000000000100000000000000000200030100000002600230000003000001110000000000300100000000000000000000000000000000111400200660302000000000300010000000300
000000000000000000000000000003000000000000003333333303300033303303130300000000000000003000000000000000000030333000010003000330200000533333333030333000000000010000000000
000000000000000000000000000000000000000000004106000000000000000000000000000000000031000000000010000501600000000000000000000300000000000003010000000000000000000100000000
000000000000020000000000000030000000000000000000000000510100002000000010001000000000000000000000030000002000600001000000000000000030000030001000000001000200000000000001
000400000000660000000000000000000000000066000000000040300000066000100000000000100000000400000330000000066000000000040000003000000300000000000000003000006600000000000020
000000000000660000000000000000000100003060000000100000000000006600030000000000040000005000010000000060366000020000000001000000000000000030010003000000000600000100000100
030000000000660000000000000000002000005060000000003000300000006000000003000000000000000000000000000000006000000003000000030000000000004000000030600000003000000000006000
030200000200660000000000000200011300020006000000000020000020066060000000100000000000030200000000020020066000000603120000000006000000000000020000002000000600000000000000
333333333333333333330003333300000000333333000000033303300303333000003400000001336035635303300133030333033000001030333330000000140000000333330033303333303033333600000000
