000000000000000000000000000000000000000000000000000200000000550000000000000000000010000000000005500000000000000000000000000550000010000006030000000000000000000001000000
000000000000000000000000000000011100000000100000000000300000010010000010003000001111100000000100000000000000001010000100000000000000000011110000000000113000000001100004
000000000000000000000000000000000000030000000000000000000013310000000001000100000000000005000336000000000000000000000000033310000000000000000000000000000000000000000001
000000000000000000000000000033000000000000300000000000001000000100000000000003300000000000030100000300000330000000000000000000060000003000003000000330030000000000000000
000000000000000050000000000010000000000000100030000000000000000000000040000000000000036000000050000000000000000000003000000000000000000030100000000010000000000000001000
000000330000000000000000000000000000140003200000000001030000000300000020003000000000203000000000001010000000000020000010101000000500000300000000000300000030000132000000
000000000000000000000000000030233330000000300331300000103030030000000133036333033530333303330303310000000103363033533333333330010000030133300306000300030300000003033303
000000000005500000000000000000005000000000000010000005500003000001000000100000000010000000000001000000000000000000060000000000001000060000000000550000000000000006000000
000000000000000001111100000000030000100110000000000000000000000010000000000000000000000000000000600000110000000000000000001000000600000000010000000000005000000500000000
000030000333100000000000000000000000000000000530000303000000000000000000000000000300010030000000000100000030010000000000033000000000001003000030010000000000000000305300
333330000000003300000000000000000000001000330333000000000000000000000000000503300000000000000000050000000330360000000000000000000000313333000000100000000000000003003000
333030000000000000000000000000000000000000331000000000000050000000000000000003000300005100000000000000010333030000500000000000030000003303030000100005000000000003100000
000030000000000000000200000000000003000006000030000000000000000000010000000030000000000000030000000030000000030000000000000003300000000003001000000000000030001020100000
100033333333333033333333333300000001000001120030333333030000000003500000000001003333300300030000000000000100033000000000000000000000000000333303030000000000000001010331
