000000000000000000000000000000000000000000000000000000000000000001000000000000030000000000000000000000000000000000000401000001000000000000000003000000000000001030000006
000000000000000000000000000000000000000000100000010000400000003000000050000300000000000000000000000000000000600300000000000000000000000000430000000000000000000000000000
000000000000000000000000000000000300001000000000003001410310101000000000000001010000101100000000001110000000500000003003030000000000030001400000000333310010100003300141
000000000000000000000000000000000000000000000030333000103300000000000000300000000000000000010000000000000000000000003030000000000000033100000000000000000000000003005003
200000000000000000000000000030000000000000100030033000000300000200000300000010000000220100000000000000000000000000030330000000000000033000000004000600000000000003300000
000000000000000000000411110000000000300100003033363000003000000105300001111000010000000000041211000000000030000003333130000050004000033000001101000000003020000003300000
000000000000000000000000000000000100000010033303030033330003303000000000000000033335100060000000003333033010000033330030335303000000033003330000000330313033033331300303
000000000000000000000000000000010300001000003000000001100000000010000000300000000010500000000000000100000000000001400050012000000000000010000003000000000000000000000000
000000000000000000040000000000003000000001000010000000000000000000000000000000000000010000000000000000000050004000000000000000000000000000000000000300000000000110000000
333300000000003300141111000000000001011003333300000000000000000000000033030000000000000000000000003013110330014101000003000000111300100040000001000000000000010100000000
000000000003033300000000000010000000000000000500000000000000000000000030000000000301000000000003030000000330000000000000000000000000000010010000000000000000003000005000
000000000033333300000000000000100001000000000000000300000000000000003000000000003033000061000033030301000330000000000000000000000000000000302000000001000000030330000000
000000000333333300000000000001111000000000000000000000000000000000040000000000033333000000000033330000000333000000000003110000000000000000000000000010000000333030000000
333333333330333303333333333300000003300013333333300000300000000000000000333300030003000000030030330036333000333310000000000030333303300000300000000011000033010331000300
