300000000000000000000000003100100300000030000000000000006000000000030000000000500010001000000020000000000300000000000003000000000000100000003000000000300000000300000600
300000030003303300300000001000030100000006001000000000003000000000000030003010000330331300000600001005000300000001000000000000300001000100003000000005000100103000000000
000000000000000000000000000000000000000000000020303000000003000000000000000000300000000000000002000010000000000000000000300100000000301000000000300000000000000000600000
000000000000000000000000000000000000010000000630000000000000003000660030000300000000000000000006000200000000000041000000000001000000000100200000300000000000066000200000
000000000000000000000000000000000000000000000361000000000002000000000000000000300060000030000060000000000000000000005000000000000000000000000000000000000000066000000000
000000000000000000000000000000000000000100000600000000010000000000660000300000000000000000000066000020000000000000000000000000000001000001000060000000000060006000300000
000000000000000000000000000000000003335333050330033333300000000300034300000000000000210000030033333333330000030033333330000000000000030333030000003033033130031333333303
000000000000000000000000000000000000000000310000000000000000000000000000000310000000050000000030310000030000000000000000010000300000000010030300000003003100600000030000
000000000000000000000000000000010030000330300000033203000000000000050000000100000030010000000030303000330000000033003000000000010000030000300000000000001130003003300300
000000000002000000000000000000000000005000000000000000000000000000000000000000000000000000000000000000000000000000000003000200000300000000000001001000050000000000000000
000000000066000000000020000002003000000000004030000000000030000000400000050030000003001010000000000000000000000000000000003600000003005000100000000000000000000001020000
000000000066000000000000000000000010000000000000000010000000000000000000000000000000000100000000000000000000000000000000006600000011001000000000000000001000000000003000
000000000066000000000000000000000000006000000000000000000003000000000000000000000200000000000000000000000000000003000000006300000000000003000000000000004000000000000000
333333330033333333333333333303330330010000000300000000003333333333333300004000303333303333310000000000000303333000000000033333333333300000000330033000000000000000000000
