000000000000000000000000000000010000000000000000000000001000000000000060000000000000000003000300000030000000000000000000010000100000010000000000020100000000000300000050
000000000000000000000000000000050000000000000000000000000000000000000000000000000300600050000000000000100000030000000003300000000000000000000000000000000000000000000003
000000000000000000000000000000020000004000000000000000000000000000400000020000001003000000000100000000000000000000100000004100000000000000000000020000400000000000300000
000000000000000000000000000000400000000001102003000000000000000000000500660000000000000030000060000000000000030000000030000040006000000000000000100000000100000000021000
500500000000000000000000000010660003000000000000300000000100000000000000660030000000000000000030300000000001000000000000003003500000000000035005040000000000000000010000
000000000000000000000000000000060000200201000000300010000000000000000100660031000000000000003000200000000000000010000220200200000000000000000000000020020000000001000003
000000000000000000000000005540330033333330033333300000000000000333300013303330000355000000023333010000000001005533330333330333000100000000005000000333300300000103333333
000000000000000000000000000000000000000000000303030001000000000000000300060000000300000000000000100000000600000000000000000000000000010000001000000000000030010000000000
000000000000000000000000000000000000000010000000000000003000100100000000000000000001000000000000000000000000000000000000000000100000000000004000000000000600000000060000
000400000020000010000000000000000000000000000030003100000300100000000000000000010000000400000000030002000000030000000500002000000000000000000000000000200000300000000000
000000000660000000000002000000000000000000000000300006000000000000000000200000000030010030000000000000000002000030200000060030000400000000000000000016600000000000006000
000000000660000000000000000300010005000001001000000000000000000500500000000030060000000000050050000066000013000300000000066030000000000000000000400006600000110000000000
020020000660000000022000000300000000000000050000000000020000003000000000001030030022020000001010000066000000000300000030060000000000001000100000320006000000000220000000
333333333333333333333333333303201000000010000000633033130003030000000033333303333333031303300000003333333333330133303003333333000000000000550000000003330331133330000055
