000000000000000000000000000003300000000000000000000000000333000010030000033000004000040000000000000001100000000000000000000010033300000000000000000100010000500000000100
000000000000000000000000000013300000030000000000001000003033000000000000000000000000000000000000000000030030000000000000000000030303000000000000000020000000000000000013
000000000000000000000000000033310003000100000000003000000333000010000000000000000010000000000000030000000000020000020000000000003300000003030000003000000001002003000000
000000000000000000000000000030310030001300000000000000003333000040000000000000000000001000030130010000000000020000660000000000330300000000030000003040000006000000030000
000000000000000000000000000035330010000000000000000000003333000000100000000036400006000001000000330000060000030000600000000000031300000003300000333000000400000000000300
000000000000000000000003000030330010000000200200000000003333000000000000310000000000000000020033330060000000302000662000001300333300020030332003331000000320000000000000
000000000000000000000023000033000003230000303330000000001030000000000002300000000000000000030033330000000330303333003133230000033500336333331333333000000033300350006000
000000000000000000000033300000000101600000000000000000000001100000030000030000300000003300006300000000001000000000000000000030000010000000000000100033300000000000030000
000000000000000000000333300000000000000000000000000000000000000100000010000000000300633300300000001000000000000000000000000000000000000000000000000003300000000000000000
000020000020000000003333300000000000000003000000000110000002000000000000000000100260330300000020000000000000000110000001100000000000000000000012000133006000000000000000
000000000660000000003333300000000000000000000000000660000066000002000000100003000010003300000660030000000000000000000000000000000001000000100000060330300060000000000000
000000000660000000333333300030000000000333000300000660000060000001000000003330000000333000000061000000000000000000000000000000010010000000330066000003300000000150000000
200200000662002003333333300003100002003010500000000062100000000000000020330336002000333300000062010030000000010000000001030000200200000000000066200033300000000000000000
333333333333333333333333000000000001330300000000033033030333303000000030030330333330331000013330330200000300000000300000000030303333300000503331333333030031000000230000
