003000000000000000000000000300000000010000000005000200000000030300000000000000030000100000000000000000000503000000300030100000000500000000000610000000000300000000000000
300000000000000000000000000001000000000040000000030000000010000000000030000000100000003010000000000000001300000000100010000000000000000000003000100000000000510000000001
000000000000000000000000000000000003033331033333030100103133333033030010000000000000313333001000100000000001000000000000000000033313000000000000000030000300000000030000
050000000000000000000000000000000001000000000000005000000100000000060005400000000000000000000000100300000050001005000000000000000000000001000500000000000000000000000000
000000000000000000000000000000000000100000300011001000000000000000000000000030330000000000000000000000000000000000000000000030001000000000000000000000000000000000000000
000000000444500000050000000000000000005000000600000000000300000000000000000000040000160000000000000004450000000000000000000050000030000404500000005000000010444500000010
000000000000000033300000000010000003000000300000000000013000000000000000000000003310303000000000006000001000300000000100003300000000000000000000000000000000000030003000
000000000000000000000000000000000010002001001000000000300000000000001000000000000000000000300000000000000000003000300000000000000000300000000030000000000030000050000000
000000000000000000000000000000000000000000000000500000000000030000000006000000000000001000000000000001000000000000000000000000000000000000000000000010000100000000000000
000000033333311100000033333000000000000000010000000000000000000000000011000030300000000000000000000133010000000033303011101000000033300000003333031000000003103001100000
000000000000000000000000000000000000000000000000000001000000300000000000000000000000000100000000000010000000100000000000000003000000000000000000000000000000000000000000
300000000000000000000000000030000000000000030300000000100000000000000003000000000000300000000000000000000000000000000000000000006000030000000000000500100000000000005000
350000000000000000000000000005000000044050003000000000503530000004401000000000000050000000035000000000000000005001003000000000000000015000000000000350000000010000000000
333333330300000000000000000033013330001000000000000303003333033003000000000000001003000000000030001010000000330030030000040000000600033363333000011330331000000000000030
