000000000000000000000000000000001000000000010000000000000000000000000000400000000030000000000000000000000000000003030000000005000000000010000000030005000000000050100000
000000000000000000000000000000000001000200000000000102130000000000000000000000000000000000300002000000000000000004002000000000000000000000000000030000000000000000300200
000000000000000000000000000000010000000600030001000000000100000000000003300000000000005030000000003330010001000000000300000300000000000000000000000000000030300000300000
000000000000000000000000000000000000030000000010000030000000000100000000000000000000000330000000300330010000000000000000003300000000204000000000003000000003300003006000
000000000000000000000000000000003000000000300050000330000000000000004003300000600006003300000000000330000000000000000000000301000000000000000000166000000003000000006000
000000000000000000000000000010000000000102000000001330000050000000000013300002000000000330000005220300200000000000000020033300016101600001000000006000003000300003000021
000000000000000000000000000010000000303333000003033000000000000000000030333030000000331000033033333333333000000033333331030000330333300000000330333000000031303333333333
000000000000000000000000000000200000000000000003000004000000000006000000001031000000000000000000000000030000000000010000000000000000000000005000003000000000000001000010
000000000002000000000000000001000000000000000000000000000000000000000000001000000200000500000300000000000000000000000000000000000003000000000500000000000000000010000010
000000000000000030000000030000100000000000003000001000000000000000000000003000000000000000000000000000003003000000000000030000006000000000000000000000000010003001000000
000000200000000330000000330000000000300000000000260000020000002000000000001000000000000003000100000000000000000200006000330000000000000000000000000000000003003000000000
000006600000000330000003330000000003000000003000000000660001306000100100333000300000000045010000000000000000006600030000000000000000000000001000106000030000303060000003
000006600000222330000003330000000000000000233000300000630000060000000000333001000062000000000000000000300000006600000000033030000003000000000000000000100000330000000000
333333333333333333333333000000000600300000333033630333303303033000000033100013333300000030000000000000000033333100000000330033300000003000000000001000000033300000100000
