000000000000000000000000000000000330000200000000000000000000000000000301000000000100000000030000000003004000000030000000000004000002300000300000000000000030000000300000
000000000000000000000000000000000330000000000000000000000000000000003000000000000000000000000000000005500000040000000000000003600030300000000100500000000000000003000000
000000000000000000000000000000000001000300003300000000000000600000000300000010003000000000000000001000400100000000000000001000000000000000001001100000000000000000302000
000000000000000000000000000000030300000000030000000000100100000000300300000000000000000000010600304000000000000000600000000000000300030000000000000000000100101000060000
000000000000000000000000000000303300000000000000000000000000000033301300000000000000000000000610000003000000000000003000000000033303300000000000000000000000000000060000
000000000000000000000000000000300000000000000000000000000000000323000000000000000000000000000660000000300000000000000000000003333000000040000010300000001000006000066000
000000000000000000000000000333300000000003100000000000000000000333000033333403000000000000033033333330010333300333330330000000333000000000003333333033333303000003333331
000000000000000000000000002300000030000000000000000000000000000000000000000000000000003002000000000000023000300000000000000000100000100000000000000000030110550000000023
000550000000000000000000003300000000005500005010000000000000000000000000055000000000000000000000003000033000000000000000000000000150000000001100300000000000000000000033
100140000000000002000000000300000001000000300000000020000002300000500000014000000000000000205000000000303000000000000000000000100000030060000000000000000000000003000003
000000000000000066000000300000000100300000000000000060100066000000010030001000003000000000000000000003000000100000000000000000010000000660000102000000000000030000003000
000000000000000066000033333300000000000000000000000660000066000000000000000000000000060000000000000333333000000000000000000000000000306660000000000000000000000000303133
000000000000000066000333000000000000530000000000000100000006000002003000000100000000000000003000000300000003000000300000000000000002000060000000000001100000000003130000
333333333333333333333333000033333030331333000000033333333033330000000035330300000000003000300000000330000000010000000000000005330303333333530000003000000000000003030000
