000000000000000000000000000000003000000000000000000030000000000000000000060000000300000000000000000003000000300000003000000000000000000000000000000030000000000000000000
000000000000000000000000000000003300000000000000000000000000000000000000000300001000000010000000000000000000000000003300300000000000050000000100000100000000000300000000
000000000000000000000000000000030313000000000001000000000000300000100000000020001330000001100060030000000000000000033310000100000000001000100000003000000000000000000000
000000000000000000000000000000333300000000000000000000000000000000000000006000030330000000000030000010000000002000333300000000000000001300000000000000020030000030000000
000000000000000000000000000030330300400000000100600000003006000000000000030003333330060000000000000000003000000033333300000000000000010000300000010000000060000000100300
000000000000000000000000000003133000000006000010000000310100000001000000000003303300030000000000000000000000003033333300000000000000000000000000000000000000300003000000
000000000000000000000000000033333300000000000000001060330000000000000000000003363330010000100000000000000050000033333300000000000000000000000300003030500003503330133330
000000000000000000000000033000000000100000000000100000000000000000000000013000000000000000051000000000330000040600000000000000000100000000300000330300001000000000000010
000000000000000000000000033000000000000000000000001000000000030000000000000010000000300000000000000000030100010000000000000000010000010000000000300000000000000000300000
000000000000000303000000333000000000003000000400000000000100000000000000000000000000000000000000000301330030300000001000000000000000600030000003330005000003000000000000
300000300000000333000003333030000030333000005000000000000000000300000103330000000000300000300130000010300033300000000000000000000000300000500033300000000003300000000000
600000000000000333000333333000600000010000064000000000000000400000000000310000001000000000000000003333310033000000000000060000000000003030003033031130000003030000000100
600000000000003333003333333060000303113303000000000000000000000000000003330300000000000000000000000330330333300300000000000000600000033330003303320000003033330000000000
333333300333333333333333333003333303343310000000000000000010000333333303333330003030333353300333333303331033003300000000033330313333333333330333333000000033333300011000
