000030000000000000000000000000003000000005300000000000000000010006000030000000030030030000000000000000300000000000000000001000000000003300000000003333000000000000000000
000000000000000000000000000000000000000000000000000000000000100000000000000000000000000000000000000000000000030000000000000000000000000000000030000000000010000000000000
000000000000000000000000000000000000000003000000000000000000000000010301000030003000000300001000400000003000200600003000000010300000300036000000000000300000000000000002
000000000000000000000000000020000300000333000000000500003300000000033300030000033000330301000000000000000003000000000000000130330000033331000000133003310000040300000166
000000000000000000000000000000000000006000000310000000003000000000003000000303300300001330000000103000000000000001000000000003300000003333000000003333333003000000000000
000030000003330000000000000000000005003033000033300001003000000000063300000003333000330330000003330000100100000000000000010300300000033300000003333333300000003330300066
000000000000000000000000000000000000030333030000030000000030033030330300000003330000033000100000100000000000100000030000333033003000333300000330303003000000000001333333
333000000000000000000330000001000003330000003000033000001000300330000000000000000003000000010100000300000000000300000000300000000100000000000000000000000000000000000300
000000000000000000000000000000300100000000000100000000000000030000000000100000000000000000000000001000000000506000000000000000000000000100000000000000300030000006000101
000300000000033000000000000200000000003000300000000000020000000010000200000100001000000000010000030100002300000100200600000002000000300000000000000030000030030000000000
333300000003333300000000006610000100035000330000000000630000000000006600200000000000050004000003030000006330000000000003000066000000000300003300500000000000000003000100
333330000000033000000000006600000500003001000000000000610000000000000610000000000030000000010000000000060300000000001100000066000000500000303000000600030000000000060000
333300000033333000000000006600000000333000100000000000660000300030006030003160000000000000000033300030066000000000000330000000000133100000013002000000000003300000003300
333000003333330030033333333300000000330000003033133330330000000333413333000000000010000000003333313333333003003300000003313303000000000000000000033000000600000000000000
