000200000000000000000000000006000000032010000000000000000000000005300001050000000000000000000000000000000000000500000000000000000000000000000000100000000000000005000000
000000000000000000000000000000000010000000000000000001030112310000000000000001000003000000000000000000000301000010000000100000000000000000001011100001000000100000000000
000000000000000000000000000000000020000000600000000300000000000001000000000000000000333330010000001001000002000000000100000003333330000000000000000000000000000000000000
000000000000000000000000000000000000000000000030000000033300000000000300300260000000030000000000000000000000033000033000030000100000000000000300000000000000000000000026
000000000000000000000000000000000660000001000030000000000000000000000000016660000003000030000000000000000000030100000000000000001000000000010033000000000000000300030066
000044410000000000000000000000006660000444000000000000000001000000040400006130000000000030000000040000000000130010000001000000000030006000000400000000000000600001000666
000000000000000000000000000003003330006000333030000010000033033000000003333330000000000303010000000001000033000000000000000000300033300000000003033000000000000003330030
000000000000000000000000000000300000000000000000000000000000100001000030000030000000000200000010000000000000000000000000000000000000000000000000000000000000020000000000
000000000000001111110000000000503000000000310101000000000000000000000000000000010000000000000000000001110000000020000000000000000000001100100000000000000000000000000100
333330000000000000000000000210000000000000010000033333000000000030000000000003330301010000003000000030000100001200000000000030000000006000003331300300000000000010060000
030000000003333300000000002601010000000000030000003000000300000000033300000000300000000000000000003300000200002000013030000000000012330000000300000000333000000000100000
000000000003000000000000066600000000000000000000000000000000000000030000000001001036000000000000100000005106066600000000000000100030000000000000000000130000300000000000
000030000033000000000000066606000000000000000000030113003010000000300000000000000050000044400000000000000000066000033000000445000066610000000000000000330000004440000000
000333333333000033333333333300000000000000003333300033330030000333360000000000003333000000001001000033333333333233333000000000030301300303300003333333330000000000000000
