000000000000000000000000000000100000000003050000000000020000000000001000000001100000003001000000000000000000000000002000000000000000000001001000000000000000300000010000
000000000000000000000000000050010000000000060000000000010000000000000300000001040000000000000000000000001000010000000000000000000001300000000001000001000010000000300000
000000000000000000000000000000000000000100300000060000000000000000000011100030000000000000000000001110001000000000000000000000000003000000000000000020030000000001000000
000000000000000000000000000000003000000000000000000000000000000060000000000100000000000000002000000000000003000010001000000000000000000000000003030600000000000000000000
000000000000000000000050000000000030000000050030000000000000000060000030000000006000050002000000000020000600000000030000000000000000000001004000000000001005300000200000
111400000000000000000333330003030022000000003300020000500000030060000020100600000000000330000300002003000000000000030020000000101400300000001114003660000003333000000000
000000000000000000000000000000003030000000000000033003330000000333333003330333333330000000000000003330333000000000000030333030001600001000000000000133333000000000133333
000000000000000000000000000000600403000000000000000000000000001000000000100000000001000000001000000000000000000000000300000000000010000003000000000000000000000000000030
000000000000000000000000000000001000000001000000010000050000000000100000000000300100000000000000000000010000003000000000000000000000000000000060000000000000000000000000
111000000000000200000000000000000000000000000000000000100000000000002000000000000000000000002000000000003000000000000000200000111000000000000000030031000000000000050010
000000000000006600000000000066001000000000000000010000000000000000000530000000000000000000003001000000000000010000000006600000000000000040100000000000000000000000000000
000000000000006600000000000010000000000000000000000000000000000000000300001110000000000000066600000000000050000005000000000000000000000000030000000000000010000006000000
200000000000006600000000000260000001114030000010000010001114030333333000000000000002000000006000001104100000000233333006600021100000000030000000002200000000000000000000
333333333333333333330000033330033300000000000000030023330000000040000000000000000330333333331334300000005003030300000003333330331033000000000000331353333300000000000000
