000000000000000000000000000000000000000000000000000030000000000000006000000000030000000000020000000000000000000100000000000000000000000000000000030050000000000000000000
000000000000000000000000000000000000000003000003200000003000000000000001100300000300000000000000600110000000000000600000000000000030000000000000000000000000000020000000
550000000000000000000000000000301104000000000003350000100000000300011000000335300100300000000000000030000000000000001100000000550300000000000000000000100000000333000010
000000000000000000000000000030000100000000000000300000000000110300000000002330000001000000063000000001200000000030000000000000000000000000030000000000000000000333000000
000000000000000200000000000030100000200000000000300030000000000300000000000030000000000000000005000000033130000030000000010000000000002000000000003040000000000003000000
100000005000000000000000000000000000000000002003000000000000000300006003333001000010000000005000000333003000000030000000500000100000000000000000000000000000200333030010
000000000000000000000000000003333330100000003303003000000300000330333333310000000000000000000000063330030000000033333333000000000000000000000000000000000033333330033033
000000000000000000000000000000300000600300000000000000000300000000000100000000000000000000000000000000000000000000000000000000000300000000000000030000000300000100000000
000010001100000000000000000200000000000000000000001000000001100000000000000020000000000010400000000500000000000005000000110030002001000001000200300000000001000000110000
330000000000333000110000003300000000300000000001000000033300000000000000500030000000330000000000333000100000100000000300000003000000033010003300000000000000000010000033
330000000002333000000000003300000003000010000001600002330300000001000000000330004000300000000001303000010000000000000300000203000000033000003300000000000000003000000203
330000000000333000000000003300000003300010000000000000333300000020000000000330000000030000000100330000000000000030101330000033000000030000003000100000000000000000000030
330000003333333000000002003305000003300000000010003031333000060000000100200330500000330000000200306020000000000100200330333003001300033000005000000000000010000000333133
333333333333333333333333333300005003330313000100033313333330333100000000333300000000333333333334030331330020300030333303333130100100033033333300133000000000000000333333
