000000000000000000000000000000000100001000000000000000000003000000000000002000000000000000000000000010000003063000000000010000000003000000000000000000000000000000000010
000000000000000000000000000000000000010000600000000000000000000000001000000000000000000003000000100000102000000000000000000000063000000001060000000000003200000010000300
000000000000000000000000000000000000000000000000000000010000000000003000000000000000000000011000001000160000000400000001000066300003010100000000311100006601030303000000
000000000000000000000000000000000000000000000000000001000000000000000000000000000000000300000000000000060000300001000100000000000000010030000000000000006600000000000000
000000200000000000000000000000000400000000600000000010000000033000000000000100000000000000000000000000006000000200000000000060000100000000003000000000006000000300000000
000001100000000000001110000000505001110000000000000000500301100000000100000001100000000000100000000000066000001101000000000064000000000000000000000000000000000000000000
000001100000000000000000000033333100000001000000000100033333300000000000000000000001000010033053330030303000001000000000013053000000033333030050003003333033333000000000
000000000000000000000000000000000000000000000000000000030000000100000000000010000000000000000300000000000000000000000000000000000000100100000000000020040030000000000000
000001000000000000000000000200000030000010000000000000000000000000000003000020010010000030000000000030000300000000001000030000000300000010000000060000003000021100010050
111000000000000000011100006610000661110000005000000000000000311000000010010661310000000000100000000000000000101105100000010000000200000000000000000000000016000000000000
000000000000000000000000006600000663000000000000001000000000000300000000000660000000000010000000000000000001030000000000000000000000000000000000011000000000001100020000
000000000000333300000000006600005660000000000000200000005300000000010200043660100000000003300000001030000030010000100333300300000000000100020000000000000200010000000000
000000000000000000000000006600000060000005100001100100000000000010000130000660000000000000011000000000000300000000040000000030300000100000011100000000001000000000000000
333333333333000000003003333300333300330303000001100305000000030000001000303303303033333330006000001000000000000333330000000103000000000000100000000000001133333330000000
