000000000000000000000000000010000000000003051000000000000600000000000000003000100000000000000300000000000110100000000000000000005000000003300000000000000000000000000000
000000000000000000000000000000000000010000000200003004100000000100000002001110000000111000020200000000010005020011100000230115300000000000001020000000000000000006000000
000000000000000000000000000010000001310114003013066001000000100000000066000000003030000000033111031000000600000000000000600000000000000000001311114000000005000000000000
000000000000000000000000000000000000300000000000066000300000300300000066300000000000000000000000000004000001000000000006603000000000000100000000000040000000000000001000
000000000000000000000000000000000000000000010000066000060000000001000066000000000000000000000000000000000000000000000006600000000010000000000000010000000600000000000000
004444410000000000000000000013000001000000001000000000003500100000000066000001000000000000220000000000030100000000000020600000000000010003002000000304441400000000000000
000000000000000000000000000000003003330333000060003333303000333000000033303310033001333063300303333003033000000030533333333303000000000000003330303000003001000000030000
000000000000000000000000000000000100000000001000000000000003000030000000000300000000000000100000050000000000000000000000000000000000000001030030000000000000000000000000
002000000000000200111111000000000001110000000000000000000020000000000000000000110000000000002001110300001000000000000000000000002000000060000200011000000000000001110000
131111400000006600000000000000030000000000000050000000011311111000000000000000000000000000006000000100004003000000000200000020131111400000006600001003000000300000000000
000000000000006600000000000000000000000000010001300000000000010000000000000001060000000000066000000000000000000000000010000040060000000000006000000000000000000000000030
000000000000006600000000000000000005000000000000000100000000000001000003021030000000000000006000000000000500000010000000000000010000300000000600000000000000030000000000
200000000000006600000000000200300000000002004404400000000050000100000000444440003002000000066000000000000004404403004440000000210000000000000002100000010010000030400002
333333330033333333333333333330000333333330000000000000003033333000010000000033033333000100033333330000000000015000000000000330333333030000003303330300333300000003530300
