000000000000000000000000000000100000000000000000000000000000000000303000000000001000000100000000000000000100000000000000000000000000010001000000000000000000000500000000
000000000000000000000000000000000000000000000000000000100000000000000000300000000000000600030100000000000000000000050000000001000000000000000010000000000000000000000000
000000000000000000000000000000000100030000000004400000000000600000000000006043003000000000003000040000000000000000001000000000000000000014000000000000000100001000000344
000000000000000000000000000000000000003000000000000000620000000003000000000000000000000000000000000002000000000000000001000000030200000030000000000000200000330300000000
000000000000000000000000000000000000000003001000000000100000000000000000000000000000000000000000000060000100000000000000000000016600000000000000600030600060000000000000
000000000010000000000000000000002000002003030000300000000000230000003030000000000000100000000000000006000000000000002000001000016600020020000000200000000000010000000400
000000000000000000000000000003330331303233613303500000103333030000000033333330000000000000003300032303333000000000303030000000300133033033030003333033533300000000030303
000000000000000000000000000000000000000000033000000300000060000000000001010000000000000000000000000055000000000000002200000000000000000000000000000600000000000003000000
000000000000000000000000000000000020000000010000000100000000000001000000000100000000000000001000000600000000000000031000000025000000006000000000000000000000000600000000
000140000000000000000000004400000003000000300030000000000000000000000000000000001400000000000010000000000000000000000000000003000000000000441001400000000000000000000003
000300000000000002000000000000000000000000000000000000000000005000000000000000003000000000030030000000003025000000000000100000000000000000000003000020000000000000000000
000000000000000066000000000000000000000000006001010000000060000000000000000000000000000000000000000000000000000000600000000000000000033000000060000010000010600000000000
200200000002000066000000000000000000000001006600200000004066000000000000003002000000000000020023000000000000000000000000000000000000001000002002000060000000000061000100
333333333333333333333333333300000000000000033300300100003333100000000000000003333013100000033330333333333000000000000000000000000000030333330033303000000000032010000000
