000000000000000000000000000001000000000100000001300300000000000000010000000000000030000000000010000000000000000000000000000000300300006000300000000000000000000000000000
000000000000000000000000000000000000000000000001000000100000005000033000000000000000000000010000005530000000000000010000000000000000000001004003000503000000000000000001
000000000000000000000000000000000000000000000010000005003030000000000000000003011100330000000000000000000000000000000000000300000110000000000000000000000300001000000000
000000000000000000000000000000000000040030000000030333000000000000000000000000000000006010000000300000000000000100000000110330000000100000000000000000020060010000000000
000000000000000550000000000000000000000000053000003303000000000000000005300000000030055000000000000000000000000005500000006300000000000000300000000000000003000000000001
000000000000000000000000033300000000003330020001000001000000000100233000000400000000030000000000330002000000000030000036000000050000300000000000000100200000000000000000
000000000000000000000000000000030000000000000000010000003333333000000006000003333303000000000002003333333000000000000301000033033003300000023000003330330303000330000000
000000000000000000000000000000001000000300000000000000000000000000000010000000000000000000000006040003000000000000001000010000000000000001000020030000030000000000000000
000000000000000000005553000000000000000005553000000000005000000053000000000000001000000100000000000000100100000051100000000030000000500000000000005000000000000000000050
000050000011000000000000000030000000000000000000000011000000000000000005000000030501000000000000000000500001110000000000000000000000000000400000000000000000000110000000
333333000000000000000000000001000000000000000001000300000000001000000000000003030001000101000000003330330000000000000000000000000510000000000000100100101133033000000003
033030000000000000000000000000000300000002000000000000000000000030050000000000330300000000033000000330300000005100000000000000100000000100000000000055000003303000000000
000000000000000000000000200006000000000000000200000010000000000000201500000000001000000000000000000000000000000003300000000000000040000003330000000000005000060000000333
100003333333333333333333333300000003003330333333330333330000300031333300000001050033300300300000000000003333333333333330000000333333300000000303333000000010000330300330
