000000000000000000000000000000000000300003000000000000000000001000100000000000001000000030000000000000000001000000000030000010000000000000002000000000000050000000010000
000000000000000000000000000000000030000000030000000010000000000000000000000000000000000000030000000300200000000000003000000000000000000000601000000000000000100000000000
000000000000000000000000000000000000300000000006000066000000000000030502000000003100040400002000300006600000000000000000000005100000000000000000000000000000000000100000
000000000000000000000000000000000000000001600000000006000000000500000060000000000003000000060000000006600000000001000100000003000000000000000000000000000000000010000000
000000000000000000000000000003300000000001663300000060100000003000000016500000000000011000066000000006600000000000000003000000000100000000000000000000000000000000000000
000000000000000000000000000010000000000000660200000000010000002000000036020000000000300000060020000306660000002000000100000010000002200000000000000000002200000000000001
000000000000000000000000000000000000000000333030003023313330330000000030333300000030333030033303303433330333030320000000000000333030330343000000000033333000100000000000
000000000000000000000000000000000000000000000000000000000000060005000000000000000300000000000000000000200003000103043000030000000000000000030000000000000000000000016000
000000000002000000000000000000000000000000000000000000000000000006000000000000100200000000100000030150100000003000000000000000000000003000000000000020030000000000000300
000000000066000200000000400000300000004000300000000000000010000000000000040000006600106000000000000000100000100000000000006600000000300000000004000020000000000000006600
000000000066006600000000000000000000100030000000300000000000000100000000000300006000000000000000000003000000000066000000000600000000000000000000010660000000000040006600
000000000066006600000000000000000000005000030000000000000000010000000000000000006610000000000000303001000300100066000000006600000000000000000000000661000000200000006000
000002200066006602000000000000000000000030000000000000000001100003000000000100006530010000010000000000000000000066020000000000000000000111000000000000200000000000026000
333333333333303333333333333033333330333330300000000000000000000010010000003301033031000000020030000000360300010003330330300030000000000000003333330333003001000003333330
