000000000000000000000000000001000000000000000300000000000000000000503000000000000000000000000000000000000000000000000000000000000000000000000000000000000100000000010003
000000000000000000000000000000000000000000006000000000030003000000000010000000003000000000000010000000001000001000030000000000000050000000000030003000300000000000000000
000000000000000000000000000000000000003010010000000000001000060000300000000000000000101000001000000000100000004001000000000030000000600000000010100000000000000600040003
000000000000000000000000000000000400000000000000000000000000000000000000000000000030000000000003000000000000013300001000000000001000000060000000000000000000000000000001
000000000000000000000000000030000000000000000000000000000000000000030300000000000000000000000000000000300000003300000000000000000001030130030000000000000000000600000033
000000000000000000000000000000000000003000010000000022100000000000000010000030300000000220200000110000030000033300000000100000000000000003000500000000200200000000000333
000000000000000000000000000000000000030000033003300333330000000000000000000000300031333333300000003333333303330300000003300060333303301300300000003330333300000003330333
000000000000000000000000000000000000030000000000000003100000000000000000000000035000000110000000010000000000000000101000000100000000000000000000000000100000000000000100
000000000000000005500000000000000000005500000000000000000000000600000000000000005503000550030000000000000010000000000000000010000000000030000000000000550000000000000000
000000000000000000000000000300030000000500000035335000000000050030000300000000000300000000000000000000001000000000000000000000010150300000000000000101002000003040000000
000000000000000000000000003300100000000000000003300000000001000000003300000000300000000000000000000000000300000000010000000000000003300000010000000000000000000000000030
000000000000000000000000003300000030000006000003100100000000000000313300000000000000000000000000000000000000001000003000000000000003300000000000010000000000300000003063
000000000022020000000000033330000000000000000033300000001002202000033300200400000006030000000000000100503001000000100000001000000003300022000000010000000000003301000000
333333333333333333333333333300010003333330303333300000313333303333333300000063300330333036300000000000000000000000000000000000333330010333533333333330333004100000000000
