000000000000000000000000003001600000000000000000300000003330000000000000000000000310330001050100033500003030000003300000000030000003000001003000000000003030300000120000
000000000000000000000003013030000000000000000000000005300000000000000000000000000000006000000055000000000000000000000100030100000000000000000000500003000000000000013000
000000000000000000000000000000333330000000000000000300000000013010000503000000000000400000000000000000000000000010000000000010000000020000000000000000000100000000001000
000000000000000000000000000000300000001000000030005000000000334000030000000306000000000000000000000000000100000000000000000000000000000000050000000000030030000000000000
000000000000000002000000000000000000000000000000320000000010030000000000003030002000100000035000000052000000000000000000003000000000000020012500000000000000000000000200
555500000000000000000000033300100035555000000000003000000000005000000300000000000000000000000000000000000000000000000000000333001000000000010000000000030300001000000000
000000003333300500000000000000000000036150000000033333300600031000031100000000500000000000303033300500000000000000000330000000000000015000001333330000000010000030000000
000000000000003330000000000000000000000000000000000000330000000000000400000300000000000000000000300010000000000010000000003000000000000000000000000010000000000000010000
000000000000000000000000550000000000000000200001000301300000500000000100301300000000000000000100300300300000000003055000000000000040000004000000000000000000000000000000
003333300000000000000000000000000000000000000300000000000000000000010000401600030303030000000000000033033310001003000000033331000000000001000001000000000000000000033303
000000000000000000000000000000000000000000300000040000000000000003000000110010000000000000000000100000000000000000000000100000000000000000000200000000100000000000000000
000000000000000000000250000000300000010300000100000000002500050000300000000000000000300000000000000000300000000335000000003000050300300000100000000000010000020000000000
000000000000000000000000000000000000000000001000000303300000000555500000003031000000000000000000300100000555530000000000000000555500000035000000000555503000500000000000
000000000000000000033333333005000300000031013333000330003333300000000000000000000000000333010000000000000000000033333100000003013000000033300003330030000000000000000000
