000000000000000000000000000000000000000000000100000000000000000000100000300000000000100000000000000000000000000030000000000000000000000000000001000000000000000000006000
000000000000000000000000000000002030000000000000000000000003330600000100000000000000040120000000000000000000100200000000050000000000000000000300000000020000000010000000
000000000000000000000000000000006000000003000000300003000006600000000000000000000001000560000000030000000000000000000000000000000000000006000000000000600000660101000000
000000000000000000000000000000006000010000000003000000000006600100000000000000300000000060000000003312000020000000100000300000000600000006000002000000660000600104004000
000000000000000000000000000000061000000000000000000000000006600000500000000000000000000650000000000000000100000000000000000030000000000066003000000000600000660000000000
000110000011111000000000000000066100001011000030003211000006600003000200000000001113000660000000000022000000000200011110000000000000100066000020000000160000660000000002
000000000000000000000000000003133360000000000000001030000313333333333300001000000000303333000000003033330003300300000000000000001000033033033333330030303330333503303333
000000000000000000000000000000000300000000030000000000000001100000000000000001300000000001000000001000000000000000000000000000000100000041000000000000000000030000000000
000020000000000000000000000001000000060000000003000303000000000000000010101000000044000000000000000001000000000000000000001000010000000000000200000000000000000000000000
000660000000000000000006600000100000000000001000030660000000000006000000000000003000001000000000000001000030000040000300061000300000000000000000000000000000000000001600
000660000020000000000006600000000000000000000001000460000000030016600201020000000000000000000660010000000100003000000000066000000200000000110500000000000001000000000010
000660000000000000000006600000000100005000000000000660000000000006600000000000000000000000000660000000000000000000000000066050000000000000000000000000030000005000000000
000660000220000000002006600000011001000000000000230460000001000050300000203011000000100000600060000001110000100000000025066000001000000010001000000000110000061010000000
033333333333303333333333333300030300000000303333303133330000000303333333333100000003000000020030330000000050000001333304033333333300000000010000000000000500300000000000
