000000000000000000000000000000000000100000000000000000000000000000000000100000300000000001000000000000000000005000000000000000000000000006000103000200000000000000000000
000000000000000000000000000000000051030000000100000000000000000000001030000000300000000000000000000000030000000000000200000000000000000000000001000000000010000000000000
000000000000000000000000000000000000040444000300000030000044410000000000000030030000003041430000000000000004000000000000103000040000000000000000000000000000000000000000
000000000000000000000000000000000000000000000604003000000000000000001000002000000000101000010300000000003000000100000000000100000000000000000103000000000000000000000000
000000000000000000000000000000000000000500030000050300000300000000000001000000000100000040000003001000000000000050000000000300000000010000000050000000000000000000000300
011000000444000000000000000001110000000003000440000000000000000004440000003000002200300032000003100001510000205000000000010001000205000440000000000011000000000000000032
000000000000000000000000000000000003333033000000000000003303313000000033033333303333333333333333330000000031333300030000000000333330300001000000000000000100500003003313
000000000000000000000000000000000000000000000000000000000001000000004300000003000000000000000000000050001000000000000000010300000000000001000060200000001000000030000000
000000000000000000000000000000000000030050000000000010000000000003000000000000000000000000100000000000000000000000000000000000000000000100000000000000000005000000000000
044000000444444400000000000000400000030000000000004000000000016003000144000003000030000000000000004000000300000044000000000000004444400000000400000200444400000000040000
000000000000000000000000000000002000000000000000100000000000000000000000500000000300000000000000000300000000000000000000003000000030000000003000501000000000000130000000
000000000000000000000000000000000000000000000000000000000120000002000300100000000000000000000000010000000010003003300040000000000000000000000050000000000003001000000000
000225000000000000000000000200020500010000000030203000000000000000000000000000000100003440000000000110000000000500300000000002000000000000000000000010010000440000002250
333333333333333333330333333333333300001000333300300033000000000000000006333300000010000000000000000000000333033003330403330303033330300000003033330303330300000003333300
