000000000000000000000000000002000000000000000000000000000000010500000600001000000003000000000000030000000000000000000000000003000030000001010000000000000015000000000303
000000000000000000000000000000100000000000405000000000000000000000000000000001000000000000000000100000100000000000000000000300000003300000003000010000000000000000000003
000000000000000000000000000000000500000000000000000000000000030100000000001000000000000001311300030000000000000200000020000000000030000000000000150300000000000000030003
000000000000000000000000000000000000100006000000000600000000000000000000000010000006002000000300630000000100006000000660100001000000000000000000000000100300000000033003
000000000000000000000000000000000000000000066000000300000000000000000000300040000006560300010030030000000000000600000060003000000000030000003300000000000000000000003000
000000000000000000000000000010100000000004060000000010000000000030000560003100200140061000000000330100000003000663000060003333000060000000030000000000000000000000050330
000000000000000000000000000033310330000000333333300000000000030000000013300333333333310013033333333300031303030003333133333300000001000000000010000000000000001003333333
000000000000000000000000000300001020000005000000000000530100100000000100000000000003000003000000000004000050000000001010000000000000000300000000000000010000030003001330
000000000000000000000000000000001000000340030000000000000400000000100000000000000000000000000101000000000000000000000000000000000000000000000000000000000060110000000000
000000000000020000000003000302000020000000000000000100030000000000000000000000030003030000000000000000000000000000000000000000000000010000000000002000000000000000003000
002000000000660000000003000300000060000000000100000300030000000002100000000000030003000000003005050050006100000000000000000000000000600000000004060030000000000000000000
066000000000660000000000300300000630000000000000000000030000060006000000050002000003000000030500000000000000000000000000030030000030016600000000000000000006600000000000
066000002000660000000000333300000660000000000000000013330000000036000000000000003033000000000000000000000000000000000000000300000000003000000000006000003006600000000000
333333333333333330033333333333030030000000000043033133330000600333330000040013033330030000000000000000063000000000000003330053000023033333333331333303000333333330006000
