000000003000003000000000000000000000300000300000000003000030000030000000001030010001000000000050000300000300000000000100000000000000003000040000003000000000000300000000
000000000003303000003000033300003330000030300000300000000000301030000030003030000300000000011001100000000000003000000001001000000033300303351000333000000000000000010000
000000000000000000000000000000100000010000000000000100000000300000100000000000000000330002000000000000100000000000003330000000000000001000000000000000300000000000000000
000000000000000000000000000000000201000003000000030000000000000000000000000000000030000000006000000000000001000000004000000000000000000000000000000000100000000000400000
000000000000000000000000000300000000000000000000000000000000003000001300000000000000013300000000000000000000000000000000000000000000000000000000003000000000000000000000
000000000000000000000000000000000000300000000000000000000000000000000001001100000000030000000000000003000000000010000000300000000000000000000000000000030000100000000400
000000000000000000000000000000000000000300000000003333010000000000000000300000000000000001333300330000030000000000000033033300000004000000300000000030003360000000033300
000000000000000000000000000000000000000000000000000000000000000000000010000000000000000000000000033000000000100000100003030000000000404000000000000000000000005060000000
111111000000000000000000000011110101100000003003000000011110110000000000000000300000000000000003300000003003100000000003500053000000010111103000003000033000000001110101
000000000000000000333300000000300000000003000000330000000100000300000000003330001000060000000000000000000000000000000002000000300000000000000010000000030010000000000000
000000000000000000000000000000000000000000000000130000000006000000000000000000001000001000000000000005030000000000000000000000600000000000000000000300000000000000000000
000000000000000000000003330000000000004000000000003003300001000103330006001005000000000000000000030010000300000000000000000000001034000000000000003000000000003006060000
000000000000000000000030000000000030000000030000003000000000000030000000000000010000000000100010000000000000000000000000200000030100000000000000000000000000000000003000
333333333333000000033000000303303330005001000003300000033332333000000300000033330300333330000000000300460000000000000000000000000000133330330001000000300001000033333315
