000000000000000000000000000030000000006001000000000000000000000000030000000000000000000000003001000010303000000000000000300000330000000100000000000330006000033350000001
000032000000000000003000000000000000000003000000000000000300030000032000000100000000003000000001100000001000000004013001000000000002000000030006000000000000000000000000
000030000000000000000000000030000000020000000000300000000000300000030000000200000000000001000000003000000000003003000003000000000000000000000000000300000030000001000000
000000000000000000000000000000003000000000000010000000000000010050100000300000000000100000000000000020050001000000000000300000000000000100000000000000000000200000000001
000050000000000000000000000033000010000000000000050000000000000000000000000000300000500000000100000000000000000000000003300000000000000000003000400330000000000000000000
300033300000033000000000000033000032000000300100300000000000000000003300003033010000000000000000030000000033010001000010000003000333030300003330301300050300000000000000
050000000000000000005050000000300000000050000000005000000500000050000033333330030000050000000000010303303003000000000000000000333300001000050030050000000000033030500000
330000000000000003333330000000000000003330030000000000000000000001343000000003300300330000000030000000000030000000000010000006000000001033033310000010100030000000000000
000000000000000000000000002000003200000000000002000000000000000000000000000030101000000101100000030000020000002000003003000000000100000000000000020000001000003200001000
300000000000003000000000000000103000000000000030000000000003000300000100000003000003300000000000000000330050500000000000000000000000030000001000050000000000011300000000
000000000000000020000000000000000000031000000000000000000000000001000000000000000000300000000003000000000300000000000000000000000000000000001000000000000000000000000000
330000030000000000000000000060015100000000203600006000001000000000000000000003000000300000000000000000500000000000015000000000300000000000000300000000000000005000000000
330000333300000000000000333300003330000000000003333500101003003000040000000003300003330000330300003000333006303360003033000000330000001300000000313300000030003530000003
000000000300000003303333333305000000103300303333300300000000000000330000000050000051000300000000050500000333333305000000500010003000000003033030333000000505000000000000
