000000000000000000000000000000000000000000000000010000000000000000000000500000000000000000000000000000000000000300000110001000000600000000000000000000000000000000000300
000000000030000000000000000000530000000000300000000000001000000000300000000001000000000000000000000000000000300003000000300000000100000000000000000020000000001000000000
000000000000000000000000000000000000000200000000001000000000000000000000000003000106000000000003000000000000000000002000000100660000000000000000200003000000300000000000
000000000000000000000000000030000000003600003003000000000000000500000000000000000000030000030000000003000500000000066000000000660000000000001000600660000000000000000100
000000000000000000000000000000200000006000000000000300000000100000000000000000000000000000002000001000100000000000060000000003660602000000030006600060003000304000000030
000000000000000000000000000000000300006120300000000010000003000000000000100001000030060000000000006001000503030000566200000020660000000053000006620000000000500000000101
000000000000000000000000000000000303303331000000000006000000000000000000000003033333010001000003000033303000000103003033303100323033300600003303333333334000200000000000
000000000000000000000000000000010000000000000000000000000000000000000000001000000000000000000030000300000000000000000000000000003000000002000000110000000000000000001000
000000000000000200000000000000600000100100020000000100000003010000000000100000000000030600000000000200000005000000030000000000000000000000000000003000300000000000000000
000010000002006600000000000000020000000100063000000000000000000000010066000000000000000020010301006600000000000003000000000000000002010000000000000000000000000000000100
000000000066006600000000000000000030000000060000100000000000000000160016000000000000000000005000006600000000100000000030000000006100000000000300000010000000000000000300
000000000066006600000000000003000000030006660000000010000000010000660016000000000000000160000000006000000000000030000000000003001000000000000000000000000000001000000000
000002000066206600000000200000000000000026660000000320000000000000662506030000002000000062000000200400000005000000000000430000000060100020000002000001000000000000000020
333333333333333333330003333300000003030333003003000313030000000033330103333000003333003303333330033030330000000000000000000300000000000330100030033340000000000003303330
