000000000000000000000000000000000000000000100040000030000000010000010000000000100000030000000000000000000300000000000000000000030000000000000000000000000001000030001000
000000000000000000000000000000000100100000000000000000000603000300000000330000000000030000000000010000000000000010000000000000000000010031000010000000100000000001000000
000000000000000000000000000000000000005000000000000004000050000000000000020001000000000440000000000000000004000000013000002000010000000000006005300000000000000000010001
000000000000000000000000000000003000066000310200000000000030300001200000660300000000060000000000000003000000000030000000066000000000000300000010010000020100001000002000
000000000000000000000000000000000000006000006600000100000000000003601030060000003030000000000000000100500000000000000000066000000110000000000010330006000000000000006030
000000000000000000000000000050000000066000006002000020000060000006002000060001000000000230000000000000000000030000020000066000000000300600030000000000001000000000066020
000000000000000000000000005500001000033333333033333333313003330333333003300330000000331333300000000000400000000033330023033333000000033330330000055000100000010003333353
000000000000000000000000000000000030030000030100000300000003000000000001000000000000000010010000000000000000000000000000000000000000006000000000000000000000000001000000
000000000000000000000000000030000000000000000000000000000000000000000000000000000000000000300000000030330000001130000000000000000000010000000000030000000060000000000000
000440000020000000000000000000000000010000000003000000010000000000000000014000000000000200000010000000000000000000003000004030000000000060000000000000440000003010002002
000000000660000002000003000005000030000003003000000000003000010003100050000000000000006000000350000002000060000000000000010000000000000020000030000500010000000000066000
000000000660000066000000000001000000000000000000000000000005000000000000003000000000006000300000000060000000000000000000000000000000000660000000300000300000000000060003
000200000660000066020006000000000000000030006100000000000000000000000000020000000000006600000600000050003400030010300000000000001001000660300060000003200000000000366300
333333333333333333333333333300001000000055003333300000000000000100000033333300000050033333333330030400330000000000000000000016000003531303303333033003333000000000303333
