000000000000000000000000000003000000000000000000000000000000000000300000000030000000000000000000001000000000300030000000000000000000000000000000000000010000000300013000
000000000000000000000000000000000000000000050010000500000000000000000000001000000000000000000000000000030000001003000001000000000000000000000000000000600000000000010000
000000000000000000000000000000200001011010030001200010000000000000000000000000000002000000000000121311110003000000000000101110000000000060020000100002001060000000000000
000000000000000000000000000000000030000000003000600001000000000000000000000000000066030000030000360001000002000000000000000000010000003040660020000000000000030300022000
000000000000000000000000000005000000000000000006000000003650000000001000000500000006000000000300660000000001000006600000000300000000000000660000000000000000301000660000
000000000000000000000000111100310110030000000030602002020060003000021200000000000066010101100000600320000063000206600020000000601100100000604000000000006000011110660000
000000000000000000000000000000000000003300030303033101333033333033333300000006300003000000033000003030303330300333033300333333000100033000330000001000000000000003333334
000000000000000000000000000000000000300000000000060000030030005000010000000000000000000000000000000000000030000000060000000001000000000010000000000000000000000000000000
000000000000000000000000000000000003000000000000005000000000000000000000000000000000300000000000000000000000000000000000000000200000020000000005100003000000000000000000
000000000000020000000111111000030000000000002000300000003101110000010003000000000000000000001000000000000001000300000000000000000000040501000000000000000201111100000000
002000000000660000000000000000200030000000000000000000000000003000001000000000000000000203000000000000030000000000300000000030000000430000000000000000006000000000000003
066000000000660000000000000006600000000000030000000000000001000000000002000000000000010000000000000000000000000000000000000000000003000000000000000003006600000100000000
066000200000660000202022000006000020030004000000000000300220000000000050000000001111000000000002000000010000000000100000000000000020000000000000202000006600330000000000
333333333000333333333333333333333300000000000000000000003303030000000000000000000030000000035333330000000000000030000000060000353033300000003033333330103330130300000000
