000000000000000000000000000000000000000330000600000000301000000000001000000000000000100000000030000000000000030000000000003000000000000100012300000000000000000000000000
000000000000300000000000000310000000000000000000001000000000000000003000300000000003010003000300000000000000000030000000000003000000000000330000030000000001000032000000
000000000000000000000000000000000000301030000000050003003330000000000330300000000003000030000001100000000336300000003000000000000000000000000030000000000000000000000300
000000000000000000000000000001200003033000000000100000033333000000000300010200100100000000000000030010001333300030000000000010000300000300000000021000303350000000000000
000000000000000000000000000300003000330000000000000000003300000300000300300030000003000000030000030000003333000000510000000001300000300000000030003300000300000000000000
000000000000000000000000000000000063333000000000000000033336030000500000030330000000000000000000100000000003000004000000000000000000300000000000003000000300000000000000
000000000000000000555000000000000003030330000050533333303033030333330333000030030000000055513300300000000033333300005650000000033333100000003300003303333300000010000000
000000000000000000300000000000000000000010000000100100000000000102000000002030000000000000000100000000000100003000001000030000000000000003000050000000000500000005003100
000000000000000000000000002000000350010000000000000000200000033000000000000200000000000003000000000000000000002000000300000000003003000000000000003501300000000000000020
303000000000003333000000000003000003030000500005000000000060000000000000000001000000000001000000100030000000600000000003030000003003033330000000000000030033000000000000
000002300000033333000000000001000000000023000000000000000000000000000000000000000003000006000000000000003000000000000000000020010000053330000000000000000030330000000000
003000330000033330000000300000000000030001000000310333000000000000000000030000000000000000000000000030000000303000050000000033000000030000000000300000000033300000003063
000000300000033330000003330000000000000003010000000333000000300000000000300000000000000010000000000000003103230000003005000003000000053300000010000000000033310000052300
330000333333333333333333333310000103300603000000030330330005000000000033330300000450000000030000000303003003330333330330300000000100033303130000055005100030333033030333
