000000000000000000000000000000000000000000000000000000000000100003600000000000000000030000000000300000000000000000000000000000000001000000000033000001000001000000000001
000000000000000000000000000000000000000000000001200100030000001030001001000000000000000000000000030000000000000200000000001000000010004010000000000030000000000000000000
000000000000000000000000000000000100000000100006610011100000066000000000200001111010011011000000000000000000006600000000000000111130100000000000000111111000000000000000
000000000000000000000000000000000000000000000006600000100000066000000000000000000000000000000000000000000000006600000000000030000000000000006000010000000000000100000010
000000000000000000000000000000030000000000100006600000000000006000000300100000000000000000010000300000000000006600300660000000300000030000000003000000000000000000030006
000000000000000000000000011100000000000000000006600201000000066000100001000200020000002000000000200000303000006000300600005000002000000000000000620002000000010000030006
000000000000000000000000000000000000000000333303333343000333303000400033333003330300333303033330010000000333033301333330003000303333030310303103330333333120000003033333
000000000000000000000000000000000100000000000000000000300001003600000000000003000000000000000000000000000610000000001001000000000000000000000000000000000000000000000000
000000000000020000000000000000001000000000000000000000000000000001000000000000000000030000003000000000000050000500000020000300000000000000000000002600000000003053300000
000000000000660000000111111000000000000000000000000000000000000000000000000000000145000000000000000103060000000000000660000000000000000000000000000000100000003000300000
000000200000660000000000000000000000000000000000000000000000000000000201000100000030000000000000000000002004000000000660000000000000010001003000066604000300000000000000
003006600000660000000000000000030000000000005006600000010000500303006600000301006000000000000000000030066000000000000660000000000050000500003000066000100000000000000000
003006600000660000020002000000000000000000001000600001000000000003006630001110000013300000000600000030066006001100000010005000000003000001110000066000000000000000000111
333333333333333333333333333303303000003000303003000000000000000313303300000000000001000000000000013303333000000000333330000000000000000000003333033060000000000000000000
