000000000000000000000000000000000300000000000000000003000000000000000000000001000000000030000000000000000003000000000000000300003000000000000000300000000030000000000000
000000000000000000000000000000000000000000000000000000000000000000000060000000040000000000000200000000050300000010000300000000000001000000000000000000000000000030003000
000000000000000000000000000000000000000000000000000000000000000010003300000000000001000000000000000000000000000000060000500000000000000000000000000000000000000000000000
000000000000000000000000000000000000000000000000000333300013000020000000000000000300003333300000000000000000000001033301300000010000000000000010000000000000060000000000
000000000000500000000000000000000500000000000000030333300000050000100000003000000000303033000000000000050000000000333300000000600000000000000000000000001000000030000450
000000000003300000000444011100001300000000000020000000000000300010300000000301000300000000536003000000300100000000001001010000444011101002000000000000030044400110000310
000000000000000555000000000000011003330303333333030000000000000033333330333030333333030000005050000000000000010030000063003330000000000333030003303006000000000000000000
000030000000000000000000000000000000200000000000000000010300000000033000000000000000000000000000000033000300000000000000001000000000000000000000300000600000000000000000
000000000000000000000000000000000000000000100100000000000000010000000000000000000000000001010000000000000600030000000000000000000000000000000000003000000300400300003000
000000000000000000000010000011000000000000003000000000000060000000000000000000000011010000000000030000001000000010060000000000000005000000000000000000000000000000000005
003333000000000000000000000000000300000000000000000000000000000000333000050000000000050000000000000040000000000000000000000000000403000000006036030000000000000000000050
003333000000000000000000000000000000000000000030000000000030100003033060000100001000000000000000000600000000000000000000100000000005000000300033030000100010000000000000
000000000000000000200000000000000004040111000006000000000000000000010000000000440111000000014010111000200000000010000000000000000033000000000010040000000000002000000000
300000033333333333333333333333333330000000010006003550000000000301000000150000000000003333301000003303333033303305554000000000000000033303303000000000500130333313033333
