000000000000000000000000000000000000300000000000000100005000000000000000000000400000100300002000000000003000000010000000000010000000000000600000030000000000000010010130
000000000000000000000000000000000030033100000003000006000000000000000000000000060000000000000000000010333000000000000000000003030000000000003000303000001000000100000000
000000000000000000000000000000000000000000000000000000000000000000100000000000000030000000500000000203030003000000000000001000000000000000001033330000000000000000000000
000000000000000000000000000000020000000000000000000300000000000000000230000000000010050200000000000333300000000000000300030030000200000000000333330400000000000000000020
000000000000000000000000000030001030000000000000000000000030030000000300000000000000000000300000003303333000000000100000000000000000000000000333333000000000000000000000
000000000000000000000000000000000330030000010000000000000000000000000000003100000000000003310000003031000000100000000000000300000100322003003133300000000000000002000330
000000000000000000000000003303030335600000310000000000330000000303333300000000000003330333300000330330000000001000000003330333003333330331333030100001000000000000000033
000000000000000000000000003300000330000000000030100000000000000000000103003000000000000100000010000000010001000000031000003000000000000000330010013000000000000000000010
000000000000000000000000033300000330010000000050000000000050300000000000000000000000000000100600000000000000000003000000000200000000000003300000050100000040000300010000
000000000010000000000003333000033310000000000100010000000000000000303000003000000000000000000000010000000000000000010000001000000000000030301001000001000000000000002000
000000000000020002000033333300030330000000000000000000000000000033333300000000000000000000001000000001000000000501000010000000001000003030330000002100000000031000002000
000000000000000000003333333333303330000300300000000005000000003303003005000300000000000000000000000000000000000000000000000000000000033033330000000000000000000000000003
200000000000200000033333330003303030000000200000000000200000030033300000000002000000200310000000000000000060002000000000020000000000030300000000020240000000000000000033
333333333333333333333333000033300000000000363333333030033300330333000000000000103013330333300000000000000333033300000000000033060300033300003333133301350300013003333330
