000000000000000000000000000000000000000000006000000000000000000030000000000030500000600000000000003100000001000100000000100001000050000000000000030000100300603010005000
000000000000000000000000000000000000000000300005004100000010000000000100000030000001000000304000000600000000000000000000000000001000300000000000000000000300000000000000
000000000000000000000000000000000000000000003110000000000000000000000000000330000000000003000000000000000001000000011100000300000001500000000111100000003100000000000000
000000000000000000000000000000000000000000000000000100000000000000000120000030000000200003300000030001000010001100000030000000000003300000000000011600000000000000010001
000000000000000000000000000000000000000000000000000000000000030001000000000330000000000003000000000030033000001110000110000000130000300000000001001030050300020300010000
002000000000000011111000000000111113005010000000000000000000030000000000000330001101000003300001110060030000000000000000000000000036300000000000000000013300000300011110
006000000000000000000000000000010000000000310133000000003333303000000033333330000000333330000000003133033333303353330330000000033333300000101003330030303333133000000030
006000000000000000000000000300003000000003010000000000000000000000000020000000000000000000000000000000000000000000000000000000000000000000000000000006000000000000000000
000005000000000000000000000300000000000133030000000000500300500000000000000100000000000000000011000000000000103000000300000000100100000000000000000003005001000000000000
001111000000000111110000003300000000003030000003000103100000000011101000011101000000001110000000000003000000000300011100000000000000000000000000000300111000000000000000
000000000000000000011200003300000002000033000000000000110000000000001000000000000000000000000000000000000000000000000000100000000000001000010000000005000100000000000000
000000000000300000011000003300000300000333000000000100110000010000001100000100100000000000000000000000100000000000000000000000001000000000300000000000000000000000000000
000000000000300000000000003300000300030033002000041000000000000000003100300003500000010030011000000000000002000301000001020000001111100000300000001000000000000000000000
333333333333333333333333333333303333301333000000033330330060000330333033333300000000333333300000000000000000000033303330060000000000033303000060100033360000000030000000
