000000000000000000000000000000000003000000000100000000000050000000000000000000000000000010000000000000000000000000000000000001000400000010001000000000000000000000000000
000000000000000000000000000000000001000000001200000050000000000000000030000000001000000300000000000000400000000000000000000030003000000000000001000000000000000000000000
000000000000000000000000000000000100440440000000000000000000000044444000000010100000000001000000000444440000100000000000000000000000000000000000000044440000000000000000
000000000000000000000000000000000021110000000000000000000000000000000000000000000100000000001000030000000000000000001000000000000000000000000000000030001000000100000000
000000000000000000000000000000000000000000000000000000000000000000005003000000000503000000000000000000002000000000000000000000000000000000000000000000000000000000000000
010000144414000000000000000000100000012001000000001000000000102110103001000010010000010000100002020003000000000000000005401000000000010000010100031000000000000000000201
000000000000000000000000000000000003033303001000003335033133030330133300100000333300000000030013333033331000000000000000030000333333300000000000000333330300000003333333
000000000000000000000000000000000000000000000000030000000000000000000000000000000300000000000000000001000000000100001000000000000000000000000000300000050000000000000000
000000000000000000000000000000000000000000003000000000040000003000000000000010000000000000000000000000000000000000000000000000100000000010000000000000000000030500000000
011000004444400000000000000000001040000000000000001100000000000001303000000000000000000003000000000600000011001004444400110000000000000000000005000011000000000001000300
000000000000000000000000000000000000000000000000000003000000000000000000030100000000000000000000000000200000000000000001030000000000003300002000000000000000000000000000
000000000000000000000000000000000030000000000000000000001000300000000000600000000000000000000000010000010000100000000000000000000000000030003000000000000000000000300000
000000000000000000000000020244414000100001000031200000000000000144040000000000000000044100000001000000000000000000000000000000000020200000000000000000000000000004410400
333333333333333333333333333300000000000000303333003035030011000000100000000003033330000300000000000003300333353303103333033330033300300000003333303303333100200030000060
