000000000000000000000000000005000000000000000000101000000000000000000000030030000000000000300000000000160000000000000001001000000000060000000000000000000000000000002000
000000000000000000000000000000000000000030000000110300000000000000000001050300000003000000000000000030000030001000000000000050000000000000000000300000001000000000030000
000000000000000000000000000000000100000000000000003330000000001000000000000000000000030000000000010000000010000000000000000010000001000400000000001000000000200000303003
000000000000000000000000000000000000066000000000003000000000010300000000100000000000005600000000000000000300040000600000000000500000000000000000000000000000000013033053
500000000000000000000000000000000000006000003010033300030000000000000000010000000000506000000000000000000000100000660005010000030300300001000100000000000350000013631003
000000000000000000000000000000000000066020000000031630030000000100000002200000000033003600000000000130000000000060660200000000000003302200000060000001003300000003303005
000000000000000000000000005000000503333333000000033300000000000000000003333033333133303333300000000000000000001033303330000300333333303053300000050330333000000003030000
000000000000000000000000200000000000000010001000000003000102000000000000600000000000004200000000000000000010000000000000002001000000000000000000600000000000003000000000
000000000000000000000003000000000000000000000000300000000033000100000300000000000010033000000000000000000000000000000010030100050000600000020000000000000010000000000000
000000000020000000000033300300000000001000000000000000000330003000000000000000002000033300300000000000100000000000305300033003000000000000000000101003000000000000000000
000000000660000000000333300300000000000000000000000000000313003000000100000000066000330300300000000100000000100000000003333003000000000010000000300006600010001000300000
000000000660000000003333300300000000000000000100300050003303003500000000000000006000333300303000010000000500000006000100330003000000000100000630000000000000005000000000
022000000660200000033333300300006100000010000003302200003330003000000000000000066020303300312200000000030000000000003003333003000000050000000003000000002030000000221000
333333333333333333333333003350000000000000133333333333330330036500000000000503003303313003330303003333030000000000050003330033000005000000000000000333310300000003331330
