303000000000000000000000000000000000300000000000033000000000000033000000000003000030330000000000000300004300000000000000000000031000000000203300000303040000000200000000
000000000000000000030000000100011000000003000000000000002030000000040000000000300000003000000000010000000000000000000000000030000300000030000000000000000000000003000001
000000000000000000000000000000000200000011000000000000000060000000000000133000000000000000000000000030000000000000000000000000000000300333200000000000000000000000005000
000000000000000000000000000000053000001000310000000000021300000000000000003330000010000010200000300000000000000030000000003000000000000000330000001000000000000000010000
000000000000000000000000000000000003033000010000010000064000000030330000000000000000005000000000000333000000000000000010000000330330000000020003060000000006100063000000
000033330003330000000000000030003300030000000000000000660600000000000000001000000300006006601000000000100000133300000000000000000000006000000000066000033330000330000000
000000000000000005000000000000000000001000000301633330530000033000060030000000000000300033300000000000000000300000010630005000000000000000003333030000100000000000001405
030000000000000000000330000000000000003000006000000600000000000000030001004000000000001000000030000000003003000030300003000000000000000000005000000011010000001006030200
000000000000000000000000000000030003000000000000000000300000600000003000004000000001000000000000000000010000000000000006000030000000000000013000000000000000000000000010
000000000333000000000000000000000000003300003000000000300000100000030000000000000000000000000000000033330000020001000000000000000000000000000000000003360000000300110000
000000000003333300000000000200006000000333000000000000000000002000000000000000000100000000000000000000333030000000000000000002000000000000003300000050030300030100000000
333330000000000000000000006600000000000000000000000000000011066000000000000600000000000000000000000000000000060100003000000066000000000000000000000000000033330000000000
000000000000000000000000006600003335300000000000000000000000566000000030003330000000300033300000000000000000000500000310100060305030000000000000001000000000000006000000
000000000000000000033333333300000000000000000000000000003333033003500043010006000000000000000051330000000000003300000013303033000000000000000000003000000000000000005001
