000000000000000000000000000000010000000100005000001000000600000102000000000000000000000000000000000000000000000000000000000000000000000000000001003004010000000000001000
000000000000000000000000000000000000000003300000000000000000000000060000000000000003000000000200000000000000050000000000100000000000000000000000000000000010000000001000
000000000000000000000000000000000233031000103100000030003300000000110000000000000000003050301100000000000000506001030040000000000000000000040000000030000000000000010003
000000000000000000000000000000000000000003030000000000000000000001000000000100000020000000000000000000000020000000000000000000000000000000000000000000000000300000000000
000000000000000000000000000000000100300660030000030060000300660001000000000000400000000000010000000000000060000000000000000000010000000000000000000001000600000000600001
000044410000000000010000000002000000000260000041000600000000665000000000000110200000100300000000000000544660001000000000000000030044000000000000013020300000000106000000
000000000000000000000000000030030303330033000000000030000301333000000000000003063003000000033000330000000330333333330300000000000000000000000000000300332000000003033033
000000000000000000000000000000000400000000000100000000000000000000000000010000000000000000000000000000000000000000000000001000000000600000030100000001000000000000000000
002000000000000001000000000000000300020000000000000010000001000000000000200000000000000000000000000331000003000000000000010000000100000000000100000002000000000000030000
011000400000000000003333000000000030100100000000000000030000103000000001100040030005000000000110003030000000300500000000000000004000033300000000000011000400000003330000
000000000000000200000000002003000060000000010040002000000200000000000600000000000000000300000000000000020000000300000000000000020000000000010000000300000000000130010120
000000000000006600000000066000000000000000000000060000000000001000000031060000101001000000300000100000060000100000010000000010340000010006600005000000000000000030000660
000000002000006600000000066610001000000000000000466000003000000000004400000000000000000000002000400000666010000000000000500000660000000006660000444000000000000000000666
333333330033333333333333333300000003330333000000033033333333033000000033003330000000000000030013330330603000000030000003003000333033303330030000000300033300000003110303
