000000000000000000000000000300000000000000000000000003000000000000000000010000000000000000000000000001000003000300003000000000000000000003030000000000003000000000003000
000000000000000000000000000000030000300000000000000001030000000010000000000000000000000000000005000000000000000000000000100010000000000006000002000000003030030000000000
000010000000000000000000000000000000000000000000000300000000010300000000000000000300030010000310010003000000000003300002000000000000000601000000000000000000300000000000
000000000000000000000000000000000000000002000000000300000030000030000210000000010600000003000300000000002000000000000000030000000000200400000000000000000000000000000062
000000000000000000000000000001000000000006000030000300000030000000006600003000000000000300000300000000066000000000300000000000000000000000000000300000000000300000000016
000000000000000000000000000000000100000066040100000301000030000000016601000000000000100000300300000000066040001000300000005000000000000000003000030000000000000000000006
000000000000000000000000000001000000333333333500031033333333303033033033000050000000000000030333333333303000000333333330000000000000000000003033003001000031333333361333
000000000000000000000000000000030000000000050000000000000000000000024100000000000000000000000000000000000000000000005100000300500300000000000300000000600000000030050000
000000000000000000000000000000060000000000000000000001000000000000000000100000000000000000000001000000010000600000360000000000000010000000000000600000000000000000000000
000000000000000030000000000000000000000100000600000000000000000030000000001000000000010000000010100000300000001000000000000000000000000000001000000000002000000000000100
000000200000020030000000000000030600000000000000000000000003002000000010000000010300000000300000001000000000011000030000000002000000200000000000000000000400000001000000
000006600000660030000000030000002000000000000001600005000000060001000000300000000000000106605000000000300000000110003000000056000003000000006001000006000100000000003000
000006600000660030000000000010000100000000000303600000000000000000000000000000000000000606603000000000001000000000000000000063001000600000000000003000016600000110000000
333333333333333333333333000300000000000000333333500060003133333000000000000000000000033000100000003330003000002033300033300303333333300000000000000330003300000000000000
