000300000000000000000000000000000000000000000000000030000130000000301000000000000000100100000030000000100001000000000000030013003000500000000000040300000000000000000100
000000000000000000000000000000006000003000000000000000000000000000001010340000001000001000000000300000000000000001030000000000000000006020000000000000100000000000000000
000000000000000000000000000000300000200000000100100030000000000000000003000000300000000404000000000000000000003000000000000000000000000000000000003020000100000300000444
000000000000000000000000000000000000000000000000000000000000000000000100000300000000001000000300000000100600100030000030300000030000000000000000000060000000050500003000
000000000000000000000000000000011006600000300003000000000000000050000000000000003000000000000000000000000000000066000000000000000100000030000000500060000030030000000000
000000000444000000000300000003000000660000300000600000000022000000000000004000200000000001010000033000000212000000200000000000000000000444000000003662000030000000000100
000000000000000000000000000003333303330310000010000001003333334000000000000003333000033003000003000000003333303063303000000000000000000000010001000333333000030003330033
000000000000000000000000000000000000000000000010000000000000000000100000000030000000010000100000000000001000000000000000001000000300000000000000000000000000030000000000
000000000000000000000000000001000000000000000000000000000000000050000000000100000000000000000000000000000000000300000000000000000006000000000001030000000000000000000000
000000000044440000000020000000000000000144000000000003000003000010000002010030004004000000000006000000000000000301000000300603000000000044440000000000000000430000000000
000000000000000000000660000000010000000010000003000000000000000000000030000000000000000000006000000020000100000000000000000000000600300000000000000010000000000000000000
000000000000000000000660000030000000000000000000000000000000004000000006000001030000000000000000600000000000000000000000000000000000000000000000000000000000431000000000
002200000000000200000662000000060000000000003440000220000000000300000506500010000000020000000000000044400002200006213000000500000030000000000044400020000000000000002000
333333333300333333333333333000000003330000000000033333330000000000003033330303330033303030300006000301000333033310333333303033000000133000030000100033133300110001033303
