300000000000000000000000000000000560003000300300000000020000000300003000000000300000000000000003000000000301000000000000000000000000030000030000000000000000030000000000
000000000000000000000000000001000500300010000000000000000000000000000500000000000000000100000000000030000000600010000000000000000030000000000006000000005600000001000000
000000000000000000000000000033013110000010030000000100000660000010000000000000000000000001000300000100000000000000000000000000000000000010001031100030111100000000000000
000000000000000000000000000030000000000000000000000000000000103000000030000000000000000000000000001000000060060000000000000000000000300000001000000300000000000000000000
000000000000000000000000000003003003003030000000000000004003030000000000030000000000000303310000000000000000000000003000006000000303000000000000600330000000000100030000
000000000000000011111411111130010000033530100502000000000033333000300000030300011101003333341011110011010000000101111110000000003333300000000000030130000300006000011010
000000000000000000000000000033330030331000003000003010000300003000000033003100000000030000300300000100000000000500003000000010330000300001003300030301333300000000000000
000000000000000000000000000000000000000000000000000000000003000000001100010001000000000000000004000000000000000000000000000000000000000010000000000000000001000000000000
000000000000000000050000000003000000060000000000000000000000000000000030100000001053130000100600500000000000000006000000000000000001000000000000000010000000000000000000
000000000000003301111111110000000000500000111110000000000000000110110000600003011111000000003011113001010111100010111000000000300101000000100000000000000000600000000000
000000000000033000000000000000000000300010000000000000000000000000030000000000100000000000000000000000002000000000000000000000300000000000000100000000000300000000000000
000303000030333300000000000000030303000103100000000000000000000000000000000000000100000303033000000000000000000000000003000000330000000031300003030000303300050000000000
003303000333333300000000000000333300010111300000041111110111111000000000004003300000030300033100000000000100000000000000011111330000000300310031034003330341111110000003
333333003000033333333333333003000000000000330330000000000000000303333000000000330300300300003330330000000333333003333400300003003033006033303333330003000300010000000000
