000000000000000000000000000000000330000000000000000000000000060300000000000000000003000000000000000030000000000000000300000000000100000000000000000000000000000000000000
000000000000000000000000000000003300000000000000000030000000000000000000000000000001000000000000000000000000000000000000101030000003203000000000000000000000500000000000
000000000000000000000000000000033331000300040000000100000000010000030010100005300000000300000005101300000003050000000000000000300000000103000001000000000003000000000000
000000000000000000000000000000333330000002000000030000000000010000000000000020000002040000000300000000000000003200000000000000000000000000020000000000000000000000000001
000000000000000000000000000033300036000001000000000000000200001000000000000006000000000003030010006300000010000000000500000000000000001000000000000021000000000600000000
000000000000000000000000000030330306000002000200300003020030003000000000000026000002000000063000036010000000000500000100000003000000000000000000002000100000030000000000
000000000000000000000000000333333003333033303303030303333330103000000030333331333333000003033330333333333033333300000000000040000000033333333343333000000100000000000000
000000000000000000000000003300000000006003030000000010000000000001000300030330000000000000000100000100030000000000000000000000000000000000330000000000000030000000000003
000000000000000000000000033300360000000000000000000100000000000100000000003000000000000000000000100000003000000000001000000000000000000003330000030000003000000000003330
500000000100000000010000333300000000000000000300000000400000300000000000003330000000000000000000000000333000050000000030001000000000000005305000000300000000000100033503
000000200000020000000003333300006000000300003000000000060000000100000300003330000000030000000600000033553000000000000000000000000000000330330000002000000000000000023303
600000000000000000000333333301000030000000000000000000010000000000100033333100000100000030000000003033333000000060001010000000000000033353330000000000000000001130333333
600000200000020000003333333300000000000010000000000000000000000000000013303300060000000000000000303303330000000040000020600033000000333333336000002000600000000033333303
333333333333333333333333330000000000000000000000300000000000000000000000330030000033600000000000033333300000130000303033033333010000063330000333333000000030303331333300
