000000000000000000000000003301000000000000000000300000000001033010000000000000000000000000000000330001030000300000000330000000000003003000000000000000000000000000000000
000000000000000000000000000000000000000000003030000000000000000000000000000000000000330000000000000000100000000000300000000000030000000030000130000000000010030030001000
000000000000000000000550100000060000003000550100000300005501000000000000300000001000000000050000000000000000000055010001000000003000000000000000000003200100000000000000
000000000000000000000000000000103060003300000000000010000000003000000000101000000000000333300000000000030000300000000000000000000000010005000003305000000000010000000000
000000000000000000000000000010000000033330600000000000000000000000000000000000000130000000000100000000100000000000000010000000010000006000000033330010000000000000000000
500000000000000000000000000000000000333300000000000000000000000000002100003000000100010030000000000000000030000001000000000000000100000000001003300001000000000000000000
000000333300000000000000000030030003063353000000033303000300000000303313303303310003300000000000000000000330000060000001003336333330000000003331033333330000033330330030
000000000000000000000000000000000000000300000000000000001000000000000000000000000000000001006330000000000000000000030000100000000000000010000000033000000000000300300000
000000000000000000000000000000010000000001000001000060000000000005000000000001000000000000000000000000310000030000000000000000000000000000003100000000000000000000010000
003000000000000000000000000000001000000010000030301000101000000000000000050000120000000000100105000030000003000000030000001000000000000000001501000000000000000000000001
000000000000000003300000333300030000000000000000000000030000000000000300013300303300000030000000000000300010000000033000000000010033300000000000000000000000030330000000
000000000000000033330000000000000001000000000000000000000003000000000000000000030330000000000000000033330001300000333300000300000530100000000000000000000501000000000000
000000000000000333300000000000000110000000010000050000000000010500000000000000303600030010000000000330000000000003303000000000000000350000000300030500030150000004000000
333330000033333333333300000001000300003333363000000000000030000000000000000003330333000000030013333303333003330033303330330000300000000050000100010300000330000000000000
