000000000000000000000000000300000001000003000001000001000000000000000000000030000001000000000000000001000000001300100000005000100000100000000000000000000000000001000000
000000000000000000000000000000000000300000000000000000000300000000000000000000000000000010000000000300000000000000000000000000000300000000000000000000000000010000000000
000000000000000000000000000000000000000030000600000000011000000000000000000000000000100600000000004430000010000000100001444000100000000030000000000000000000000000444000
000000000000000000000000000000000000000000000030000000010000302000000000000000000000000003000030003000000000000100000000000000000001000000000005000000000000000001000000
000000000000000000000000000000000000000000000030300400000000303000003000000000010000000033300000300000000000300005000000000000000000000000003000030000000000000000000000
300000040404004000000000000000000000000000330030041300000006330000000040000000040400030033000000001000000000000010000000000000100000300414000000000101000000004000000000
000000000000000000000000000030303330300000333303300000103303303000000000000000000000133333300000000330330000000030100003330033533333340000000000000330330300000000333331
000000000000000000000000000000000000000000000000000000010000000004000000000000000000000000001300000300100000050000000000000000000000000000000000000000000300000000001000
000300000000000000000000000004030000000000003000000000000006000000000001000000010000000330030000000000001300100000300000000000000000000060000030100000000300000000000000
000000044440001000000000000000000000000100000000000400300016000100000064010000000000000000000000000000030000330000000001000000000000000000000000000160000010000000500000
000000000000000000333000000000000000000000030000003000000000000000000000000000000000000000000000000100000300000006000000000303000000006000003000001000000000003330000000
000000000000000000333000003000000300000000300000001000000000000000000050000000000000000030000001000001000000300000000000030303000003000050000000000000000006003330000001
000000000000000000330000000000000013000001404006000000000000000400001000000003000100030000040000006040406300000000000000300030000000040000103030000000000000003304000000
333333333333333333333000000000000000000000000000023333133300000000000033033330000000053033300000500000500000000000000003200333030000000000010060000010001003333330000000
