000000000000000000000000000000000000000000000000000050003400030000030000400000000000000000303030000000000010000000050000000000000000100000000000000000010000000000000000
000000000000000000000000000000000100600000060000000000000000000000030000000000100000000400000000003000000000000001000100000000000000000000100000030000000000003000030010
000000000000000000000000000000000030000000300040000000000000000300030000000000000003000000000100000300000000330000000003033300000000000000000010003000000030003000000000
000000000000000000000000000000000000000200000000030000000000000333300030000000000000000000000000000000000333030000060000313300000030500000300000000010000003300000000000
000000000000000000000000000000030030000003000000000000001000050300030001066000003303000000000000000005001333330030000003035300000000000000000010300000200030303000001000
000000000000000000000000300000333031006600000030030000000000000333330000060000000003000000000000000000000333330000110000033000000000000004000030000000000131330000003000
000000000000000000000000330010300030033003433333300000000000000333303300033333330333333303000033100000000333333303303333333333000000000010000533333003000003313033023300
000000000000000000000000030000000000000300000000000000001000000000000000000000000000100010000000500000100000000000000000000100000000000010000060003000000000000300000000
000000000000000000000000030000001000000301030100000000010100000000000000000001000000000000000000000000000000000001000003000000000000000000000000000000500000000000000000
000000000000000000003303330000003003030300010050000000000000000000030000000000000300060000000000030000003000000000010000000003000100000000000000000000000000000000000030
000000000002000000000333330000001003333300000000000000000000000000000010000000000000001010000000000000000500000000000000010000000000000000050000003010000000002000000000
000000000066000003303333330000100003313300000000030010003000001000000300000000000000000010000030000000000000600000006000003303000300000060000000500000000000060000020000
000000000066000033303333330000000003303300000300001003000000300000060000000000000000060000000333030000001000060000006000030303000000600001003030000000000000036000003001
333333300333333333333333333300000003033333000030000300003333033000000000000000003100000006003030330000000003333300303333333333030000000033003333333000001000333000000003
