000000000000000000000000000000000000000031000000000000000000010030000000000300000000000000000000000000100000000000000000000030020000000000001301050040000000000000000000
000000000000000000000000000000000600005000000000000000000000100000000000003000000002020000300000001001003000000000000000110000000000000000000000000000000500000000200300
111110000000000000000000010011111000000000000000000002000000000101000001011000400000300000000010000000200020000000000003000000020030000000000000200001000000001000000000
000000000000000000000000000000000000000000000000110300002000300000000000000030000000020000000305000130600200000000000000203000200000300000000030060000000000300000200000
000000000000000000000000000000000003000000000000203366000000000100000300500000000000330000000000010336600000000000000033310000000000000000000336000000000000000003000000
000000000000000000000000005000000000004000000000030366000010000000000000000000000050300000000000003336600200200000000003313000200200030000000336600100000000000500000030
000000000000000000000300000000000000103333000000033303004333033000000000030000060000330033300333030333330003000000000000000333033303100033303331033000303000000013300030
000000000000000000000000000001000000000010050300000500000001000000030003000001000000000300000000000300000000000000000000300000000010000000000000000000000000000000000000
000000000000000000000020000013000501000000100000000000000000000000000030000000010000000000000000000000000100000000000010030000300000100000000000310100000000300002010000
020000000000000000200300000030060100000000300010000000100000200000000300300033010000200000000003001501100000000000003000000000000100000000000000000131110000000000000000
200000000000000036600020000005003000002000000000032000000136101000000000000300200000000000300001000000000000000000000000000000300000005300000000000000000020000000000000
000000000000000336600330000033000003000000000400030000000006602000003000000003000000000000030000000000000000000000000300010000010000010566603000000000000000000000006000
200200000000003336600330000033006006000000000005020500033030600001300000000000303000000000003000000000000000005000000500000000000000033360030000010000000020020000000000
333333300033333333333330033330003000000500600003033333003033333000334000000003300333000000000000000001000301000030000000000000000000030300330000030000000133003010000000
