300000000000000000000000000000000003000000000000000600300000000000000000000000010000000500000000000000000060000000000000000000000030000000000000000300000000000000000000
000000000000000000000000000000000000000000000400000000000021000000000000006000000000000000000000020000000000060000000000000000000001060000000200000000000000000000300000
000000000000000000000000000000000020000000331100000000003311300000000000000000000010000100000000000000000000000000000000000002330000000000003000001000000000000001000000
000000000000000000000000000000000060001000000000000000300000030000001000000660000000040000030000000000000000000000006300000066330000000000003000300000010000000001003000
000000000000000000000000000000000660000000000020000000000000200000000000000061000000000000000000000000000000030000000000000060330000010033005000000000000000001030000000
000444000000000000000000000000000660000400000053000000000000000000000000000600004240000001000000000000000000330000000000000010030000000033000300000000400100000000000000
000000000000000000000000000031033330000000333033000000003333333003000003333330000030001000000300000000000331300000000503300333330303333333003003303000000000000000000000
000000000000000000000000000000000000000060000000300000000000100000602000000000000020300000000000000000000000000000000000000003000000001000000000000000000200000000000000
000000000000000200010000000000000000000000020000000000000600010000000100004000000000000000000000100000000500000000000000000000000000000000000000030000000000000000000000
331100000000003300000000000200000010000100300000000000003300000000000300000000001000000000030000000000000331100000001001000000000000003111003311300000000000000000000000
000000000000003300000000006600000000000100330030000000001400000000600000000000000000001000003003000000066000000000000000000000000000000000000000000000006600020000000000
000020000033003300000000006601000000003300300000000000000300000003030000000100000000000000033000000000165000030500000000000000000000010002000000000000006600033000000000
000000000033003300000000006600000003000300330000000000003300000000330000000000040000000444033000000000060000000000000000000300000440003000000000000410006600033000000000
333333333333003333333333333300100003333300333300300100003333003333330010000000000000000000000333033333333331333300000000031000000000003333333306003333333303333600000000
