000000000000000000000000000000020000000000000000000000000000001010000000003000000000000000133000000000000000000000000000000000010000000400000000000000000000000000000000
000000000000000000000000000000000000200000000000000000010100000000000000010000000000030000002000003000000000300002000100000000000000000000000000000100000041010000000000
000000000000000000000000000001110306630100000000000000100110030003003000001000000000001000006000000005000000300000000000000000000000110111034000000360000001000600000003
000000000000000000000000000000005006610000005000000000000000000000000000010000000000000000066000000000000000000006100200000000000000000000000000000660000030000000000000
000000000000000000000000000000000006630000000000000000000000000000000000002001000000100000066003010000000030000060000000000000000000000003000000000660100000010001000303
001444000000000000000011100020000006100000101444000000103020000000100000000000000030000000036000000000000001444016000300300000000000100300101000000600000000000000010400
000000000000000000000000000033333310003333000100033303333033330000000033333330000030503303033303330000303000010033333331303333000000030313333333333333033330313300000000
000000000000000000000000000000000000003000060000050033000000000000000000000000000000000000000000000001000000000000300000000003000000000000001100000000000000400000000000
000000000000000200000000000000000030000000000030000000000200050000000000000000000010000000000000000000000000060000000000000000000400000000000003160000100000000400000000
111110000000006600000011000000010000110000000000000000006000100011110000000000000300000300000000000111100000000000000303003000011005000000001101110000000010000000000001
000000000000006600000000000000006000000000030100000000506603000000000000000000000000000000030060000000030000000000000000100000000000300000000000000100001000030000000000
000000000000006600000000000000100000500030000000000000006000000000000000000000000000000000000000000000000000000000500000000000000010050000000000010300300003000000000000
200000000000006600000000000000000000000000000100001110006600000203000000100001010443010100000000002001000100000000140000000000000000001000002000000000000001110000000000
333333333333333333333303333000000003030300000100010000013333333333333300001000000000000000000000003033031330333300000000000031303303000000003303131000310000000010000000
