000000000000000000000000000001000000000000000000000000000000001000000000000000000000160000000000000120000000000000000100010000000003010000000001000100001000000000000010
300000000000300300300000000000000000000010000000003003003000000000004000000010003000000013000000000000000003000000000000000000100000000000000000030300000000000000000000
000000000000000000000000000000000003010000000030000001000000100030000000000000000100003000000000000001000000011000000000000000000006000001300000000000000010000000000000
000000000000000000000000000000000000000000001000003500100000010000010000000000000000030000000500000000030020000000100000000000000000000000300000010003000001000000000000
000000000000000000002000000000000000000000000000300000050000000000000000000000050030000000000000000000000650000000000000000000000000000000000000100000000305000000000000
000000000000000000000000011100000000000000000001100060006000111000000000000000000000000000000000000000010600000000000000000111003000000000000000000000000000060000000000
000000000000000000000000000000000003000000000000000100000000000001000003303003333333000000000000005000000333330300000000010000300000030330000500000050000033133000000000
000000000000000000000000000000000000000000000000400003100000000000000000000030000001000000000000030001000000000050000000000000000000000000000000001000000060000000000100
000000000000000000000000000000000000000000000000000000030000300000000000000003000000030030000000000000000500000030000000000000000030000000000010000000000000000000300300
000000000000000000100000011100006040000111000000000000000300000000011100100000000000000030000000000000000000010000000000000111000000000002000000116000000000001000100000
000000000000000000000020000000000000000000000000000000000000000000300000000000000000000000000000000000000000000000000000200000000000000000000000100000000000000030000000
000000000000000000000660000000000050600000000002000000000000002660000100000010000000050000200000000300000000000300000006600000006000200000003600000000000000000000300002
000000000000000000000660000001000006600000000000000000000010020660000000001000000000000000000030000000000000000000010000600030000000000000006000000000001100046000000003
333330000000003333333333333335333303333030330003000040000030000303301330000000000000000001000333000000000633030000000003033333100000033333030333330000000030033330000003
