000000000000000000000000000000000000600000300000000000004000060000000000000003000000000000000030000000000000000000000003000000000000000000000000000001000000000000000000
000000000000000000000000000000000000000000000306000000000000000000000000001030000000000000000000030000000000000000000000000000000000500000300005000000000010003000000200
000000000000000000000000000000000000003310300000000000000000000000000000000003000510000000000033000000300600000000000003505000000100000200003000000000001000000210000000
000000000000000000000000000000000000033300040005000000010000000000000000000003100000001000000333600000303005000000000000306000000003313000103300360004033300000000030000
000000000000000000000000000050000000333330000000000000000010000000000000000000300000000000032303000030050000000000000000000000000000000000000010000000003000000000000300
000000000041100000000000111100000000300100000000000000220004110000000200011010000000000000003303000000300000011000011111000000000000003000000000000000000000011110000050
000000000000000000000000000000000003333330000333133303330000010230330000000000053303000000030303333303000000000000000000003033633300000000000033333030330000000300030000
000000000000003000000000000000000003000001000000000000000000000000000000000000000000002100100000001000300000000000300000000000000000000000000000300010000000000000000000
000000000000000000000000000000000000000000100000000000000000000000000003000000013000000000000000062002000000000000000010101000000000000010300000030060000000000000000000
000330000000003000000000000000000300000000000000300000000000000003330000300000000000003000000000300000000301000001030000400000000300100000000001000000300000000000000000
003330000003333300000000000200002000010010001100000003330101000000330000000000000331000060000000020000510330000000333000000200000000003000000000000003000010030020010000
333333000000000000000000000000000000003000000001000000000000000033333000000001031000000000000000000000000000000033333300000000000300000000000000000300003000000000000010
033333000000000000000000002200041110000000100001000000000000000033033000000000000000000111300000220000000030000503333300004030000022200000000000000003323000300220005010
333333333333000033333333333300000000000000000000033333000000300333303300000003333000000000030003330000000000333333113330000000333033301000000000000300330313303300300000
