303000000000000000000000003300000000000033000100000000050000000000300000000000000000001000000000003000000000000000030320000000004030300000000000000000003300000000000000
300000000000000000000000000000000000030000000010000000000000000000003300000005000000310000000003000000000000000000000000000000030000000000000000000030000030000000100000
000000000000000000000000000000000030300000000000000505302000000003300100000030360000000030000000000005000000000003000000300000630305000000000000000000000010000000000303
050000000000000000000000000000030000000010000000000000000000000000000000001000000000000003100010000000050000000000100000000000000000000000000000200000000000000003000000
000000000000000000000000000030000001030000000000030000000030000030000000000000000001000000000300000000000000000000000000000000003000300000000000000000000002100004000000
500000540404004000000000000000000010600000014040040001004000000030000040000000000000000000500401004000000000000000000300003000000000140000000000000000000000000000000000
000000000000000033330000000033033330000000000000000033300100000000303000333300133000000000000000010003030000000000001000330000100003300333000333003010100003303003303333
000000000000000000000000000001000003030003000000000000300000000000003030000000000000000000000000033000000030000000000000000000001000033300000003010100000000000400000010
000000000000000000000000000000000003000000000000000000600000000000000000000000000010000000003000000101000000010000000000000000000000030000000000000000000030000000000000
000000333330011000000030000033030010000001430001010000001063000000000000000010000000101000001000030300000303100015100010000000000000300000000000003330000000001000000100
000000000000000000000000000000000030500300000000000000000000000000000000023000000000000000000010000000000000000000000000600100003000000000000000000000100015000000000000
300000000000000000000000000000003000000000000000000000000000030000000000010001000000000000000000000000000000000000000000000000030000100000030000000003000000000000000000
000000000000000000000000000000000000000605010000000000000000000000100050000050000000000010000000000000000000000000030000040400000000350002004000025000000050000053040500
333333300000333330300033300020000030000000033300033300000100300000003100000003330303033030033313030333000000003313003001000000333300330000000033330000003300000000000000
