000000000000000000000000000000000000000000000003000000000000000000000000000000000000000000000000000010000000000000000000000000000002010000000000000000000200000300000000
000000000000000000000000000000030000000004000000000000000000000000001100000030000000000010300000500000000100030001000000003000000000010001000000300000000023000000000000
000000000000000000000000000000001050030000000000000000000000000401000000000200005005004000005000000000000000000001000004000000004000000000004500000000000000000000000000
000000000000000000000000000000000003000000004000000003000000000000500000000000000000000600000000000000000000000000000000000000000000000000000000000100003000130000000000
000000000000000000000000000000000003030033030000000030000000000000000000000000000000000000000000030000000000200000000000000000000100000000000301003000000000000000100000
000000000000000000000000000000000001000120000000000000000000000000022000000000000000000020000000030100000000030000000000000003000122000000000000003000000000000000000000
000000000000000000000000000031333033333303000000000000000000000303333000000010033330333333033000333303331000000000000003333333033003303000000333333000000001010000000000
000000000000000000000000000010000000000300000000000000000000000000000000000000000000000000300000000000000500000000000000000000000000000000000000000000000000300000000030
000000000000000000000000000000060000000000000013000000010000000030000001000000000000000000000000000000000000000300000000100000000000010000000000000000000000000000000000
404000000000054500000003000040400000000000450000000000000000000000000045006000000000000000000300000110000000000000000000000000000000000000000500000000000540400000000000
000000000000000000000300000000000000000000000100000000000030030300000000000010000000000000000000000000000000000000000000000000000000000000003000000000100301000000100000
000000000000000000003333000300000000000010000000300000000000000033001300050030000000300000033006030000000050030000000000001000000000033000033300003000610000000000000000
000022000000000000003303000300002000000010000000300000000000000003000300000030000010000000000300036010000030000000000000000000000000030300033030000000000000002000115000
333333333333333333333333333333030030000010333003300000000000000333333000333130000000000000060333330000000600030000000000103000330333033303333033033033033333333000000000
