000000000000000000000000000005000000000000000000000000000060000000060000010000050333000000000003130015000000000000000000000333000000000000000000000100000000003300000002
000000000000000000000000000000000002000000060000000010000000000000000000040000000003000000000000300000000000000003000000100303600000005001000000000000000000003300000000
000000000000000000000000000000000030000000000000000610000000000001000000000000033334000010000333000000000100004000000000030300000003000350000000000000000000333300005000
000000000000000000000000000010000030000000600000000000001002000000000000000003333300000000003333300000000002000000005000303330000030000000000000000000000003333300000000
000000000000000000000000000000000030000000010000000000030100303000040000003003303100000000033333330100001000000010000003333303200030000100000000000000000030300330003000
000000000000000000000000000000000000000000000000000030300000030000000000000223303000000100030333000000003000300000000003303000200000010000220000000000000433330000000650
000000000000000000000000003300000013130330000000133403333333033000000035303333310000000000003000300010200343033300000003330000333533333333330000033000000003300001000000
000000000000000000000000033300000000000320000000060000000000000000010000000000000003000000000100002000000000000000000000000050000000000000000000500000000000000000500000
000000000000000000000000033300000105040313000000000000300000000000010000006000005005000000000000030000000000000000000300000030000000000300000000000003000000006000000000
000004000000000000000003333000000000033330000030000000000000303000000000100000000000000000600000000000000000000000000000000000000000000000000030000000000030000400000000
000000000000000002000333333000000003333100000000000000000000000000000000000000030000000500300000000300000005000000403000000000000000000026000002000000200000000040000000
000000000000000000003333333310000000333303033000300000000000000000000000000000000104000300300010003030000000300000001101300000000000000000030010000000000000100000000003
200000000000220003033333330000000503303300000000001000223300000100000026000000000000000300300000220000000000000000000000000006000000000060330000020000303320000000100000
333333333333333333333333000000030003130000000003303333330010000003000003330333000033131330330300300000063000100000000330000000000000003333330303330333303303033330000000
