000000000000000000000000000000000000000000000000000000000000000000000000000000000000000050000000000000000000001000000000000000000050000000000000000000000000000000000000
000000000000000000000000000000000000000000000000300000101000000000000000000000000000000000300000000000000000000200000000030000000000000000000000000200000000010000000003
000000000000000000000000000000000600000030100000000000000000400000000000000000066000000000100000000003000000306600000000003010000000300000000030100000000000600000003000
000000000000000000000000000000005651000000000010000000000000000000300061000000066100000000000000000003000000006600000300000000000000010000000000000000000000000000003000
000000000000000000000000000000000660000000000000000000003000001000306000001000066005000000000000006300006000000600000000003000003000000000050000000000000000060000353000
000000000141001110000000000100000660000000000000000141300000001030000010000000160000001010011100000303003000036600000010003000030002000140011000000110000000660000303000
000000000000000000000000000003303303000000000000000000000000003300033300000303333303000000000000003333333000333300000003300333030303300000303333333000000000333333333333
000000000000000000000000000000101000000000000000000000066000000000000000000000000000000030000100200300500000000000000000000000000000010000000000000003000000000000000000
000000000000020000000000200010000000000000000000005020000000000000000000400000000000003331000000000002010000000110000000000002000050060000000300002000060010000000000100
000300000000660000000006600000030000000000000020000663060000000000000000000000000000000301001000000066000020000000660000000016400000010000000000006000000031030000000000
000300000000660000000006600000030000000400000000000160000000040000006000000010000400000000000000000060000000000000660000000060000600300000000003006000000000000000000000
030300000000660000000006600003030100030000060003000060000000000000006600000000000000000000000000030066000000000001660000000060000010000000000000060020000060000000010000
030300000000660000020006600003030010000020010000000660000014101000006300000201300000000100100003200066003000000000660000006060111000030000000000036100000000101000100000
333333333333333333333333333333033033303033010000001333030000000333303333033330000000000000003303030333333000000033333033330633000010000000013303033000000000000000000600
