003000000000000000000000000050000001000000100000000300000000100003000000000300000003000003000000000000010000010000000000000000030000000000000000200000000010000000000000
000000000000000000000000000000001100000000100000000000000000010000000010000000000000000020000000500030000410011000000100001000000055000000000000000000010000000000000000
000000000000000000000000000000000000100000000000013033000011000000010000001000000000000000000000000200000030000003033300000000000000000000004000040000000000000000330330
000000002000200000000000000000000005200021000000100000000000000000000000000000000020010010000000000000000000100010000011000003000000003001000100020006100000000000000010
000000003333033000000000000000006000333303000000000030001000000000000003000000233000300000000000100000000100000000000000000000000000030000000003303100000000000000000000
000000000000000000000000000000000100000000000000000000000000000000300000003000000100000000000000000000300000010000000060000000000000001000000010000000000000000000340000
300000000000000000000000000033333330000000300000033300330333033000100030333000000000000000033300033030000333300333300330000000033010300000000000000300010000000003311043
000000000001000000000000000000000000000000300000000000000000000000000000000000000000000005000010000000000000001000001000010100000000003300000000100000001000300000000000
000000000001100000550000000000030500000000030000000000004000000000000000005500000000000000000000006000000000000000001100000000030000300000000000010000005000001000030000
000000000000000000000030333000503000000600000000000000300103300000000000010000000000000000006000100000000030330030000000000000000000040000030300000000000000000000300000
000000000000000000000000000000000000300000300000000000000000000000000000000000000000000000002000204000000000000000000000200320100300000000000000000000000300000130000000
000000000000000000000000000000000103000000000000000000010000000000000000300003000000000001013333030000000000000000000001333401000000000000000000001100000000000000000060
000000000000000000000000000000000030000000000330000010000000000000000003000300001100000000200000000000300000030000000000000000100040000000000000000000000000000000000000
303330033333333330003333003330300030000000000000000333003000033000000033300036005000000000000001000033300330003133330330000000003030130000013333330330000000000003033300
