000000000000000000000000000001000000000000000006000300010003000000000000000000000000000000000000000000000000000000000001000000000000000000000001006000004000000000010000
000000000000000000000000000000000000000000000000000300400000000000000000000103000003010003000000000000003000000000000000000000000000000000006000000003300000001000040000
000000000000000000000000000000000000000000000000000330300000000004000000000000001000000000000000000033030001000001000000000000000010000000000000000000000003360300040000
000000000000000000000000000003000200000000001000000000600000000000000000000000000000300000000000000000030000000000000000100000000000000000005000000000000000000300000000
000000000000000000000000000000000000000005000000000003330020040000000000000130000000000000000000003010036000003600000001000000000010004000000600000000000030003336000000
000000000000000000000000000000000000000000600005500003300000000000000000033230000055000520000002000000303000030000000000000000000000000000000000000000000000001330000000
000000000000000000000000000000000000030300333333030003030100000333331003033033330333000000000000003303303333030000000000000000000000000313330030303000000033033303030033
000000000000000000000000000000000000000000000000000000000000030100000003501000010000000000000000000000000000000000000000000000000000000000000060000000000000000000000000
000000000000000000000000000000000000000000000000000000000000500000000000500300000000000000000000000000000000000000300000000000060000000000000000000000000000000000000100
000000000400000000000003303000000000050100000000010000000000100000000000330100000000000000000010000000000000006000000000030330000030000400000100000000100000000000000003
000000000000000000000000003000000000003000000000000100000000000000000000000000300000004000000500000000030000000000000001000030000360000000100300100000000000000000000000
000000000000000000033300033310000002300000000000300000330400000000000010000330000000000000000000000000003300006300000333000033000000000000100000000000000000000330000000
000005500000000000333000033300000010000030030000000003030000006000000000003330000000010000000000550000333000000000003030005333000010100406030000000000000000003330000000
333333333333333333333330333300000003333330000000030313330000300000000033030030001000000000030333330333030001000033333033303310010010033333300000000000000003303330000000
