000000000000000000000000000000040010000000000000000000000000003000000000000000000000300000000000000000010005000000000005000000600000030000000000001000000010300030000000
000000000000000000000000000010000000000600010200000000100000000000200000000000000010000100030000000000201000200000100001000000000000000006000000000001000000000000010000
000000000000000000000000000060000000100000003100000000000000000001100000000000000000000000000020000001000101140200020000000103000000000000000000010000100010410000603000
000000000000000000000000000000001000000000000000000020000000300000000000001000000002000000000660000000000000006000660000001000000000000000000000000000030000004001000500
000000000000000000000000000000000000000000000000000660000030000000000006000000000000000000000660000000000000000000610000000000000000001000000005000000100300000000000006
000000000011111000000000000003011110000010030020000300001000000000000000003000301111100000000600000410050000000020060000005311000000014000000040000010200000000000000000
000000000000000000000000000500000000000000030333133333030000500033333300003053000000000000003333303335333033333033300330000001000000000000000000045303030300000000000000
000000000000000000000000000010000000000030000000000000000030000000020000010000000000030000600000000000000000000000000000100000000500000000000020000030001000000000001000
000020000000000002000000000000000000000000000000000000000000300000000000002000000000000011000000000001000000000000020000000000000020000000000000000020000000000000002000
000110000000000011000000200000000000002000000110000000000000000000001000011000012000000000000300000000030000000001110040000000000100000000000000000000200005000000000100
000000000020000000000006600000000000066000000000000000000000000300000000000000003000000000000000000000000000200010000000400000000000000320000300003006600000020004000000
000000000660000000000006600000000000306000000000000000000000000006000000000100066000000000003000000020000006600000000000000060000000030660000003040006600000660060001000
020200000660000000000006600000000000066000020200010000000000006006601002020000006000000500000001110000000002600000003000000000020200000660300001141016600001630110000000
333333333333330333333333333300000003103303333333300000000000000303003311003333333333000000000000010000500330033103033330000005330033033313331000000303333330033030330310
