303300000000000000000000003000000000000000000003000000000000000000000000000003033000303300000000030000000000000000060010000000000300000000000000003303300100000000010000
000000000000000000000000000000000000000000300000000000000000060000000000000005000060000000000000006000000000600000000000000003030000000000000100000000000000000000000100
000000000000000000000000000000000000000010000000000400000000000000600003000000000000060003000000000000000000000000000000000000000000000060000000000000100001000000010100
002000000000000000000000000002000000000000300000000000300000000030020000010000020002002000000000000000000000500000000000000000002030000000000000000002000060000003000000
000000000000000000000000000000000000000000000003000003000000000000000000000000000000000000000000400000010000000000000000000000000030000000000000000000100060000000000063
011100000111100000000444000000000020000000444050200111100000001001101000030000211000011300010010000002030001010001111100000002010100000000000000001010100500000000220000
000000000000000000000000000010303333333330010000001003003330303000000003203330000000000030000000033305331000000000000003333333100000000000103300303000000000000033303300
000000000000000000000000000000030001010000303300000000000000000000500010000000000000000000000000003000001000003000000000000000100030000000000000000000003000000000000000
000000000000000000000000000000000000100000000000000000000000000000000010000000000000000000000000010000000000000000000050000000000000003000006000000000030000000000000000
000000000000000000000001110000101000000000000000000300000011003000000000000000000000000000000000000011000005000000100000003000000000006000000000000000000000000030000000
000000000000000000000000000003000031000000000000000000000000100010000000000000000000000010010000003000300000003000000000000000000000000020000000000001000000000000000000
000000000000000000000000000000000000000030000000000030000000000000000300000000000003000000000000000000000000000000001000000300000000000000000000000000000000300000000000
000000000000000000002022000002200000100000011100000000000020000044000000000000000001000000000100000020360130360002200000000000444030001005000000030444000030000000010110
333333300000033333333333333033133310000000060000000000403333030010000000010030050000000000003303303330030000000030333303333333003100000000133333003330000000000000000000
