000000000000000000000000000000000030000000000000000000060000000000000000000000000503000000000010000000001000000030000000000000000000050000003000000104001000000000000000
100000000000003300000000000303000000000000000000010000000030000000003300000000000000103000000000000000003330003000000000000003001000000000330000000101000000000006030006
000000000000000000000000000000000003000100000033300000003000333000033300000003300000003000000000010000000000300030003030000000000100001003330001000000000000000003000333
000000000000000000000000000000000003001000003000000010010030010000303100000000000010000002000000000000000000000000300000000100100000000103333000000000000000000000030000
000000000000000000000000000000000000000000003030000000000003300003333300000000000000000000000000000000000000000000133000000000000000000333330000000000000003000400003300
100000000000000000000000000000000000000000000000000006000000000033330300011000000060333003000000000000000020000000000000100011330003000633330000000030000000000000000000
000000000000000000000000000000000003300000000033300300000000333333103300003013300000003333000000400060000000000000003330000000003331033331300003000003333030000000130330
000000000000000000000000000020001000000040000000000000000000000000100000000000000000000000300000000000000004000000000000000001000300100000000000000100000000000000000000
000010010100000000000000003300000331000010010000000000030000000151000000000003300030100010000001000000005000000333000000000000000010010000000000100000010011000005300000
330000000000003000333000033300003300000000005000000000000000000400000000000000000000000000033000000010330000033300000000000000330000000100000000333300000000060000000000
300000000000000030000000333300003030000000000000000000000000000001000000000000000000000000030000000030000000333300000000000000300000000000000001033300010000000000000100
000000000000000333300003333300333030000000000000000000000000000030000000000330000100000000030002000303300300330300000000500000000000000500000036333000000000000000000000
000000033000000000000033333303003333000000000000000300000000000331001000000040000300100000000000000000000033303000000010000000000000010000003030333000000000000010000000
330000000333300000333333333330003330033030000000000000000000000003003100000003000000000000033000000000333030333001000000300000130100013000033303333330000300000000000000
