000000000000000000000000000000060000000000000000000000000000000000030000000000000000000000000000000000000000000010000000000000000000000050000000000050300000600000000300
300400000000000000000000000000000000000001000003000000000200000106000050000000001000000000600600003000000000000010630000000001030000000000000000200000000000000000000000
000000000000000000000000000000000030000000030000000000000300000030000000000003000000000100000000003300004333303000000010000000000000000000000000000333333000000000000300
000000000000000000000000000000000001005000000100300000000000000000000000000300000000000000000000300100000000000000500000000000000000000003000010000000000000000000000000
000000000000000000000550000000000005500000000000000100000000000001000000300005000040001000500000000000000000000055000000000060000000000012003000000000000003000000003100
330000001111000000000003000001100006030000000000010000000111100000000000000000000000003010000311100030003000003000300000000020010110000000030000400000000000000000000000
000000000000000000000000000000000000000000333033300000000000000000000030303330300000000310300030000303330000000300010003333333000000000000010000050000000033303330333000
000000000000000000000000000000000006040000000000000002000000300000050000000000000000000000000000030000000000000600500000000000000000000000000000010010000001000000000020
000000000000000000000000000000000060000000000000031040000000000300400000000010000000300400000000000000000000000030040005100000003000000000000030000000000000000003000000
000000333333300000000000000000300030000000000333000000000000005000000004000033313030001000000000030000000000000003000000000000330133000000030000000000000000000000200000
000003000000000000000000000050000330000000000000000300000000130030000000000000000000000000000000060001000000000000000000000000000000000000050001300000000000000000000000
000000000000000000000000000000000003000000000001000001000000000000000000000000000100000000000000000000000560000000050000000000000006003000000000030050000000000000100000
000000000000000000020000000000000010000000000000030000000000020130000300000000000000330000000000000000000000000633000000000000000000000000000000000100000001011003000000
333300000000033333333330033330030003330030000000000000000330333000000033330000000003003000033000001000333030000000000003000330000000000300003033033000000000003000000000
