000000000000000000000000000000000300000000000000000000000000000000000000000000000001000000000000000000000001300003000000000000000000000000000000000000000000000000000000
000000000000000000000000000000001000030000000000000400000000000000000000000010000000000100010000000005001011000000000000000000100000010000000000500000300000000000001001
000000000000000000000000000000002001000110660000000000000600300000110000000000000000000000000000000500000000000000000000000110000000000000000001100000000000002006600000
000000000000000000000000000000036003000000160000000000006000300600000300100200000000003000001000000000001000000000000001000060004000000000000000100000000300006006000000
000000000000000000000000000000100000103000660000000000006600000026000000000000010000000000000000000000000000000000000000000004030000000000001000010000000000005006000200
000000000000000000000000000000061120000000600000200030000023002012000000000000000000000000030000000000000000000000000000020000000000010000001020000000000000066026000002
000000000000000000000000000030334303323330030333300000003303300330303003303000000100003001030333030000000000000000000003330330000100000336333033300000000010333333331333
000000000000000000000000000000000000000000000000000000300000000000300010000000000000000000000600000000000000000000000000010030000000000000000000001030000000000000000300
000000000000000000000000000000100000000000000000003500000000030000000000000000000000001000000000000001000000000000000010000000000000000100000000001000000000000000000000
000000000002006600000000111003600000000000001000000000000000010000000000002000000000000000000011000603210360000066300010330000500000000002000000000000000030010000000000
000000000066006600000000000000000000000010000000000000000006000000000000060000000000000000001000000006600660100066000036050300000000050066000000000000000100000000000000
000000000066006600000020000000000000000000000000000000000000003000000000363000000000000000002100000000600060000066000000000000000000000066000000000110000000000000001300
000000000066026600002002000000000003000000000000000100000000000000000000063120001000050000000000000006602660000266000020000000003100000066020000000000000000000000000000
333333330333333333333333333003333330000000000000000030000000000000000030633330000000000030003030303033303330333301313030000000000100030313330000000000000000300103303030
