000000000000000000000000000000000000030000050000000000001000000300000000000000301020000000013300000000000010000000000000000000000000600000000100000030000000000001000000
000000000000000000000000000000000000000000000000500000000000100000000000000055000000000000000000000000000000000000000000003310011000000100300000000100010050000010300300
000000000000000000000000000003000000000000000000000060300000500000000000000000003000000000003030000103000000000000000000033000000100000000000003030033300000000000000000
000000000000000000000000000010001040030000000000000000000000000001000000000003000000000000000000000000000000000000000000000000000000003000000003000010000000000660000001
000000000000000000000000000000000000000000000000000000001001000000000000000000000003000000000000330106003000000000001000000033000000000000000000005000003300000030000000
000000000000000000000000000000000030000000000001000000500100000000000000000000000000000020000300000300000000000000000000000003000000000000000000000000033300000000000000
000000000000000000000000000000000000000040033001103033040033333000000000000000330333300303330000333500000000000000000000301033000000000000006000000310003333303130000000
000000000000000000000000000000000000000000000000001000000000000000003000000000000000000000000050000000000000000000000000000000000000000000003000000001000004500000300000
000000000000005000000000000000000000000000000300000000000000000000000050000060000000000000000000100000000000000050000000000000000000000000000000000000000000000000000000
000000000000000000000033300050000003330000000000000000400000000030000000000000000000000000000000000030000000000000000000000000000300000000060000000000000100030100000000
000000000000000000000000000000004000000000000000000000000000010000000000000050000000000010003000000000000000100000000000000000000003000000000000000000000003000030000060
000000000000000000003000003300051030000033030060000000000000000000003300000000000000000000300000000000000001000010300030100000000000000000000000000000000000000100600000
000000000002000000000000003300010000000033000000000100000000200000103000000000000000000000000000000000000000000001000000000000000000000000000000000000000030000000000000
333333333333333330333330003333300300300031000000000000003033033300000300060000000000333000030000000000000031333333000030000000333033303333330000000333503300000003303303
