003000000000000000000000000015000000000000000000000320000000000000000000000000100000003000000000010000300400000000000013000000003000000000000000030000004000010000000000
000000000000000000000000000000000000003000000000000000000000000000000000000000000000000030001000001000000030000400000000000003100000000000000000000000000000000001000000
000000000000000000000000000006000003030333100000000000000000100000000033303033000100000000000000000030030000000000000000000000010000033004000000000000000000000003000000
000000000000000000000000000000000000000003000030000001000000000000010000000000000000000033000003000000000000000000300000001000000000000100000000060000000000001000000000
000000000000000000000000000500000000000003000000000000000000000060000000000000000002000000000000050000000030000000000000000011000000000000000000000000003504400000000000
000050000030000000002530000300030000000000520000300000100003000000000200300000000000000051000000030101002000000000000000003060000050100030000000000330000300002000000500
000000000000000000003333300000000000000003333003000000000050000000000300000000000000000010033330010000043000000003000000000000000000000000000000000213000000000103000000
000000000000000000000000000000010013000000000000000100000010000000000330000000030000000000000001000000001003000000000003000000000000000000100000001000000000000000023000
000000000000000000000000000000000000000000000000000000000000600000000000000010000000000000000000000010000000000000000000000000005000000000000000006000000010010000050000
000003333303333300000000000000000000000000000001303200000000000000100000000330000000000000000000333000300300000100000001000002000003333303330000033330130300000000000000
000000000000000000000000000000000010000000000000000300000003000000000000001000030000000006000000000002000000000000000000010000000003000000000000000000000000000600000000
300000000000000000000000000000600000001000000053310000000000005000000000000003000000000000030000000000000110000001000330000000300000000000003000100000000000000000030000
333300000000000000000000000000000000000002331000050000005100003000001033330000000500050300033330000000000000000003000030000000330300000000003063000000000000000020003000
333300000000000000000000000000000000000003333310000300003333000006000030001000000000000000033330000001000000100000330000031003333300000400003333000000000000000330003000
