000000000000000000000000000000400000000000000000000003000000005000000006000000000000000300000000010000003000000000000000000000000000000000000000000000000000001000030000
000000000000000000000000000300000000000000040000003000000000000000400300002000000000500000030000300000000000000000010100003000000000500030000000000000023030000000130000
000000000000000000000000000000100000100000000001000006200005000000000000066030100000000060000000000000000000000000000000006000000000000000000000100000660000000000060054
000000000000000000000000000000600000010000000000300066000000000000000000166000000000000200001100010000000000000000000000300000001010000000000000000001660000000600000010
000000000000000000000000000000000000000030000000000066000000000000000000006000000000000660000010005000040000030000000000000000000000000000000000000000660000000100000000
000000000000000000000000000000000000000000000001020066000000100000000020066030000000300660000660000000000500010000000000000001000000000000010000000200060300000000110000
000000000000000000000000000000030000060000333300353331330000002000000033330000000000363033033003335000000000000000000003333010000000000005000000000300330300030003000333
000000000000000000000000000000000000000030000000000000000000000000000003000000000000000000000000000000000000100600000000000300000000000500000033000000000000000000000000
000020000000000000000000000003050000000000601000000000030060600030000020000000000000000030300000000000003000500000001000000000000000000001300000000000004000000000000050
000660000000000002000000000400000000102000000000400000050000000002000000000040002000000000000300000200001000000000000040000600000000000020000000001000000000000000002000
000660000000000066000000000000000000060000000000000000050000000000000000000000006000000000000000000000030000003000000000006604000000000060000000000000000000000000066000
000660000000000066000000000000000000060000000000000000000000000000000000000000060100006030300000000100000000000000000000006600000000000660000020000000001000000000066000
200660000000000066000000000000000000066000000000000000000100000000060000000000066000000000000000000000010000100000004000006600000003000600050030000000000030000030066000
333333333333333333333303033300000000333013303033300000000100000310533203301030630033000005000030003030353333301330003330033633100000033330333031033000000000000000003333
