000000000000000000000000000000000000000000006500000000000100000000000000000000000300000000000005000000000000100000000000000012000000000000000021000000000000010000000000
000000000003000000000000000300000030000000000000003003000000000000000000000000000000000000001000000000000100000000000030000000000000000000030000000000000000000000001000
000000000000000000000000000000000000030000000201000300000000000000000000000000012000000400000023000000000000000000000000004000000000010000000002011010000000014006000000
000000000000000000000000000000000000002000046600000500000300000000000000100000005000100000000600000100001050000300000030000000000000000300000066000001000000000000000000
500000000000000000000000000000000000002001006400000030005200000000000000000000302000000000000060000000000000000000000000000000000000000030000066000000000051000000001000
000000000011111100000000000000033100022000006300000011110001010000000013000030002000320200200660001100000000000011100000302003301000000000000060000000000100030000005000
000000000000000000000000000000000003333033033303300000000005010003303300000000303300030333303333010000000000000300000000303333600000000000000303303000000000000000030330
000000000000000000000000000000300010005000000000000030004000000000000000000300000000000000000000000000000060300100066000000006000000300000000000000003000000000000000000
000000000000000000000000000030000000000001000000000000000000003000000000000400000000000000030000000000300301000000000000010000000000000003000000000000000000003030000000
000400000020000000000000200000000000003000300000000040010000000000400000000000000000000000000000010000003000200000020000062010000000000000000000000000200000000000000000
000000000000000000000006600060000000000300003005030000000000000000000000600000000000000000000100000000030000000100660000000000000000000000000000060000000000000000000000
000000000020000000000006600000010030000000500000000000000100000000000000660030010000000300000030000000000000200000660000002000000000000000000030000010230000000001000000
020220200220000000000006600000304000000000000000302022020000000300200000600000001111000003000000000001010002200010660000002000100030001011111130001000200000001110000000
333333333333330033333033333300303330030000004000033333330000000333333006333330000000100001000333330001000313333003333300333330003303000000000000000036300300000003330030
