000000000000000000000000003350000000000000000000000300000000000000003300000000000000300003300000000000000000000000010000000000000000003000000600000000000000003010300000
000000000000000000000000000000030000001530000000050000000000000000001000030000000000000000000030060000000000000000000000000000030000000000000605000000000000330000000030
000000000000000000000000000000000000000000000000300000000010003500000000000000000500000000000000000032000000000300000000000030000005000000000000100000000000000000000000
000000000000000000000000000000000001013000000000000000000300004000010000000000000000000000000000000000000000050000000023010000100000000300000000300000000001000001000000
000000000000000002000000000000000010000000000000000021000000000000000000003000000000000000000000000002000000402000000000000000000000000000000002000003000000100000003030
505500000003000000002000034000000030000010505500000000050055130000034000010000000000000030000000000000002005500000000000000002000030000000000000002100000010000000000000
000000000300000000033330000000000032000400000000000000033000000330001000100000001000330000040000003000030000000000003010000003003031000003000010133003000000000300000230
000000000000000300000000000000100000000000030000000000300000500004030000000000000000300000000000000000000000200000000000000000000001000000330000033000000000030060000000
000330000000000000000000000000000000000000000500000000000040000000000000000001000100000000000002000000000006000000000000000000010030010000000000003000000000000000000000
000000000000000000000000000000400000000004000000010000000003000000000000060100000000000000000000000000000000000000000000000020000000600000003000400000000000000000000000
000000000000000000000000000000000000012000000300000000000000000000300000000000000000000003000000000000000000300300000140000000000001000000010000000000100100000000000000
000000000000000000000000000000010600000000000000001000000006000000000000000000300000000000000000000000000003000000000020000000003300000000000005006000026001000000000000
000000000000000000000000000000000003000000000030000003400001300000000030000000000000000000000030000000003000030050050000000000600003000003400000040000000000000000050000
000000000000000000000000000000000000000000003000003000000030000000030000000330003000000000000000000000000013000500000000000000000000033000000300300000000000000030010000
