300000000000300000000000003000000303333000000003000000500000030003000000000000333000013030000000313300000033300000006003330000103333000000300013000030333303300000000030
000000000000000000000000000300000030000001000000000000000000003050000000000000300000000000000000000100000030000000000000000000000000000000000300000000000003000010000000
000000000000000000000000000000002000000000000000000000020000000000001000000000100000000100000000000000000001000001005600000000001000000000000001000000000010000001100000
000000000000000000000000000000000310000000000000000000000300300010000000000000000000000000030000010000000000000000000200000100000000000000000030000000000000000000000030
000000000005555000000000555501355530005000000000530000000005555500000030000000000030000000000005550000000000100010000005000000000000100035055000001000000000000030000555
000033300003330000000000033300000330011000000033000000000300303000000000000000000000000000000003010000000030000000000000000033000100000003330030000000000000000000000333
000000000000000000200050000005000003333303000000000000000500000010000000030003033303000313000043100300000366333001002000010000005333314000003333030000330033000000000500
333000000000000333333333300003000000330101300000003333330333333300000000000303330203300000500000300000000030000100000003303000333000000504300000030000100310500000000004
000000000000000000000030000000000000010000033000000100000000040000000000000000000000000000000000030000000000100000000000000000000000000000030000003400400000000000300000
000000000000000000000000000000000103000000010000000303010000000000000000000000000000000006000000000000000000000000000000100000500000000000300000000000000000000001010005
000000000000000000000000000000000000000300000010300000000000000000000000000000000000000000000000001000001006000000000000003000000000000000000000000000000000000000000100
000000330000000000000000000050000000000303000403000000000000000000000030005550200003000060000050005000000300020030000000000300000000000050350005555000000000000033000000
000000000000000000000000000000000000000000000003300001000000003000033300003330001300000033000003330000000000000500000010000000300000000005330000316000000003003333030010
330000000000000003333333333300002033000000000000000133030303333000100000000003000000000000005000000000200000000000000003333333330000005000030500000000020000000000000000
