000000000033000000030000000000000000000000000330000000000003001021000300000000000000000330000000000000002000603003000000010000000000000000000000000000100000000000000030
000000000000000000000000000000000000010300000000000000010000000000000000000000000004001000300000000000100010060060000000000301000000000000000000000000000000000000001000
000000000000000000000000000000041100000033000000000000632000000002003330041310000000030000030003000050000001000030000000000100000411130000000004101000000000600330000001
000000000000000000000000000000000300000020000000000000000000000000000000000003000060400000000300000000000000000000000000003000000000530000000000010000000003000000000000
000000000000000000002000000000000010003000000000000000020000000000000000130000000000000000000000000003000010000000000000000000000000000000000000000030000110000000000014
000000000000000000111100011100000000033330000000000001113000000053333000000000000000002000000000000000000010000000000000000000000000000000000000000100010110303300000111
000000000000000500000000000033300330000000000000000100000000000000003030333030000000000010000000133333330000203000000003433003333300100100003330303000000000030100500000
000000000000000000000000000000000000000000000000000000000000000000003300000100000001000000000100000000006000000000300001003300003000000000000000000100000000000010003400
000000000000000000000000000000000001000000000000000000000100000000000001010000000000000000600010000000000000100000300000000000000000003011000000100000001003000300000000
000003330000000004111000010030000030000003100000000001003000000005400000000000035000000411100000030000000000003300000030000000060000005000330000000300010000001003050000
000000000000000000000000000000000000510000000003000000003000300000000000000000000300000000000000000000000000000000000000000000100300010000000000000000000000000500000100
000000000000000000000000000000000000000000000000000000000000000000000000000000000000000000000003000000002000000000000020001000000000000000000000006000010100000000000000
003333000000000000000000000010000000000000100011166000106000000000011110010010000000000000100301000000011003333000001110000000300011100333300000035000000000000000000000
000003000000033333333333333300050000000000003000033330030000003000013100000003330313330333300000000000030000013035000000000000000000000006300000000000000303303330000000
