000000000000000000000000000000000000003330000000000000600000000000000000000000000600000000100000000000100000000005000000000300000000000030300003330000000000003000003000
000000000000000000000000000000000003000003000000000000000000000000000000000000000000030000000000000000000000010000000000100500000000000303030033003000000000000000000000
000000000000000000000000000000003000033003000000000010000000000000000000000000000000000000000000030000000100000000000000600000000000000030030030003000000000000000610000
000000000000000000000000000000000503330300000000300000000000000000001000000000000000000000006003000000000000001560000000660000000500033330033330003002000000000010660000
500000000000000000000000000050000303336003000040600000000003000000003000000060000000000000006603005000000000306650000003660000003003003033033330333006000600000003601000
000000000000000000000000000000000003333350000006000000000130000004003301000000000000000000036600001000000000006600000003060000104103303030331333331000003300000003660101
000000000000000000000000000300000003060030303033000000000000000333330300010000000000600000033333330010000303300301000003333333313333330000333030033333533300001000333303
000000000000000000000000333000010300310000000000000000100003030000010003000300100000000000100033000000000000000000000010000000000000000100000000000000500000000000001003
000000000000000000000003300310003000000000003000000000000030003000010000000000000000000000000330000010000000000000000000000000000000000400001000032006000000000000001000
066000000000020000000003300306600000000000000000000000000033003066000000000000000500000006000333030000000001000000000000000002000000100005000000000000000000000000000002
066000000000660000000333330306600000000030000000000000003300203206000030000660000000000001033330000000000301000000000000000066000000000000000000030000035000003000000066
366000000000660000033333330330600000000010000000000010033333303366000000000065000301000006303030030000000000300000000000600066100100000000000000000001000000030000000016
366000000000660000033333333331600003000004000000000000330330333006000000000660000000000003303033030002000000000000000010000066000003000000000000000000000000000006000066
333333333333333333333303003333300333006110000000033030313030013003333333033330000000330333330300330000030000000300200003333331030000300000001000003000000000100003330030
