000000000000000000000000000030000000001000000000010000000000000000000000000000000000000000000000000000000005000000030300000000000000000000000010000000500000000001300000
000000000000000000000000000000000000000000001000000600000000000000000000200000000000000003000000000030000000000001000000000000000000000000000000000000300000000000000000
000000000000000000000000000000000000030000030004440000014030000000000000000000000000000010000000000000003040000000000000000000060100003000000000044400006020000000100003
000000000000000000000000000000000000000030000506000000003000010000005000000000000020000000000000000000120000000000000000300000000000000000000000000000000001300300000000
000000000000000000000000000000050000200030000010000000000001000000000000060300300000000000000000001000000000600000000000000000000300000000000003100000000000000300000000
000000040000000000000000000000000000200030000000020600020000002000000000000001000600000001000000000000000000000000000000010010000000000000000000000000000200000300000006
000000000000000000000000000000003000330333300003330033130033031000000000000003313033300000000001003333333303303300100100000300000000300000050333333033033330033330000000
000000000000000000000000000000000000000000000000000000000000010000000003000000010005000040000000000021000000000050000000000000000000000000000000300000000000000000000000
000000000000000000000000000000000000030000000000000000000000000000030000030000000000000000000000001000000000000000000000000000000000006000000000000000000000000000030000
000004444000000000000000000000000000000005300000000060030000044000000000000000000000300000400300000000000000001000000000400000003004100000000000000000000000000003000000
000000000000000000030000002000000200000000000000000055000000060000000000000100000000000000000030000000005000000001000000000013000000000000300000001000060000000000000420
000000000000000000030000000000000000000000006000001000300000003000001000000300001000000000000000000000030000000000000000000000000000100000300000003000000000000000500003
000000020000020200030000000010000000000000100100010300000010000000000002000304000000000050043000000200030000000000000002000002000000002000300300300000000040003003000010
333333333333333333333333333310030330000003000000050000030033330000000033333030000000333403300000003333333000000000001003033333000303303333330000000600000000000500333333
