000000000000000000000000000000000000000000000000000000000000000000000000300000000000000000000000000000330000000000000000000330000000000000000000000000000000000000000000
000000000000000000000000000000010000000000000000000033300000000000000000000000000000000000000000000003300000000500000000003010010006000000050000001000100030100010000001
000000000000000000000000000000100100000000000000000333300000001100003000201000000000000000000010000000030000000000000600033360000000010203000000000000000050000000000000
000000000000000000000000000000040030000000033000030330300054100030000006600000000000000000000000003333330066000000000000333330000000003000000000000030000000003000000030
000000000000000000000000000000030600000000003000333003300000050000000006600000000000000000000000503333336006500000300003333500000000006600000000000000000300530000500000
000000000000000000000000000000000020000000030003033333000000000000002206600000000000100000000000303333330060000000000003333300000002210100000000000100030000010100000003
000000000000000000000000030000003660000000003333333433300000300333303331033030030000001000000000003013300353336300000003303330033330033103330000000033033310003110050000
000000000000000000000000033000000000000000000006000000000000000000033000000000000000000000000000000000000000000000000000000000000000000000000000000030033000005000000000
000000000000000000000000333004003000003000050100000000000000000000330000002000000000000000000000001000000000000000000000000000000000000000000000000000330000000000000000
002000000000000000000003333000000000060000003000000000010600000003333000006000300000000000010000001000010000010000000001100000000000000010000000000000330000000000020010
066000000000000330000333333000000300000000060302000060000330000333003100001000005000000300000400000300000030000000200000000000010000003300000000300333333000000000660500
066000000000000030003333333000000000000001036000000050000030000033333000000030000000000000000031000030003030000000000000000000000000000300030000000333333000003000660000
066000000000220300333333333000000120000000066000000000030300030363330000000030130003000000000003521300333000000000000000000000000100003033303000000303301600000220063000
333333333333333333333333333003333330000000003330000500003330300030310000000010000010000000033333313033330000000000000000000000000030033033330000000300333003333333333003
