000000000000000000000000000000000030000030000000006043000000000000000103000100003000300000000000050000000000000000000000000000010100000000000000000000000000010000200000
000000000000000000000000000000000001003000010000100000200000004000000010000001011000030000010000000000000000000000020000003000000000000000010000000000000300000000000000
000000000000000000000000000001000003001000000000000300000000000000000000110000300003000000000000130003000030000010000030300000000000060000000000000000000000000030000300
000000000000000000000000000000000130000000001000000000000030100000000000000000000000400000000000330000000306000000001330000000000000000003000000500030000000000330000060
000000000000000000000000000030003300100036000000000000000000000000000000310000030001000000000003330000000000000000103003000001000000000000000000000000000000006333000000
000004410000000000000000000000033330200015000000000000000000000000000002000300000000010004400033030000010000000000033330000000000004400000000000040000000000330010000000
000000000000000000000000000033333333333300000000600000306030000000000033333000030003000000033003330000000100330335333330330333000000000000002000000300001033330300000000
000000000000000000000000000003000000000000000000300000000003000000000000030000000010000000000000001000001030000000005013000000000000000000000000000000000000010000000000
000000000000001111000000000000000001101030500000000000000000000000001000000000003000111100000001030003000000000000000000000000000100011010000000000000031010110400000000
030000000110000000000000000304000000000000003000000000000030000000000340000000300000000000400000000003000000160000000000001010000000000000000000000000000300600000011000
000000000000000000000000003300000000000000500000000000000010000000003300000030000000000000033000000000003400000000000000300000000000003003000000000000000000000000000000
000000000000000000000000033300000000000011000100000000000000000000133300000000000000000000000000500000000000000000000000000000000000000010300000000000000000000000030000
000000002000000000000000333301000001000000000004410000000000001010503300000000000000000000000000000000000300000000000001200000000000000010000000000000000000000000200000
333333333333000033333333333333330330030330100010000000000000000303031300000003033333003333300002000000100103330000000003043300000010000033333333033000401000333330333300
