000000000000000000000000000000000000000001000010000002000000060000000000100000000000000000000000100010000000100000030000033003000001000000000000000000000000000000100000
000000000000000000000000000000006000005550000550000000000000000000030000000000000000000300000000300000000000000000000000000000003030010000000010000000055000000000000000
000000000000000000000000000000000000000000100013000000300300000000100000000000000000000000000000010000000060300000030001000000000000000000000000050000003000000330000000
000000000000000000000000000000000010000000000000000000001000000000000000000000000001000000000000000000000000000000000000000000000000000000000000000000000100000000000130
000000000030333000000000000000000000000000006300300000330000000000000030000000001000113003300000000000000000000030000000000000000000000030302000030003000010000500000000
000000000000000000000000000000000000000000000000000000000000000003000000000000000030000605000000010000000000000100060000000000301300006000000000001000000000300000000000
200000000000000000000000000000000100333333303030300000013100003000010100500002000010000300000000003300003000000000100000000000100010100000000000000000603333330033300003
000000000000000000000000000000000000026000000000000003000000000006000000000000000000000060000050000000000000000000010600000100000000000001000000001000000000000032110000
000000000055500005550000000000000000000000000003000000000000000000000000055500005550000000000000010405010000505000000000000250000200000055000010000000000000055500000000
000000000000000000000000003300030330000000000000000000010001333000000000000006000030060003300000000000000000000006000000000000000303300000000000000000100000000000000000
000000000000000000000000000000000000000000000000000000010000001000001000000000000000000000000100000300000000000000000000000000000000000000000000000000000000000003000000
000000000000000000000000000006000000000100300000000000000000000000103600000000000000000300010000050000000000003000000000000030000000000000000000000000000000000003000003
000000000000000000000000000003020000000000100000010010000000030000000000200000000000000000030005000000000000100000000400000000000000000000000010000000000000000000000000
330000333333333333333333333333333033300000000000020000003333333000000003330333300033033333100000303333303301333303000000023313303333333033302000000060000003303300000000
