000000000000000000000000000000220000000000000100000000000000010000000000503030001001000000000003330000000000000000000000003001000000010000000000000001000010050000000000
000000000000000000000000000030001000000000001000300000000000000030100000333300000060000060000303130000050000010000000000000000000300000000000000000000036000000000030000
000000000000000000000000000003000000000000000010000000000000000000000000333030010000000000000113100000000000300000000000203000000000000003000000000000000000000000030000
000000000000000000000000000000000000000000003000000000000000000000000033133000150030000030030333030000000000000000000000000000000000000000000000300000000000000001000003
000000000000000000000000000000000000000000000000000000000600003001000003030330000000000000330030330000000000000000000030011000001000000000000000000000000300000000000000
000000000000000000000000003300000000000000000000000300330000003000100033333500000000000300333033300000003000000000000030000000000105300000000010000100000302000300000100
000000000000000000000000003300000000100000000000000000303633030013010030333333303303030033033303301000003040000033333300050000000033000000000500000360333333333330000000
000000000000000000000000033300000000000100000033300004000000000001000000000000000000300000000000000000030000010000000000000000000000000000000000330000101000000000001000
000000000000000000000003333300000000000000303003001001000000000000000000000000000000000000000000000000010000000300000000030330000000000000000033330000000000000000000000
000000000000000000000003333300000000000000003101000000000000000003000000000000100300000010000000000000000000000000000000033303000000000000000033333030000000000000005000
000000000000000000000333333300000000000000300330300500000000000000000003000000030000030000000300000000000010000000000003033333000000000000003300330030000000000000000000
000000000000000000003333333301000000000000333333300040030010003000000300010000000000000000000000000001600000000000000003303333000001000000003310313000000000500000000100
000000002000200000003333333300003000200020333300300000030200020000000000000011000033000000002000200000000100000000000003030333320002000300003030303000000000100001000033
333333333333333333333333333330333333303300300333303303333330333000000000003000000033303333033333330000000001000033333330330330333333330000000333313330033300000000000030
