000000000000000000000000000000100006030000000003000000000000000100000000000000000003000300000100006000000000000003000000000000000000000000000000110000000000000000000000
000000000000000000000000000000000000000000000000000000000000000000000000100000000000000000000000010003000000000000300000000000003000000000000000300000000000000000000000
110000011000550000000000000000010001000000000000131000550020000000000040000000030060000000000200002100000110005500000003020000000000000000000000000010000000000004040000
000000000000000000000000000000003000130030033000000000000600000000000000000310330000010000006600020000000000000100300000060012000000000000000030030000000050000000000010
000000000000000000000000000000000000000000300000000000000660066000100000000300000003000500006600660000000000000300300000630306000300000000000030000000300000000000000000
000000000000000000000000000000000000000000003010000000000600166000000000000000030000000000006600600000000000000000000004660060005000100000000000000000000000000000000000
000000000000000000000000000030003300000000333033300030000330303004010133333333300333300133001333300000005000000035300333331330333330000000003330633040000003000003333333
000000000000000000000000000010000003000000000000000100600000010000000100000000000000000000000000000000000000000000000000000000030000500000000000030000000000001000000000
000000000000000000000000000000000100000000000100000000000000000300000000000000500000000000000003000000000000000010060000000000000000010000000000001000000000000003000005
002000000000000000000400000000200000000000400000000000000300000100006511000000000000003000000000030000000100000000000000100000110005540000000020000000000005000001100055
066000200000000030000000000006600106000100000000000000000005050100000000000100000000003000100000050000000000000003000000000000100000000040000660002000000000000000010000
066006600000000030000000000006000060000300000100100000001000000000000000000000000001000000000000000000000000001000000000000000000000010000100660066000003000000000010000
066006600000000030000000000000630660400000100030000030000000000000003000000000000000003000000000000000300000000000001000000000100000000000000660000000000000000000000000
333333333333333330333333333330313011000000333333300000000001000000100010000303333330333033333003310000010000000000030000000000000000003333333330333333003500000000000060
