000000000000000000000000000000000100003403000000000000000000000000000000000000630000000000000600000000033000000000000000000000006000000000030000000000000000000000001004
000000000000000000000000000001100000000000000000000300000000000000000000000500000003000000000300000000330010100000000000000000000000000000000000010000000001110000000000
000000000000000000000000000000000000000000000001030000000000010030110000020003010010000001000000000000300001000000400000000000300000000001100000000310000000001000000000
000000000000000000000000000000000010000002000030000000000000000000000000000003000300000000000600000003033000000200000000000000020000000000000030000300000000000000000000
000000000000000000000000000000010663000000000000000000000000000050010100000000000300000000000000000033333000006600000000403000000040003300000000000000100000000601000000
000000000000000000000000000000000160000511100000000000005000000050000000000003000002000000000000000313303020006000000300003000300010200000000000000000000200000060000600
000000000000000000000000000033335030000000000000010300006000000333333310000000333333033033100000003033303333333300000000000000033303303303530000000333333000333330000000
000000000000000000000000003300000600002130000000000000000000033400300000000000000000000000000000000000000000000000000060000000000003300000001000033000000000000000000000
000000001110000000000000033301600003000333100000000000000200330000000100000000101001300000000000000010000000000001100100000100000033300000000300333000000000000000003000
300000000000000000110000033350000003000033000011000000006000033000000000000000000000000000030000000000000000000000001000300000000333000000000000133000000000100000000110
300000000000020000000000333303000005003333000000010000000003033000000100000000000002000000000000300300050000000000000020023000000050600000000003333000000040000000000000
000000000000660000000003333300000000033333000006300000100030333000000000000000500006000031000033050000000000003000000660000000003433300000000033335000000000000000300000
300000202000660000000333333300000000303303000000030030023303033000000000000000200066000000000001000000000100000000000600000000301333310000003330033000000000003005001000
333333333333333333333333333300000003330333033333300331333333013000000000000003333303000000033313530000000000000013333330000000003003000100003353333000000000000003333330
