000000000030000000000000000010020000000000000000000000300100000000000300000000010000000000000000000001000030100000000000000000000000003000003000003000000000000000000000
000000000000000000300000000000000000000000000030000010003000100003000000000000000000000000000300000000300100010000300000040000000000000000000000000000000000300000000000
000000000000000000000000000000320000000200000000003000000000000000306000000001000300000030640000200000000300000000000100000030000000300000000003000000100000000000010000
000000000000000000000000000000000000006600000000001000000030000000600000000300000000002000000010000000300000000000000000000000000000000000300010005000301000000002000030
000000000000000000000000000000000000210600000000000000000000000000000000000000000000000200100000000000000000050001003000030001000000000010001300000000500010000000000003
000000000000000000000000000000000002006100000000000000000600000000000000000000000200000000000013003030000000000000000003000000300000000000000000000000000100000310000000
000000000000000000000000000000000003333333000001030003300000030000000000000003033333000100030033060000000333033000000001000000000000031333300333333033333050000000000000
000000000000000000000000000000000000000003350010000000000003000000000000000010000000000000300006000000000000300000010000001000100300000000000000000000300000010000030000
000000000000000000000020000000003001030000024000600000000000000003000000000000000000000000000000000200000000000010100000000000000000002000000000000630000000003000200000
400000000002000000000660000000010000000000660000040000050000000000000000002000000000000020000000000600001600000040000000000503000050061000000000000000000000000006600503
000000000066000000000660000000000003000000060000010000000000300000030005000006600000000600000001100000000000000000000000000600000030066000000006600000000000000000603000
000000000066000000000660000000000000000001060000000060000000000400000000000006600000000060000000001600000000000000000000006000000000066000000006600030003001500006000100
000020020066000000000660000000004000000000660000000002000000000000000020060006600000200060003000006600000000000000002002006650000000036000001000600000000001000006600000
333333333333333333330333330000000000001000333330643330030030000331333033306105333500030333300000000003000000000030033333333333030000001333003313333000000000000040333300
