000000000000000000000000000000000000000000030000000000300000003000000000000050000060010000000100000000000000000000000300000000003000100000000000100000000000000000000000
000000000000000000000000000000000000000000020005000005000000000000005000100060000000000000030000000000000020000000000000200000010010000000000100000000000000000000000100
000000000000000000000000000011111000000000600314100000001111100600004100000000000000000000066001410000000000003000010006600141000000000600000000000000000000000000000000
000000000000000000000000000000000000000000660000000000001000000660000100300100010000000000066000000000000000001000000000100000000000000000000000000100030000000000010000
000000000000000000000000000000000003010000600000030000000000000660000000000000000000000300061000006000010000023000000006600000000000000000000000000000003030000000000000
000000000000000000011111110005000000000050660000011010000000000600000011111000000000000000066000001011110200000000000006600000010000000000110130000000000000000110000000
000000000000000000000000000000313330000000331100300000000033033300330000000010000000000000033333030000000300005000033033033303333333300030000000000300000030000000100000
000000000000000000000000000000000000103000000000000000000000000100000001000013000000000000001000011000000000000000000000000000010000500000000030000000000000000000000000
000000000000000200050000000000000000000000000000000101001005000003000000000000000000065000000000000000000000005000000000000000000000000000003000100000060000003000200050
000000000000006600141111110006011000000000100000000000000000000000000000000000010000111100000000500000000000000010000000000000000000000000000000030000060111111000600141
000000000000006600000000000000000000000000000000000000000000000000000100000000003003000000000000000000600000000016100000000000100000000000000000000000000010000100001005
000000000002306600000000000002000000000030000030000001300000000000000010002000000000000000000000061000000000000000005000000200000006000000000000000000000000500000600000
000000000000006600000000000000000300000000000000000000006000000100001100000000000000000000110030100000001000000011011000000000000000000300000000000000000003000106600000
333333330000003333333003333360000003433303000000030100000000000000000000100033331333003333300000003333003000000030000000000000000000003000003330333000000000035330033303
