000000000000000000000000000000000300000000000000030000100000000000012000000000000000000000000000000000000000001000000000011301000000000000010000000300000000000000000001
000000000000000000000000000000001000000000000100131000000001000000300030000000000000005000000000000003000000000000300000000000000000000000000000003300000000000030000000
000000000000000000000000000000004000000000000000030000000000001100001030000060000000304040000000004000033000004001000000000000000000000004034000003300000000002001010000
000000000000000000000000000000000000000000000000030000000000000000010030000000000000003000300000000000013000000000000006100000000000000001000000333003100000000000000000
000000000000000000000000000000050000000000000000030000300000000000000030100300000000000000000000030113033000000011000000000003300000000000000003033300000030000001003000
000000000004000000000000000000000000063010300000000000000000000000000430000100003000004000000000000000033000000000500000001300000040000000000003333020003000000000000030
000000000000000000000300000033300033100000333033300000000000000100000000000303000000130333333000333013033100000300000000000000300000003033033333030000303000040000000000
000000000000000000000300000001000000000000000001000000000030010000000000000000000000000100000000503000000300000030000000000000000000000000000100000000000100000000000000
000000000000000000003300000000100000000000000003000000030000103000000000000000000000000000000000001000000000000000000300000005000000000000030000000000000000000000000000
000000000404004000033300000000000000000000000000040000334000005000000000000000040400000000010000000000000000000030000000300000000000000000330000000000001000400000000000
000000000000000000333300000000000000000000000000000033335000303000000000300000000000000000000001003000000000000030000000000000000000000003330000003000030000000000000500
000000000000000003333300003000000000000006005000000003300000303000000000000000000000000300000000000000010300003000000303000000000001000003330000000000000000000000000010
000000000000000033333300003000004100004300000000001033310033333050000000000000000000000000030000000000400300003030000302000000010000000333100200000000000000000000000300
333333333333333333333000003000000651000100003000033333333303033000000033003330333331000000000000000000000000003003000000000000033333053333333333303000000033333330000000
