003000000000000000000000003300000000000050000003300000030000000000002000100000000000000000000000200000000000000000000013000000000000000300000000000000000000000000100001
300000000000000000000000000000000000300100000000300000030000000000000030000000000000030500000010000000013000000003000000000000000000061000050000000030060000000000000000
000000000000000000000000000003000011100000000000000000000000000003000100000000000600110000030000000000000033000110000000010000000000000000000030000000200011000000000001
000000000000000000000000000003000000100033000000000000000000000000000000000000010030000000300000000000000000000000000330000000000000010000000000000330313000003300000030
000000000000000000000000000000100000000003000000100000000000000000000000000000001000000003300000000000000000000000000000000000001000000000000000001300100000000330000000
500000000000000000000000000000000000003000005000000000001000000000300050000000000000000000000000000010000000000000000000000300000000050000000000000300000000000000000000
000000000000000030000000000000003103300303030000000100000000000033000000000000030003330030300003000300000000001333000033333005003003000000003303000330100033003030030000
000000000000000000000000000000000000000001003000010000000000030010000000000000000000000300000000001000000000000000020000030100000000000100030000030000300000000000030000
000000000000000300000000000000000003000000300001000000000000000000000001000600300000000000000000000000000000001000000000000000000600000100000300000000000000000003001000
003000003300011100000000200003000000000030000000030000001005000033000100010601000000000101010300010000000000000003000010002010000000000500000000000003000000000000306000
000000000000000000033333333330333330000000000000000000001030000000000013003030000030333333000100000020000000000000000060333303000000000000000000000030000000000000005001
000000000000000000033300000030000000000000000003000000010000000000000000000000000533330000000000000000000000000000000043000000001000000100000000000000000000000000000000
000000000000000000000300000030000000000000300000000000000000000000006030030000000000300001300010005000001000000000000003000000000000000000010000000000000000000005000030
333300000003333300303300000030003000000100000000003330000000000300033036000003300303300000033310000010000003000050003333000000000000000000000000000000033300000000000002
