000000000000000000000000000000000010000000000300000000000000003050060000000000000000000000000030000000040000010000000000000000100000000000000001300000000010000000000000
000000000000000000000000000000000000000000000000030000300000000002000000130300000000000000000000000000000000000300000000060000000030000400020000000400000000000000000030
000000000000000000000000000000000011000000000500000000300000000020000000003300000001000000000000100200003000000000000300000000000000000000000000000000000000000000000030
000000000000000000000000000000000010000310000001000333300000000660630000333300000000000000000000016600000002300000000000000000000000000000000000000100000030000000033300
000000000000000000000000000000000000000000000000003033300000030600000000033300000000000000000003006100100000003000000000000001500000100000004600000000603003000000333300
000000000000000000000030000000000000000000030000033333300000000060200003333300000001000000000000006600000030000000000100000000023100000000000000001030000000000603330330
000000000000000000000000000033300330003333000000030303300000000333333303033300050000330333300303000333333000000000040030030333000000030333333333333000000000000003333333
000000000000000000000000000000000000000010000000000000000000000000000010000000000000000000000000000000000000000000000000000003003000000000000000003000000000000000000000
000000000000000000030000000000000000000000000000000000100000000000500000000100100000000003000000000000000000000000000001000000000003000000300000000000000030000000000000
020000000000000000330000000000010000200000000010000000001000000000002000000000006000010003000000000000000000000000000000000030000033000101000000000300000100301000200001
660000000000000033330000000000000006600000000000000000000000000003000000000003100000003013000000000000000000060000000000000000003333366000000000000020000000000003600000
660000000000000333330000000004000006600030000003000000000000000000000000000000030000030330000000000000000300000000000100000000303333066000001000000000030000300600000000
660200000000003333330000000000000003602000000000003000003000000000000000001000000600303333000000000000000000000003000000000000033333066020000000000000003300000000602000
333333300333333333333333333300000003303330000000101000000030000003330330333030000000233030301000000000000000000000000000000000333313303333330000000003333000000003303330
