000000000000000000000000030000000000000310000000000003000010300000400005000000000000000000000000000000000000000000000000000000000000000013300000000000000000000000000001
000000000000000000003000000000000000010000000000006006000000000000000000200000050000000000300000000000000000060000000130030000030000001000000050000003000000000000000000
000000000000000000000000000006000000000000000000000000000000003000000000000000000000500000000000000000000000000001000001000000000001000000000000000000000000000000000000
000000000000000000000000000000000000000000000000000000000030000000300010000100100000010000000000100000630000000000000000000000000600000000000000030000000000003000000000
000000000000000000000000000300000030000003000010001020000000003000000000000610000000000001000000030000000000000000000000000000010100103100000610000000010000000000000003
000000000000000000000000000000003330600000000000030010000030010000000000000000020200000000000003330101000000000003000000000000002020000000300020030000100001000000000033
000000000000000000000000000033303030000020063303003323330000003030633300010000330333000360003003030000000006000006600000003333333333300000003336333005000000303333330333
000000000000000000000000000000000000000000000000000000000000000000000000000010000000000000000000000000000000000005000000000000000000000000000001030000030203000000000000
550000000500000000000000000000000000050000000000000000331001000000000000000035500300000000001000000050000550000060000000000000000000001000000000000000000005001000000003
000000000000000000000000000000000000100600000000000030000000100100001010000000100000000000000000002000000000000000000000000000000000000000000000000010010000000000130600
000000000000000000000000000000000000000000000000000000500000000000000000000003000300010000000000000000000000000000000000000000030000100000000000000000000000010030000000
000000000000000000000000000300000000000000003000000010060000003000000000000000000000000000000000030000000000000000000031000000003000000000000000000000010300100040000300
000000000202000000000000033300000000020200000000000100000000330000000000000000000000000000000000000000100000000000003030100010000000000000000000000000015000000010000000
333333333333330033333333033300000003333003000003030030003330330000000003000003333333000330300301003330300333333303300130000000000000030333000300030000000013313330000000
