000000000000000000000000300360000000060000010100000000001004000000000000100000003003400000000000030040000030000000000001000000000000300003000000001010000000000000000000
000000000000000000000000000000000010000000000000010000060000000000000100000000000000000000030000100000000000000000000000000000000000000000000100012000000000000000100000
000000000000000000000000000000000000300000000444444000000000000000044400000000000000000000044000300004404000000044001000000000000005001004040000000444020000054000000000
000000000000000000000000000000000001000000000000000000000000001000010000000000000000000010000000300100000000005000000000000000030000000000000000000000000000000000000000
000000000000000000000000000060000003000000000500010100000300000000000000100000000000000002000300300000030000000000001000010010000000033006000100000000000301000000000230
000000000004004000000000000000203003000000200000001000000003200200200000000000000000000000000000002000000000000000000004033000000041620000500030000000000010000000000000
000000000000000000000000000030303300000003333333303333000333351330030000000000000000000000030333003030000001000033303000000100000000033333301000000033330000333330000001
000000000000000000000000000000000000003433004000040000000000000010000000000000000002300000000000000000000000300001040000000000000000300050000000000000010000000000000000
000000000000000000000000000000050000000000000000000030000000000000000000000000000000000010000000000000000003000000000000000010410100000100000010110001000000000000000000
000000000044444400000330000000000000005000000003000000004000000003600000000103300000330301000000010000000000000033000000100000000000000000100000000300000000300003106000
000000000000000000000000000000000000000000001000000000000001000000000300000100000001000000000000000003000000300000000000000000000000000000000300000000000000030303000100
000000000000000000000300000000000000000000200000000110030000000000000000000000000000300100000000000010000000000030000000000000000000000000000010000050000000000003000000
002020020000000000000300000000014300000000000000043000006001500400000000004003000000300000043000000100200006000030000000020200000040310001100000400002020040000003300000
333333333333333333300000000000300001005000000000000000003333300000000000000000000000000000000000003333333000000000000003333033000000000300000001300333303300000000000000
