003300000000000000000000000030060000000000013300000003000000000000000010000006033000000300003330000000000000500000000000000000003000000400000000000000000000100013000000
000000000000000000000000000000000000000000000000000000300000000001000000000000000000000020000000000000000000000000000000000000600010000000010000000000100000000000300001
000000000000000000000000000000000000000000000000000000000000004000000000000300000000010000000000000000000000000000001000000000000000060001100000040000000010000000000000
000000000000000000000000000000000000000000000001000000100000000000000000000000001006000000000000000000000000000000000000000000000100010000000000000000000000000001000000
000000000000000000000000000000000000000010000000000000000000100000000000000000000001000000000000000000000000000060000000010100000030000000000000050000000000000003000000
000000000111110000000000000001101100000202001000000000000000202000300003000000000000050013030200000301500000020000000000000000010100000000000603202000000002200000400000
000000000000000000000000000000000000333333003000000000000330333331333000000000000000000000000000000000000003303000000003333333000000013331000333330033333333300030000000
000000000000000000000000000003000010000000000000000100000000000000000000000000000300000010050000006000000000000000000000000000000030003100000030000500000000000000003000
000000000000000000000000000000000000000006000000000200600000001000000000003000000000000000000000000100000000000000000000000000000003000000000000000000000000000010000000
000000000001100000000000000000000000000110000000300000000030300001050000500000000110000000000000000100110000000010100000000000010002000000000030010000000000000005000100
000000000000000000000000000000000000000000000000000000000000000003000000000000000000001000000000000000010000000400000000000010000000010000010000000000000000003030000000
000000000000000000000000000000000000000000000010000003000000100000000000000000000000000000000000010000050000100000030060000000000000000000010000000000000300030000000305
000000000000000000202222000000000300000000000000022220000030110000111020200000000000222000000111110000000000000000010110000202000000002200000000000000000000100010000000
333333333333000333333333333330300001300303000000033033330000010000300033033333033300333003300000003303300333333300100030030303000000003303030333300000000000000000000000
