000000000000000000000000000050000000010000001000010000000000000000000000000003000010000400000000001000000000000000000000030000000000000003000000000010005000000000000000
300000000000000000000000000010000000000000100000010000000000000300000000003000000000000000000000060003000000030030000000000003000000000000000002000000000000000000010000
000000000000000000000000000000000003000000330030000300033000333000000000000000000333001000000000003000000030000000000000500000000000000003330000333300000030003030000000
000000000000000000000000000050000005000000000000000000000000000000600000000000000006000000060000000000000000000000000000000000000000000000000000000000000000000000000000
000000005550000000000055555500000000000000051555500000003000000000000000555550005000005055500000000000000310000000000000001000005300000030000000503000011001000000000000
333000003333000000003333333300001031000000333303300300000000000330000003320330100000313033300000031300000000000033300000000303030330000000000050000000000000000000000000
000000000000000000000000000000000001000030000000013000030000000000000000000000000001000001000000000000000010000000000000000000000300030000300000300000010100500003000000
000000000000000000000000000000000000001000000300000010000000000000000000001000010010000000000030000000000000001000000000000000000300000000000000000000000000000000003000
000000000000000000000000000001000300000000000000200005000000500000060000000000505000000000030000000000000000000000000000000000001000003000003000000000000000100030000000
000033330003333000000000000030003300000333000000000000000000001300000030000000000000000003000000003000433000100000000000000010000033330000000001000000000000000003000010
000000000000000000000000000000000000000000000000000000000000000000000030000060003000003000000000000000000000010000000000000000000000000000000005000000000100000000030300
000000000000000000000000000000000000000000005500000000000000000000030100011000055000000003000000030000000005300101555500000000000000300000000000000050555005550003000000
000000000000000000000000000000000000000000033300000000000000003000300000300000330330000000033300030000500030310033330330000000200004000000500030000333003303303000030000
000000000000000000000000000000000000000000010000001001000000000010000000000100000000000000000400000100000000004000001000001005004000000000000001001000100000050000000003
