000000000000000000000000000000000000000003000000000000000000000000000000000000000000000000000000000000000000302040010000000000000000000030000000006004001000000000000003
000000000000000000000000000000000010000000000000100000100005000030000000000000010000000005000000000000000000100030000000000000010000000000000000000103203000000000005600
000000000000000000000000000000060000000040000000000040003130000000000000000000000000000000000004000000000000010301000000003000000000010000000000000300000000000000000000
000000000000000000000000000000100003000000000000000100000001200000000000000003006000000000000000000000000000010000000000300300010000000000000000003000000000000000000000
000000000000000000000000000000500100030000000000000000000000000100000000500000000000000001000000100001001000000000040010000000000300000000000000000001000000000005000000
000000000000000000000000000000000000000000000000000100000000030000000000000000002020000000000002200000000003000000000000000000400020000000000000000300000000000000000000
000000000000000000000000000033013300000006000000000000000300303333030300000003330333000000003330333333333100000001000003333333033333300000103000000000000300500000003333
000000000000000000000000000000040000000000050000000000001000000060000000000004000000000000003000000000000000000000000000013000000000000000000000000000000200000000000200
000000000000000005000000000000001000000000000000000000000000002000030001000000000000000000000000000000000000530000000000000000000000000000000003000000010000000200000000
000000000000000000000000000000300005000000000000500000000000000000000000000000030000000000000000000000000000001000000000003000030000100000000000000010000000000101000000
000000000000000000000000000000000000000000000030000000000030000000000030000000000000000000030000103000000000001000000000000000100000000000000030030000003000000000000300
000000000000000000000000000000000000600000000000000000000000000000000030300000100000000000000600000000000000000000000100010000000000000000000000010000000011000000000000
000000020020220000000000022000000000000220000000020003220000000000100000000000000200000000010020060000000030000000000000000000200202200000360000000003002020020220010003
333333333333333333333333333333334330033303030000033303330000001000000000100003033333000110030303330010000333303310000000000000330330333333303033313331333333330330000000
