003030000000000000000000000000000050014000000000000003000000000003300000000000000000000000003300000000000200000010030000000000000000000000000030300000000003000000000030
000400000000000000000000000030000000000000001000100040000000403000400000000000000010000000000030000000000100000000000000000000010000003000000005300000503000000000040000
000000000000000000000000000000000000001000000003000000000000000001000000000000000100000030000030010000000000000000000000000000000100000000600000000040000000030000000000
000000000000000000000000000000000000600300330300400000000000330000000000001003300300030000003330000100000000000200000000000335000000330004000311030000030303030003300001
000000000000000000000000000000000000000000000000001000000100000300000000100000000030000000033333101000301000006600000000000000000000000060100030000000630133303000000600
000033000000000000000000000000000000000000000000000003000000300000000000000000000000030051063300000000000003006600000000000100000000000030300000330100030533340000000000
000000000000000000000000000000000100000000000003300000003333300000100000000000000033000003333303000300000330333000200003330300000000000000330000000033300033333050000033
030000000000000000000200000003000005100000200000100000000030000200000003000000000020000000000000000030000000100000000000000000001030020000002000100000000003000000000000
000000000000000000000000000000000000000003000000000000000010000000000000000000030000000000000003003004000000000100000000000000100400000000000000300000000000001000000000
000300000000000000000000000000030040000000300000000000000000000000002000030000010000000010000000000000200000000000000005000000000000000000100000000000030000000003000000
033300000003333300000000000200300003000000000000200003305000030000000003330000000306000000000003330003000000000000060000033000300003003001020000002003000000000000000000
333330000003000000000000006633303000000000000006610000000000000000006603333000000100000000000300000003000000000000000003303300001000000000660000006000000000000000000000
333000000003000000000000006630300000300001000000000000010000010000606610300000500003000200000003000000330000200000000003303003033003200000660000066000000050000000000000
333330033333000000033333333303003010000000303603333303000030000330333303330000006000000000033031000000100000000000000003333300030000033330353330333000000000000002000003
