000000000000000000000000000000000000000000020000000000005000000000010000000003000000000000011100000000000000000000000000110100000000300000000000000003000000030000000000
000000000000000000000000000000050000000100000040500000000550000000010000000030000000000000001110000000000000000001200001111000000000003000000000000000130000000330500000
111111111340000000000000000000000001040360300000001111101140611300011003000000000000000000000000001140025000100500000000100000103400011111110000000000003030100000110110
000000000000000000000000000000040000000000033000000000000001000000001033000000000010500000300000003000000030000000000000000000000000000400000000000000003033100000001000
000000000000000000000000000000000000000000330100000000000200000000030003000000000000000000000006000000000330000000000000010000100000000000000000001000000003003006000000
000005055550000000000000000000000000100000000000000000500004000000000000100000000000000000002030000000000300030000000000200000550503000000500000010000000033000000000100
000000000000000000010000000000000013333003303030000000003333333333030303333050000000000001033033303103303330333300000301103330000030000000000600000000003031333300000000
000000011100000000100000000000000001110050000000000001001110000000000000000000030000000000000301000000000000000050001060000000000000000100001110100000000000000000000100
000000011110000000100055000000000001011000000000000001001111000000100300300000000000000000000006000000000005003000101100010000000000000000000010000000000005500000300100
330000000000000000111114001110340000335060010000200001110000300101011100000005134000111110100301111034000000000000030110140011000000511103003000000110430011400010000111
330000000000000000000000000000001000000000000000000000000000000000000040000000000030000051043000000000000001000000000030000000000000033000000000000000000000000000000500
330000000000000000000000000001000000000000000000000000000016000000000001000000000000300000101000000000000000000000000300000000300000130000000000000000000000000030000000
330000002000000000000000000055050000200333000000000000000200100000035000000005555000000105030000005050000000000000000000000001000000033000000100000555500000000000000000
333333333033333333333333333300000003003330000001033333333303003000000000000100000300000000023331300001010000000033333033130333000000033333330300303000000033333333330300
