000000000000000000000000000000100000000000000300000000103003330000000000000010000000200000000000330000000000001000001030000101000000030333330000000004000100060000000000
000000000000000000000000000300000000000003000000000000000000000000000000003000000000000000000000000000200600000000013133005000000000000000000333300000020600000000000000
000000000000000000000000000000000000000000000000020000400003300000000000000000003000000000000030000000300000000000001000000000000000000003000000000000000000000300030300
000000000000000000000000000000000010000006300000000000000020000600000000000600500001000000000003003000000000000000000000000000000000000100004000000000000000000000000000
000000000000002000000000000010000100000003000000001000000000000000000000020002000000003000003000000003000000000000000000000000000000003000015001310200000000100000000300
330000000030000000000000000000000010100000300300003000000000000000301000000030000000000300000300000000001000000000000003300000001006000000000000333000000000030000300000
000000000000000000200050000000033130000000000000000000110000000030000000333330000200000006000000100000200000000000000000000000000000000000000000000000020000100000000000
000000000000333333333000000000000300000003333333300300000000000000000000000000100033330303300000000020003000000600000003000000000000000000000000000000000003303301000033
033330000000000000000000000000000000330300000001000200000000000000000603333000000000000000000000000000000233300000060030333300000000000000000000030000000100000003000000
000000000000000000300000000000000000000000000030000000000000000000030000000000100030000050000000000000000000030000000000010030000000000005000000030010000000000000000000
000000000000000020000000000003000000003000002000000000000000000000000001000030000100002000010000000000000000000001000000000100000000000000000000300300000000000500000000
000000000000000300000000000000000000000000030000020000000000000000000000000000000030000030000003000000000000000030000000000003200000000000000000000000100003000001000000
000333300000000000000000000000000000003023000000060000030000000330000000033330000000000000033300000000000000330300000010003330000003000300000000000001600000000000300002
000000000000000000000003333350000310000000006000001002000000010000000103000000000000000000006000000030333000003001000000000000003120000330330013335050000000200030000000
