300000000000000000000000000000000000000000000000000000000000050000001000030000000000000000006000000000000001000003000010000000100000000000000000000000010000000000000000
000000000000000000000000000000000100500050400000000000000000010600300000000000000000000003000000000000003000100000000100060050000000040006000000000000000000001000000052
000000000000000000000111111040000000000000111110000000000000000110111000000003000000000100100000000000000111111000041106100011000000011101100000000000000000000001010005
000000000000100510000001110000000000000010000000010003000000000001100000000000010000111100100000000300000001010000111001111000000000000000000500000000010000000001001000
000000000000000000001011100100000000000000000000000000000000030310100000000000000000011000000000003000005001100103000011110000000040000100000000000000003230000001110000
000000000000111000001111110000000010300011000000000000000000000101010000103000000000010000300030000005000111010013110001101055000000000100001000000000000103000001000005
000000000000000000000000000033333330000000000333300000003330330001000033303350000000336533333030000313333000000000100000003333330333300333330000000003333333333331330313
000000000000000000000000000000000300000100000000000000020000000000000000000000003000000000030000000010000000000000000000000100000000030000003000000000000101000000000000
000000000000000000052405000000000000000000006000100000520051000000000030010520100000000000000600005000000000000000000000000000000133100000003000000000000000000004000000
000000000000001100011111111011111100000000006000011030011051000100050011003110000000100110000000000000000100000000000000000000000205000010200000201131111300000001101101
000000000000001111000000000000110000010000000000000110600000000051003010112000000010000000000000000000010010000000000000500000000000030000100000000000110300000100000000
000000000000001110000000000001110010000101000000100000010010000000000000300000010000000000000100030000000000006100000000000000000000000000000306000011000100030000000000
000000000000001100055000000021011101000001000000011000500000000100000111000500000011000000000300000000011100000100000111000000000000400000000000000111110000000100000010
333333333333333333333003333300000000000000333313330333330003333000010031333030000000003333300000000000600000000000000000000100333033000000000000000000000030030000033033
