000000000000000000000030330300000000020000110000000000000000000000300100000000300000000000030300000300000000301300000040000000000300000000000000000000000003033030003000
000000000000100000000000000000300100000000000000000000030000000003000000000003500001000001050000000000003000000002000100100003000000000000003000000003000000000000000000
000000000000000000055000000000000100000055000030300003030000003000000000000000000000000000000000030000300000003600000000000303000000000003010000003000000000003310000300
000000000000000000000000000000005000030000000001002000010000000300000000000000000000000000000000000200000000000000003100200000000010000000000620000003000000000003000000
000000000000000000000000000000000000001000000000000600000000000001000000000000000000000000000000000000000000000050000000000000030000000000000600001000000000010000000000
111000000000000000550030000000000000001550000300000000001013000030000032000000010000000000300000030003000030401000200000000000111000000000000000300001055003003302000000
000000000000000000000000000000000000000000033330103000000000000000000033330130000000000000033303000000000000100000110000000000000006030333030000000000000300500003333303
000000000000000000000000000000000000000000031330330000000000100000000000100000000000000000000000000001300030000000300000300300600000000000000000010000000000000000000000
000000000000000000003330000000000000010000000100000000000000003002001000010100000000000000133030000000000000000000000002000000300010000000003003000000000000000000000010
000000000003030000303000000000000000000004000000000000000000303000000003060550300003003000000000000030000000005500000550000000000000000000010000000000000000000000000000
000000000000000200000000000000000000000000000001030000000000000000000000006000000001100000000000000000003010000000100000000000000000000000000000000000030000000000000000
000000000000000000000000000000000000000000000100000000010000000006010000010000000000000000000000000000000000001010000000000000000000100000000000000000000000000000000000
322000000000000000000000000032210010000000000000010130030000010000000000005000000000011000000000003200001000005000005530300000300000052200000000000111000032000000000000
333333333333030000000000000003033360500060000000000000000000000000050000000003000300000000000000003300330000000000000000000003000000030033330000000000000033333330000000
