000000000000000000000000000000000000000000000003050000000000100000000000000000010000100000000000000030000000030000000000000000000000000000000000010000000000300003000000
000400000000000000000000000100040000000000000000100000000000001005400000000000000000000000000000000003000000050000000000010000000030000000000000000000000000000000000000
000000000000000000000000000000003000000300000000000000010000000000000300000000500000000000000000001000000000001000000000006000600001030300000000000006000000100000000040
000000000000000000000000000000000000600000001010000000000000000000000100300000000000000000000000000000000330000000000000000000000000000000000000000000000003500000000000
000000000000000000000000000000100000100000000000000000000000000000000000000000000100000000000600000000000001000000000000000000000000000001020000000000000000000000000103
000000000011110000000000000000000031100100300110300000000000000000050000110110220000030111100000001000000000000021200000000000000000003011110001000000000000051110000202
000000000000000000000000000000100003031303000000003000000000000000000000000001333333010000000000000000400031333033333333433300000313300000000000000000000000000000300330
000000000000000000000000000000000000000003003000000000000000060000000000000000006000000060000000000000010000000000000000010000000000000000010000000000000000000000000000
000000000000000000000000000000000000000000000060000000010000000000030000000000000000000000000000000100001000001000000000000101000403006000001000000000000000001000000000
000000000000100000000000000000000100033000000000000000000000000000041000000000000000000030000010000000000000000000000000000000000000000000100000000000001030500000300100
000000000000000000000000000010000000000000000000000000000000000000000000000004000001000000000001010000000000000000000000000000000000000100000000000000300000000003000000
000000000000000000000000000000010000000000300000000000000000000000000000600000000000400003000000053001000000000000000000040000000000000000001000000000000000000000000000
000000000000000000202222000000000000000202222000000003000000000000100000000000000002222002000000000003000000020000000003300000000000000000000000000000000022200000000110
333333333333300333333333333303331300330303633300300030003333333330303000000060303003333333333330300000000013033300000000000000000000033030303033330333303033033330000230
