000100000000000000000000000000000040000000000000020101050000000000000030002000025100000000000000000000000000000000000000001000000000100300000000000630030000000000000000
000000000000000000000000000000003000050000010003000000320010000000000000000000000000000000200000000000000000000000501000000002060000000000000030005000003210000310004003
000000000000000000000000000000000000000103111101000300600000000000000011110100000000000000600000000000000001000003000000000060000300000100000030000000006600000000000000
000000000000000000000000000000001000000000000000000000660001000000000000300000000300000000600000000000000300000000001001040066003001000000000000000000006600300000030000
000000000000000000000000000000100000000000000000000000660033360000000000000000000000100006000000050333360000000000000030000066133036000000000000000100006300000300330366
000000000000000000000000011103000000000000022000010000660333066000011102100000060030000006600000001300060000000000000100000066030306600000000003202003000030000000033006
000000000000000000000000000000001000000000033333030000333033033000003030300330000000330003300000000333003000000000000003300033305303000010003333130330006000000603330033
000000000000000000000000000000000000001000000300000050000000003004000000010005000000010000300000000001000003000000000000000000000000000000000000000101000000000000000000
000000000000020000000000000000005000003000000000000000000000000000000200000000000004000000000000000000000000000000000300000000000000000000030000000000000000000000000000
000000000000660000000111111000000000101100000000000023000000000000006650000000300000000000000000000000003110101100000000010000101110050003000000000000000000000005000010
003000000000660000000000000000000050000000003000000500000000000000001600000050000000100000000100300000100300000000000000000000600300103000000000000000000000000000000100
033336600000660000000000000000100000000000030306600000030000000000006600000000000110000050000000000000300000000600000000000000000000003000010000000100000000000000000000
033306600000660000202022000000005022000000033300600030100000000000006600000000000204000001100002360000000002003000000300303010023000000015026000000000000000001010200000
333303333000333333333333333333333330000003033303000300100000010330003303010003330333000300013003330030000303303300000006000000333330013030030000300000030100000003333300
