000000000000000000000000000000000100000000000000000000000010000000000000001030000000000000000000030000000000000000000000000000500000000000000000000000000000000000000000
300000000000000000000000000000000000000000300000010000000000000000000010000000000000000000030000000000000000000030000000000000000000000100000000000300010000300000000000
000000000000000000000000000000400000100000000000100000000000000000000000002000000000000000000000000000001000001000000000001000000003052000000001000000000000000000000000
000000000000000000000000000020031000300000000000000000000000000000000000066000000000000001030000000000000000006000100300000000000030033030000000330000000000010003000000
000000000000000000000000000000030000000000000000300000600000000000000005066000600000300000000000000000000000000000000100000030000000030330000000000000000000100000000000
000000000000000000000030000033303002000000000000003000000000000000000000066300300000030001000000000000000030000005000000300000000030033430000000001000000000000000002000
000000000000000000000000000033033330333050000000000000300100000061050030330305000000000000000000103333000300000001000001000000330300330333333333333100000003100003333300
000000000000000000000000000000000000000030000040006000000000000000000060000000000000000000000000000000000000000000000000000000000000000000000000000000000000000000000000
000000000000000000000000000000000330003300000000000000000000000000000030000000000003000000000000000000000100000000000000000000000000000000000000000040000000000000001000
000000000002000000000000000000000000000030000001000000000000000000000000000000000040000000000100000000000000050000001010000000000020300000000000001030000000000000000200
000000000066000000300030300000000000000000000660000001000000000030300000000000000310000000003030000030000000660400000000000006000060000100400300000000005003130030006600
000000000066000000000333300000000400000000000600000000000300000300000300000000000000000300030330000003000000660000000000000000060660000300000000001000002033330600006600
200200000066000000300333330001000030000000000660030003002100001333100040000000000300200230033333000000000000060000000000306300000060020000100001000000000033330000006000
333333333333333333333333333310000000000000330303010333335033333333033000000000003303303033333303330000000300533300001000000000333030333303330000033000000033133033333333
