000000000000000000000000000000000060000000000000003000600030000001000000000000000000000000033000000300000000003300000000000000000000030000060000000000000000000330030000
000000000000000000000000000000000000030000000000033000000000333100000000000300000000000000033000000000010000533300000000000000010000000000000000000000000100003300000000
000000000000000000000000000000000000000300010000033000000300330000000000000300000401003000030031030000000000033300000000000000000050000000000000000000000000005330000000
000000000000000000000000000000000300000200010000030004000033333000000000000100000000000000030000000000000003331300000000300000000001000030000040000000000000300330000000
000000000000000000000000000000000000000000000000030300000003033103006000000000000001000000000000000000000013030000000000301000300000000003003000000000000000033331000000
000000000000000000000330000000000300000000100000033003002030330000000000000000000000310000033000000400000203313033000300000000000003000000002000000000000020333330000010
000000000000000000003330000030330330000000303303033333033333300000000003333030000002330000033300330000003033343630020000000000333000000310033031235333333303303300000000
000000000000000000033330000000000330000000000000000000300000000300000000000003000000000000000000000000010000000000013000000000000303333000000000304300000033000000000000
000000000000000000333330000000003030000000000000000000000000003050000000000101300000003000000000000000000000000000000000000000050330333003000000000000100000000400000000
000000000000000003333330000010033330000000000000200000000000000000003000000003300000000000000001001000000000000030006000000000010303033000000000000000000030000000000000
000000000000000033333330000020033330000000400100000000000000000000002000000003300040000030000000000000000000000000000000000000003333043005300030000300000030000000000000
300000000000000033333330000000303330100000000000000000003000000000000000000003300000000000000000006000000010000003000000000000003333330000000000000000000033000000010000
200000000000002333333330000020333003306100300000000000002001000005000033000003300000000000000000002000000000000000000040001000213030030000000000000000000033000003600000
333333033333333333330333333330333303300000000000300000003033333000000033001003333303010000033300003133330000100600000030000000323330033333330000000000000333003330000000
