303000000000000000000000303000000000003000300000000300000000000000000000000003030000000040000330030003000033330100000000000000103000100000000003030000000000000006000000
000000000000000000000000000000000036020000000000000230000010000000000000000000000003000000000000010010000000000000006000000110000000000000000100000000000000060100003000
000000000000000000000000000000001003000000000000000000030000000231000000000030000000000003300000003000000000000006000030300000000000000000000000000100000000000000001003
000000000000000000000000000000000000000000000000001000000000000000000000000000000300000000000300010000000000000050000000000000000000000000000000000000000000000300000000
000002000005550000000000555500000000300555000002000000030000000000000000003030000020000001000000200000555000000000000030300500000002000000000005555330300000000530000000
333033330033330000000000033303000050000333333133300010000000000000000030000003330333000000033303003003333000000000110000000000333333300000030000033051000030033331000000
000000000000000000000000000003200000000000000010000002000010000000000300000000030000000000000000000000600005330000000000000000000000000000030000000005000000000010000000
000000000000003333330000000001030300001000030033000000000303333000303000000000000000001000000330300003000000010000000100030000333333011000010000000003000033333301500000
000000000000000000000000000000000000000050000000000000000000000000000000000000000000000000000000000000000000000000000000000100000000000100000000000000000000000000000001
000000300000000000000000000000300000000000010006000001000000100003000006000000000001030000000000000000010000000000000000000000000000000010000000000000003000000000000000
000000000000000000000000000000000000000000100060100000000000000000000000060000005000000000000000000000400000001000030000000000000000000000000000001000000000000000000000
000000333330000000000000000000055550000000000000003330000330000000555133030000000555030600000055553033000001000000605500000000000000033330000000000000000000010000030200
000000000000000000000000000000000330000001050000000000000000000000033000600003301303301000500001330000000000000000013330300000005020000005000010002333310000003000000060
000000000000000003330000000300000000500000000303000000000000300000000000110601000000303000300000000000300000000000000000000010000333000000000000303000000000033330000000
