000000000000000000000000000000000000000033000000000005000000003000000000000000000000001000000000000000005100000000000000000000000000000000050000030003003300003000003000
000000000000000000000000000000030000000003003000000000000000000000000000000000600003000300030000000030000300300000000000000000000200000060030000000000000300000010002000
000000000000000000000000000000000006050100001000003000030000000000401000000000003003000301000600000000100001000000000000000000001100000030030010010003300300100000011100
000000000000000000000000000000040000003303000001000000003000000001000000020000333003000000000000000000005000000003000000000000000005003310000003000030300300000000000000
000000000000000000200000000000010000330003003320000000000000200000000000000000330003100000000000000030000060000000000000001000000000000300030000000033000300002030000030
000000000000000011111000000300000220300003001101100030000010135000000000000000300003000000000000000300002003000030000000000003000000200100000200000030000300111110000002
000000000000000000000000005333330333333033000033000000000003000303303300000003330003333303300000003333333333033000000000001010333333333330333333030313330300000003336333
000000000000000000000000003300000000000030300000000000000000000000000000000100000000000000000000100000000000003000300030000000000000000000000000000000000000010000000030
000000000000000002000000000300000000000030000000000000000000000000000000001000000000000000000000001130300000000300010050000000000313000000030000000000000000000000000000
000401000000000011100003300300000000000000600050000100000011100000000000000010000000000000003000000000000003300300600000000000000000000100003000000300000100001000000000
000000000000000000000033300300000006000000000000000000030000000000000000000000000010100100000000000000006333300000000000000100000000000002000000000000000000000000000000
000000000000000000000033000300030000000100010000000010003000010030000000000010000000100000000000040000000030003300000000501200000000000000000000000000000003003000000300
020000000220200000022030000302000000002020000001000000030000002000000000003000220020000500000111110000003030000300221200011110020000000030003002020000000030000030000003
333333333333333333333333333300030333333313000000000000563333333003000010000530333040000000000000000000050333333002030330000000331033300000005330330000000000000030300000
