003100000000000000000000000000000600300000000010000000500000010000000000110000000000000000000000000000000000000000000000010000000000000600100000000003100000000000030000
000000000000000000000000000000050000000000000000300000600000000000000010000000000000000000060130000000000000000000000000000000001000000000000000010000000000000100106000
000000000000000000000000000000000160100300100000130600000000003000111000000000001000000001000000003000000000000000000000001111000100000010303000504000020000000110060000
000000000000000000000000000000000010000000000000000000000000000000030000050000000000000000000000000000300000000000300000100000000000000000000000000000000000000010000000
000000000000000000000000000000100000000000000300000000060000006000000000000010000000001000000000000000003000000000000003000000000000003000000000000000030000000000000000
000000000000000000000000144400000025000000000000000000620000066002000000000000000000000006300005000000000000004000010000220010000000000004440000000000000000000020001600
000000000000000000000000000003331333001033000000033330333300333333303004000003300033333033303000030000010000300001000331333333100001000000060300033000000030003300503000
000000000000000000000000000000000003000000000000000310510300000301000000000000000000003000000030300000000000000000310000000000000050000100000003000000001000000000010000
000000000000000000000000000000000000000000000000000000000000020000000000000000000000000000000000000000000000000000000000000000000100000000030000000000000000000000000000
000000000000000000011000111100305000000000000101100000000000011003000000003100000000300000000100030001111003000000000000000000000000002000110100000000100101000001000005
000000000000000000000000000000000000000000000000020000000000000000000000010000000000300000001000000005000000000000000001000000000001030200000000010000000010100000000000
000006600000000000000000000000003000000000005000000000000006000000000000000000000000000000100000000010010000026600000000000066000000000000000000066000000000000600000000
000006600000000000002022000001011440001000023000000000000300002000000000004040000000000000000000000220000000000000000000000066000000000000120000060023000000004040010000
333333333000333333333333333300000000000000333330000000003010333000003000000000000000000000105000003330333333333300000000330333000300000336330333033331333300000000000300
