000000300000000000000000000000000000000000001000300003000010000000000010000000003000000000000000000000100000000300000040000000000000000000060000000000000000000000000000
000000000000000000000000000000000005053000000005000000000000000555500005000000430000000000010000003000050003000010010000000000000000030000000001000555000000000000000000
000000000000000000000000000003000000111110000001100000000000003111011000000000003000000000000000000000301000000000000000000000000000000000000000003000103000000000000160
000000000000000000000000000100000010000000000300000000030000000000003010000010000000000600000030000010000000000000000000000000000000000030100000011000000050100030000000
000000000000000000001000000101033300000000000010000000330000000000000600000013000101000000001006010000000633300000000010003000015000103330300000001000000000001300033300
000000000000000000111111111133000000005000300020000030330000000000000010111160000111000003000001103003000033500011023010000000000011003300001111100200000000000301310600
000000000000000000000000000033300103333303031333303003330000000133033300000000000000130003300060003033033013000000000000000000000000033300000003300330030303003303030000
000000000000000000000000000000000000000003000000000000020100000050030000000000000300010043000000030000000003000000000300000000000000000000030000000000000300010000000031
000000000000000000050555500020000000003300000000000000000100020330003000000000006050000000000005000000000055500000000500000001555500000000001000053000000000500000030000
000000000000000000111111111000000060001000000000000003000000000000000003000000000111000000000000000000000011011000001010000000111011000300000100110600001000000000000000
000000000000030000000000000000000000300000000000050000000000000000000000000130000000000000000002100000000000000000000000000303001300000000000300000000000000300000000000
033303000000330000000000000001000600000000000000100000110030030000003000000300000000000000000000000000002000000010000000000003000000000000000000000000200000000050000000
033000000000333000200000000000100000000000000011111111110330000000000000000013000200000000000000001110111000000010002000030030000000000000000000000000000001000300003111
333000003003333333333333333303000010000000000000000000000300000000000003003333333300000000000000000000000333330303330330000003303331300000000033331000000000000000000000
