000000000000000000000000003300000000000400000000000000100000003003000000000000000001000000000301000000030000000000000000000000000000000000000000100003100000020003003033
000000000000000000000000000000000000300000000000000000100000000000000004000000001000000000000000130000000000000000000000000000000000001000000000000000000000000000000000
000000000000000000011111100010110000000000000000000010000000000000001100000000200000020003000000000003000000000000000010000000020000000000010103000000000000006001111000
000000000000000000000000000000000000030000000000400000000000000000100000000003200333320330300000013000000000000130000600000000310330000000000500000000000000000000000000
000000000000000000000000000000601000000000300000000000000000000000000000000003300000330000003001000000000000100000000000000000330000000000000000000000000000000000000000
550000000000000000000000005000000105000000000000000000001003000001005016050000300000333000000000000000000000000000110000000000336000000000000000000000000000000000003050
000000333330000000000000000000000500000003333300000000030000003000030000100033300000330005000000000000000030303000100003333300330000333033300000000331333003130000000000
000000000000000000000000000003300000000000000000000000103010000000000000300000000000000000000000030000000000000000000000000030001000000000000000000300000040000000000000
000000000000000000000000000000000000000000004000000000000000003001003030000040500000000000000000000300000000000000000000000000010003000030000000000000000064000000300000
000300000000000000000020000002400000000001000000000000100000000000000000001001111000000000001010010030004000061003000021101000000300000000000003000000000000000110000000
000000000000000000000320333302033330000000000000000000000000000000000000000000000010000000000000000010000100001000040001000000000000060000000000000000000000000020203030
000000000000000000000330000033003000000000000000000000000000000000000000000000000300000000000000000300300030000000000000100000000000000000000000000000000000000003300000
000000000000000000000330000033000030000030000000000000000000000000000300000000000050550000006000520000000001000000000000001001000000005000003000060500000010000000000000
000000000000033303330330000033000000010050000050003000003030000000201133033300000010000000300000003303300000000010000030000030000000000000300000000000010200000003300100
