000000000000000000000000003300002000000000000000300313330033133000000100000000101000050000000001001000000002333300001000000000000000000000000000000000000100000333000000
000000000000000000000000000000100000000000000000000000000000000000000000000000013330000000000060000000000003000060000030000000000000000000000000000000000030000000000000
000000000000000000055000000000000000300000000000300003330000133010000000000060100003110000500000006003010000033000000000000000000005500000000000000000005500000406600000
000000000000000000030000000000003000000000000010030000000000000000200600000000300560100003000001005000000030000000000000000000000000000000000520003030003000000000000000
000000000000000000000000033000000000000000000330000000000000000000010003001303300000000000000000000003000000005100000000000000000000000040000000001004000310000300200000
333000033333000000002030000033300000330000500000000000000000000000030303000000000000000000203300000300000000030033333003000000100000200103033301500000000203010000003350
000000000000000000000000000000600000000100030000000000000000010000000000000000000000000000300000000000000000000500010000000000000000000000000000040000000000000000000010
000000000000000033333000000000000000000000000000300400000000000000000000000003000000000000300000000000000000000000000010003330000000000010030003330500000400000000600000
000333000000000000000000000000001050003330000000000000000000000000000000000001000000000000000633310000000000000000033000000000001000000000100001000000330000001000000000
000000000000000000333000000001000000000000000000000000550050000003015500001000001430000030250000000000000000001000010000000330000000000000000000333003000000000000000000
000000000000000000000000000000000010000130000300000000300100003000003000000000000100001500100000000000000000050000000000000300000000000000000000000000000010000000000100
000000000033000000000000000000000000100000000003000100000500000000000000033000000000000033000000000000000000000000010000000000000030000003300000000003003000000000003300
000000000000000000000000033300003100000000000000001000003303000001001200000000330000000000000000000333300000033300000000000301000000503000000000000000000000000330000000
000000000000000000000000000000000300300000003000000000000000000000000000000003000006000000000000000020000000000000000000000000000000000000000000000000000000000000000000
