000000000000000000000000000000000000000003300000000000003000100000000000000000000000000000031030000000003010100300000000000010000000000000000010100000000000000000110003
000000000000000000000000000000000000300300330000000600000300000000000000000000000000000000033000000000000000000000000300300000000003000000000000000000043000000603300000
010000000000000000000000000000003000100300330000000000003300000100501000004000000000000000033030000003000010000000003000000000010000000000000000000010031000000003300300
000000000000000000000000000000033000500003030000000000000300000000050000000000000000000000003000000000000000000500333300000000003000000030003061100000330103000000300000
000000000000000000000000000001333001000010300300000100003000000000100000000000000000000000033000000010000010000003303300000000000010000000000000000033303000000003306000
000000000000000000000330000003033300000100330060020000000300000300000000005000000000000000013000003303000000001003033000000000100100000000000000000033133300001003300000
000000030000000000000300000033233300000000330033033033303300333300000000000003000000003333330500033000300000000033333300603333000000030000000000000333333030000003300303
000000000000000000000300000000000001301000200000000000000001000000000000000000000000000030000000050040000000300000600003000000500010100000000001100000500000000000000000
000000000000000000030330000000030000000000600000000000000000000010000000000300000000000016000000300000000000000000000003300300000005000000000000000000300001000000000000
000000000000000000300330000000000001340000000300000000000106000001000001003030000000500000000003000000000000000000000000330300000000600310000000000000000001010000000001
000000000000000003330030000000000000000000000000300000000000001000005000003300000000000030000033300000000000000000000000303000030000000000000000003000000000000000000000
000000000000000333330330000000000050000000000300000001000000000001100053303000001000000000003033000000000020000000000033030005000000000000000061000000000050000000000016
200000000000000333330330000033000000000000001000000010000300000000000003333300000000000000001330300000000000000000000000300060200000003001003300010000003600000002000000
330333300333333333330330033330000200033333000000030000000000000330331033000050033333000000003330303000000000333000000003300033303033330000000000000003300300000003303303
