000000000000000000000000000000000000000000000000000000000000000000000000000000000000000030000000000000000300000000000000000000000000000000000000000000000000000000000000
000000000031000000003000000300010030000100000000000000030000031000000000000000000303000000100200030000020000010000040310000000000002100000000000030000000000000201000503
000000000000000005000000000000000001030006000001000050100303000000100000000001105000000000000000003000000000000000003030100000033300003000103000033005000033030000000000
000000000000000000003000000000000060000000000000000000030000100300000010000000000003000003030000000000000001000001000000000503000000003000000006303000004000000000000000
000000000000000000000000000000000000000000200333300000010000000000334304000000000000030030300000000000000000030000000000003000000000000000000003030004000000000000003330
114414000000000000000100000000001000000003000000000004303000000000130011401100000200000031050001000100000000000000000000000330006000001441000033330014015100000000000100
000000000000000000000000000000000003330033353000000000000333003333500000000003000000333000000000003303033000000005000013330000330303300000003000003000000036330333310000
000000000000000000000000000000001000000000000000000000000000000000000500300000030000000000000000000000000000010000000000500000000000000000000000000600000000000001100000
000002000000000000000000000000000000000000000010003000000000000000000000000030003030000000000000000010103530030000000030000000000500300031500003100000000001000030000003
333300000000000000333300003330000330000000000000000001330000103000031003000000003000003033300000000000000300003303000003000033010500003000002000000000003300000000025050
000000000000000000000000033300000330000000000000000000000000333000000000000300000000000000000100000000003000033301000000000330000000300000000300003000000000010000000013
000000000033333000000000333300133330000000000000000001010003333300000000000000000000300000000000000000001000333300000000001333000000000000000000000300000000000000030000
000000000003300000000003333300333530104140000000000000000033333000000000000000000000000000015403430510000003333310300000030333000010000000000000000000300010040000000000
333303333300000000000000030300013036000000000000000000000000303000000030000000000000100300010100000100050000030300100000000503050000000000005000300000001000000000000300
