000000000000000000030000000000000001003050000100000000000000300300003000000000000000000000000002000000000000000000000000500000000000000000010000000000300000001000000000
000000000000000000000000000000001000000000001030000000000000000000000000000000000000000000300000000000000003050000000001000000000000000000000300000000000000010000003000
000000000000000000000000000000000000005041000000000000000600060000000003330000000110000000000000003330000000000000110000000000303004000100000100000000244103000000000000
000000000000000000000000000000000000000000100000000000000000000601000100000000000000000000000000000000000000000000300000030000001000003000000000000000003000002000000000
020000000000000000000000000000003003001000300000000000000001330000030030000000200000600330303000010013400000000000000300000000000000302000000200000030003000033330000000
330010000000000000010111000000000300000000111000000010001010000000000000333033030100000000000000000000333111001000303030000300000000033001003100100300500100000000000000
000000000000000005000000000003331336033030000000000000000103000000000000000000000000000000033330300000003000000003000000333303000000000000000000000003303300000000000000
000000000000000003050000000000000030003000006000000000300003050030103000010000000000100030000030000000030000000050000000000000000103000030000000000000000031000000000031
000000000000000000000000000500000000000100050000400000060000000300000000000000000005000000000300040000060000000000000000000000000000000000000100000000000000000300000000
333300000000000002441000000000000003303000000000000000000012441000001000000000010000000010010024410000001000000100000003000000300000000006410000003060000033300000000000
000000000002000000000000000000002000000000000100000030000000001000500000000000000000000000500000000000000000000000000001000200000000000000000000013000000000000000000000
000003000033333300000000000000033030040030020000000000000300000000000000033330000000000000033050000000000020000000000000003333000000033100000100000000300030000300601003
003333300000000000000000000000000000133333330010000000000001003000061000000000000003030002000000000000010300010010100000000000000001000003001610000000500000303030000010
000000000000000033333333333300000000000000000000000150000033333000300000000003330333000000000033300005300000000000000000000300000500000333330000000103033110000000005000
