000000000000000000000000000000002000000000010001000000300000000004000300000000101000000000000001000000001000030001005000000000010000000000000000000000000000000000000000
000000000000000000000000000000000000000000000000000000003000001000000000000001001000001000000000600000050000000300000000000310000050000030000000000100000000000000000003
000000000000000000000000000000000420000000000000000000000030000000000040000000000000000300001300030000000000000000030000000000000020000000000000000003000000000000000000
000000000000000000000000000000000000030000006000000000600000000000030000000000001030000000000000000006000000000000000000000000100001000000000001000060000000000000000000
000000000000000000000000000000000000000000000000000000000000000000000000000000000000000005000000000000003600000000000500060001000000000000030000000000010000000300000000
000000000000000000000000000030010000003000000000003000000000000000000000000013000000000003000000000000002500000000010000000000000001003000000000030000000000000300000000
000000000000000000000000000030333330000000000000000300000300000500000033033033313033000000000000000303333000000033332030033000000000000000000000000000000030333300000000
000000000000000000000000000000000000000030000000000000000000100000000000000000033000000000000010000000000000050000000000000000000000000000300000120000000000000000002000
000000000000000000000000000000000000000000000000000000000000010000010000000000000000000000000000300000000305000000000033000000000000000000000100000000100003001000000000
000004040000000000000000000004000000000000000000040300000000000000000000000000200300300003000003000000000000000040000060000000000000000000404000000000000000000400000000
000000000000000000000000000010000000003300000000000001000000050000000060000000030030000000000600000000000000030000000500000000000000000000000000000000000000000000000300
000000000000000000000000003000000000000100000003000000000000030100000000003000030000000000000000010020010300103000000000000000000003000000030003000030000000010000000000
300000000000020000000000003000000300000000000303000000020000030000000000000000010000600000000000000000100000001000000023000000010003000000000000002000000030000000000000
333333333333333333333333333300000003033330333333333333033033333100000030333300000000000200103333003033333333303033133130000300300333033301333333033000000533333330333333
