000000000000000000000000000000000000000000630000000000000000000000003000000000001000000000000000005000000000001000000000000300000000000000000000000000000000030000000000
000000000000000000000000000000000000000000000000202001000000000000000000006000200000000000000000600000100020000000000000000000000110000000000000000000000000000000000000
000000000000000000000000000000030000000000000000002003000300350600005310000000500030000000000000000400000110000000000500040000000000000000006640000000020000000000050000
000000000000000000000000000000000000000000003660066100000036600000006100000006600000000000000006000000050000000000000000000000000000000000006600000003010000000000000000
000000000000000000000000000000000000000000035600066000000300600000000000000000600000100001000366000040000660000000000000000000010000000000036600000033060010000000000000
000000000000000000000000002000000000000000333660030030003306600000130000000106000000000000033466000000000600000100000200050000000000000000006600000033660000000000000000
000000000000000000000000000001100000003030333333033333330000333000000000033033333033000000003303030303333333333330006000000000000330003000003330303033030300000000000000
000000000000000000000000000000000000000030000000310000000600016000000000010000000000000000000303001000000000003000000060000000000000000000010000000000000300001000300000
020000000000000000000020000000000000200000000001000400030000000000000002000200000000000030002000000000000000000000000000200020030000000000010200000000000000000010000301
020000000000000000200660000000000000601000000000000000000000300000300060000000000000000000002000003000002000000000000006000100020000000312000200000000000000000000000000
660000000000000036600660000000000006600000000000000000000100000000500066000010000000000000006004000000000010000130000000600000360010000336000000000000003000005000001000
660000000000000336600660000000000006600000004000030100000000000500000066000000000000000000066010000000000000110000000306603030660000003306006600000030000000000000000000
660000000000003336602660000000000006000001300000000000200000021000000066050000000000000030060000010010000000502000060000600000660000033366020600600001004000000200000000
333333300033333333333333333300000003303333600000000300000000000000000030030330002000000003031333350100000060000000000003003333333033330333333303303003333330000000000000
