000000000000000000000000000300000000000000060000000000000001000030000203000000003000000000001030000000000000000300000000000000000000300000000000000000000000000600000000
000000000000000000000000000000133100000000000000300000000000000000000001030101000003000000000003300000000600005030010000000000000000000000000030000001000000000000001010
000000000000000000000000000000100000000000000000000000030000000000000000000000000000060000000000000000000000000000000000030000000030006000000000000000000030000000000000
000000000000000000000000000000000001000000030000200001000000000000000000000010000000000000000000600000000000300000000000100000000000000000000000060000000300000000000100
000000000000000002000000000000000000002000000000000000000000000000000001600000010050000000315000000000000000000030000005000000000000000000000002000000400000000000000000
005550000033000002002000000000000000000002000000010000100055500000000000000000000031000000000000000003000000000000003000000000005550000000020002300005550500033000000000
000000000000000000033333000000001000000003000000000000020000030000000000000310000600000000000500000010000000000010000000000000000000000000110001030000300000000000000030
000000000000000333000000000000000000000003003000003300010000003000000003100000000000000000003300006030000000300300330000000000000000100000030000500000000303030000060000
000333000000000000000000000005000000000000000000010000000000000000000000002000000000000030000000000000000100000000000000003330000000000000000000050000000000000000000000
000000000000000000000000000000010000000000000000000000000300000000000000000060000000000000000000000000000000003006000000000000000000000102000000000000000000400000000000
000000000000000000000000000000000000000000000010000000000000000000000000000000000000030000000000000000000060000000010000000100000000000300300201000000010000000000000000
000000000000000000000000000000000000000000000000000001000000000000000000020000001003000300010000000002030030000000000000500006030000000000000000000000000000001000000000
000000000000000000000000000030000000600000005550000000000060000000010000001030043300005550000000006100000000000000030000000000000000000000000000000000010000000000000000
000000000000000000000000000000000003330000000001000000003330000303000000600030000000000100001000010000033330010000300003000300100000033000000005000333000000000000000000
