000000000000000000000000000003000000000105300000600003030000000000000000000300000000000000000000003100005000000000000005303000100000505000000000000100000050000000000006
000000000000000000000000000033000001000020000000030000000000010500000000000003003000000000300000000000000000000000000030300000000000001100000000000000000033000000000000
000000000000000000000000000000000010000030000000000030000000200000000000000000000330000001000000000000000000020000000300000000000032000003000000000000000000000000000000
000000000000000000000000000003000300003300000300000100000006600001001000000000000006000020000000010000000000663000000000300000100330010000000000000000000000000000000000
000000000000000000000000000003000000003300000000000000000006600000000003000000000000000000000000030000300000610000050000300000000300000560000000030000000103000000000031
000000000000000000000330000003000000000000000000000002200006000000000000002203300000000000000000012001000000660000000003500000200060020066000060000330030033000000000220
000000000000000000000300000006303230330310000002000313331303330001000063030333000000000300000000003033301300330300000000003333033330033303030000100300000000300303333333
000000000000000000005530000000000000000300000000030000000000025500000000000000000000000000000100000300000000000000300000010001000003000002000000005501001000000000000300
000000000000000000000330000050000000010000000000000000000000000330000000000003000000000030300000000300100000000000000000000000000000030000050611300000000000000000000000
000020000000000000330000000000000010000200000000000000000003330000000000000010000000020300000000100000000000000000000020000000000100100000300000360000020000050040000000
000660000000000003300030000000010300006600000030000000000003300630030100000500000000000000000400100300000000000000000000006000000000000000005003301000660000000000000000
000660000000000003300030000000001000036600000000000001000003300030000300000000000000000000000000000000000000000000000001030000000000001000003300303000600000000000000000
200660000002202000000330000030000002006600000000033000002200000031000000000000000000000022033000033300106000000030000000330000000022000000002000000000000000000000000000
333333333333333333300003033300000003334333000100030010003333300003033300000000030000003303331000000030000000000000000006300000300330300000003330000330330300000000000300
