000000000000000000000000000000000001000100000000001000000000000200000000005000300000000005000000000003000000000000000000000000000000000000000000000000000001000000000001
000000000000000000000000000000000000000000100000000000000000000000000000000001000000000000011300000000000000001310100003000060000000010000000000000311000000000000010000
000000000000000000000000000000000000000000000000000000000000000000000500000000001300000000000000000000000000000003010000000003000003000300000000000000000000000300000000
000000000000000000000000000000000000000000000200000000000000000000000600000000002000000100000000000502300000500000000000010000000000000020100000000000000000000000000000
000000000000000000000000000000300000000000000000000000000000000010000000100000001000603000000000010000000000000000060010000000000000000000000000000000000000000040000000
000000000000001100000000000000000000002002003000211000000002202000500000000000002000000020000000000002002000001100000011100000000220200020020000200000006000000000000003
000000000000000000000000000010003003333333133303300000003333333006000000000003133303133303333333333330333000000010330331000000000333330330033330303333003300000000000100
000000000000000000000000000000000300000000000060000300040000000000000000000000000043500000000000060000103000000000100500000010000000000510000000010000000000000000000003
000000000000011110000100000000010010300001111000000030000000001011000000000000000000000000000000000000001000100000000000010000010010100000001000000300000000030000030000
000000010000000000000000000010000005000000000000000000001000000005000000000000000000000010100001000030000020000060000000000000100600000000001000000600000000000010000100
000000000000000000000000200000301000000000601000000033000000000000000000000350000000000000000000000000000001000000010000000000000000000000000000000000200000000000000000
000000000000200000000000000000000250000000000000000000002000020000000000000000600000000000000500300000020000000000000000600000000000000000000000020000000000003000000000
000220200000000000000000200210001000003000000000000100000300000000304011004000000000000000000100044000030110000001000000000000000000000000500000000000200201305000000000
333333333333333333333333333330333330000000333303306100003333333230333300000000000000000000000000003333230000000000300000000001333301300000003303333333333100000000000100
