000000000000000000000000000000000003000000010000000000000000000000000060000000000000000000000000000150000000000020000500000000000005000300000030000000000000000000000020
000000000000000000000000000000000030000000000000000001000000000000000200000300000000100010100000000000000000000000001000000000000000000600000000104000000000000000000002
000000000000000000000000000000000001000000000000005001100000000000006600000000001000000011000000000010000001000000001100000030000100500001000000110000000000000000000065
000000000000000000000000000000000000000002000000000300000000000000000600000000000102030000000000000001032000000000030000010000000000000000123000003000000000000000300066
000000000000000000000000000000000030100060002000000100000000000000000600000003000060300000000003003000006000300000000000000000000000030000612000000300016000000000000016
000000000000000000000000000000000000000060030000000000000000000020106601000000001106000000000003000000066002000000000003000000000000400000600000000000006600000002200060
000000000000000000000000000000000004333033040000033103300300300335333100000003033333033303000030003333301333300333333330000000300000033003133303030333331006000003333033
000000000000000000000000000000000000000000100000000000000000001100000000030000000001000100000000000003000000000000010000000000000000030000000300000000000000000010000000
000000000000020000100000000000000000000300100300050001020000000000000010000000000000000310000061000000030000000200000000000000000000000000000000000510010000000000001000
000000000000660000110000000000000000000000000000000000060000110030010000000000000000000000000000000000000000040650000000000030000006030000004000000000000000000003060000
000000200000660000000000000000000000000000000000100000030000000000010000000000020000000000000000000000000000006600000000040300000000600000000001000500000000000000000000
300006600000660000000000000000000000000000000000010030661000003000010000000000000010000000000000000000030000000000000010000000000006600000030000000000000000000000030000
000006602000660000000002000030000000020000100000002000630000000000000000000000000000000000000000000000000020006601000000600000020003000200000020000300000000000000000000
333333333333333333333333330010000000133300010300030303330133303000000033033000000000000000000000000000010333333000000000060000033333303333000330306000001000000000300000
