000000000000000000000000000000000000020000000000001000000000000000000300005303000000000000000060000000000026000000010000000000000000000000000000000006000000100000000000
000000000000000000000000000050150010000000005000020000000000000000000000000003000010010000300000000060000000001000010000000020000000000000000000001000000003000000000000
000000000000000000000000000000030000000000000000040303030000010000200000001000000000000000000020000000000000000000020000000000000000000020000000300000000000000001000000
000000000000000000000000000000000000000000000010000000000003000006600000000000000000006630000060000000000000100000600000130300000000003000001063000000000030000300000000
550000000000000000000000000000000000000000000000005000000020050003300000000100000000006600000660005506000300000000660000000010000000000660010016000003000003000000000000
000000000000000000000000000010020020000000000003000000000000003006600500003003000002006000000060050000000000000200660000000000000000000660050062000003001000001100000000
000000000000000000000000005533360330000055003000000000000000055333033000010000033331133300013330300000000003003333333030000003000000033300303300353000000000000000000000
000000000000000000000000000000000000000000000000003000000000000001000000000000000000000000000000000010000000000000000000000003000030000000000000000000000000000000000000
000000000000000000000000000000000000110000000000000000000003000000001000000000000000000000000000000000000100000600050000000030000103000000060003000000000000150000000000
000400000020000000000000200000020005000000000200000000010001000300400000000000000000000000000000000000000000400000000000000000000400000000001000001000001001040000000000
000000000660000000000006600000660000000000036600000000000000000000000000000000060000000000000000000000000000000000000000010000003000000000000010000000030000000500000100
000000000660000000000006600005660010000000006000300030000000000010005050000000066000000100000000000000300000013050000010000000000000000000000000000006600000500005501010
000220200660000000002006600520660000000003000000500000000000000000220200000000066000000000000030020000000000220000000000000002000220503000200000002006600300022020000000
333333333333330033333333333333333030003503313033000010000000003333033301000000333331000000500000000000050330333300100000030300333303300000550033303000333333000033000300
