000000000000000000000000000000000000030000000000000010000000040000000000000000010000000000000000000000000000000000000000000000500030030000000040000500000000100000100000
000000000000000000000000000003000000000000001000000000000000000000000000000000000000001030000000100301000000000040000000000350050000000000000000000000010000010000001000
000000000000000000000000000000001000000000000000000000010030100000000005003300000000000030000000060000000000000000000330000000003030000000000000000000033300600000000000
000000000000000000000000000000000000001000001003000010000303000100500300301303000000003333300000000000003300000000333330000000030300000010000000000603000300100000003000
000000000000000000000000000000000000000000000000000000003033003000000003330330000000330133300000000010000020030003333330000000333050000000030000050033033300000000000000
000000000000000000000030500000000010002000000000000000305303300000000023333330000000233333300000000000000000000023330330305000003030000002000000000200333300000000000000
000000000000000000000003330000000003633333003330000000003333333100000033303330000100350030300000000033330000000006333300133000303030300000000100000303133030303033330333
000000000000000000000000000000000000000000000000000000000000600000003000000000000300000000000000000000000300000000000100000000000000000000000000000000000000000000000000
000000000000000000000000000000000000001000000010000030000000300000006000000000000000000060000000000000000000001000001000100000000000000000000000030000000000000000000000
000000000000000000333003330000000000033300000000000000020000000000000000000000003000000000000000000000010600000030000000000000000000000000000103300000500000300000100000
000000000000000033333033330000000300333300000000000333010005000000000000100000000000000000003333000000030000000001100001000000000000300000000103000000000000000000000010
000000000000000333333333330000050303033001000000003330330000060000004000000500000000030000010333000000000030000000000000000100000000000000003033000000000001000000000000
200200000020002333333333330000000000330000000100003330330010000030500020020000002000031000330333000002000000000020020000000010000010020020003003300330500000000000000100
333333300333333333333333333310000030333333103333333333330000000003330033333300033003033330033333333330033100000003010330000000000000500303033503303003330000000000300000
