000000000000000000000000000003000000000000030001000000000003033000030000001000000006000000000030000010000000303000000000000000000000056000000000000000000000000000000000
000000000000000000000000000000000400100000000000002000000000000000000000000001000000000000000000000000000020000002030030000000000000000000000000000000000000000000200000
000000000000000000000000000000000000003000000000066000000053333000000000000000030000060000000030010000000060000066000000000000000000000000010000000000000000000006600000
000000000000000000000000000000000000100000000503063000000333333000000000000000000000000001000000000000000660000060000000000000000005000000000000000000000000000006000000
000000000000000000000000000000000000000000000000006000000333033000000400000100000000000000000000000000000663000066030000000000000000010000000000000010000000000136600000
000000000000000000000000000030000000010000000200306000033333330000220300000000001000000000030000000000000660000060000003050100000000000000000000000300100100300006600000
000000000000000000000000300000303330000000033330330300330033333333333330000000106000000000030333330003000003033333333333333330000330000100000000100033303300030003303333
000000000000000000033000000000000330006000000000030000000000000000000000000300000000000013300000600000000100000030000000011000000060002003030001000000000030000330000000
020000000000000000033000000000000030000000003000000000000000600000000002000002000000000003000000001000000005000003010000000001030000000000133050000000000200000330500000
660000000000000003333000000000003030000000000000000000000000001000000066000000000000000333310000000300000000000000000000000000000000100033330000000100003000000330101000
660000000000000333333000000003333300000000000000000000000000000000000060000000000000003333300000000040000000000000000000000010000000003033330004000000500000333000000000
660000000000003333333000000033333030000100030000000000000000000000000560000300003000333033000000000000000010000050003300000001000300033330130300000000100030303301000000
660000000022033333333300000000233030000004000300000003000000006300000060000000000001330033300000000000000000220000000000302200001000033330330000010000210033063330010006
333333333333333333333333333310033300000000000030000036030000000433301333303330010000033333303003000000000333030300600003300030000000033030300003000030333303303330000100
