000000000000000000000000000300400000301000000000000003000000000000000300000100000000000000000010000300000000000000000000000003300000000000000000000000001030000000505000
000000000000000000000000000300000000000000010000000000001000000000000000000000000040004010000501000000000000000100000000000003001000000000030000000000000000000000000000
000000000000000000000000000000020000004440030000000020000004410000003001000000000000000444000000000000000000000000000000000020400000310004400002000030001000023000000000
000000000000000000000000000000660000000000000000030660000000000000000000000000000000000000040000000060000300000000000000000000000001000000000060000003000000060000000000
500500000000000000000000000000630000005001000000010060000000000000000000010000002000000000000000000006000000000000000000010000000000000001000066000000010000100000005000
000000000111000000000000000000665000200200000000000660000000200000000000000000303000020000000000000066000000000200060006000000001010002032100066000000003200600000000000
000000000000000000000000000033030333330303000040003330330003033000000000000000000000333333310001003033333003333310000000010000000000033350303000303003330011031030000000
000000000000000000000000000000001000000000000000300013100003003000300000000000000001000000000000030000000000000000000000000000101500000300000000000000000300000000000000
000000000000000000000000000040000004000000000000300000000003000000000006000000000000001000000000000000100000003000000010000003000300000000000000000000000000300000000000
000444000020000000000000200000000000000000000000000000000000030000000000420000002000000000006000000013000000200000000100000000000000000020000004100000000000600000000000
000000000660000000000006600000000003000000000000000000000000000000000000660010006000000000000000003000000006600000000300000002003600000000000000000000000050000000000000
000000000660000000000006600000000010101000000003000000000000000030000060600000006000000100030000030005000033600050050100001000003650000060000000000000011000000010000000
020020000660000000002006600000000000000002000000000111000000002001110200660000066000000110000000100100000001600000000000100002006600000000003200200000030000110000030050
333333333333330033333333333300000000033303000300000000000033300000000035303003333330000000000000000000000333333310000000000330303033333033333333330000000000000030006000
