000000000000000000000000000000000000000100000000100000030000000000000000000000000000000040000000000003000000000000000000010000000000000000000000000000000000300004000100
300000000000300000000000010000000303030000000000000000000200050000030000000300000000000001100300001000000000000000000000010000000000000000000000000000000000001000000000
000000000000000000001111100000000000000000000000000000016600000000000100002000000000000020300000003000610160000000000200000200000000011110100000000000000411101050000000
000000000000000000000000000000001000000003000020001000006003000000000030000005600000000000000006000000000060000000000000000000000000003000030000200030000000310000000000
000000000000000000000000000000000000000000000000100000006603000000000000000000001031000000000000000000000010000300000000000000000000000000040006000000000016000000000000
000000000000000000000000000001000050000004000000030000000600000000300000000000000000000000003000000003000600010000000000000000000000000100000000010000010000000000050000
000000000000000000000000000001300000000000000000000000003330030000000033033333333000330303333130000010003030003303000000000303303300000000000000010000000001000000000000
000000000000000000000000000000000000000000000000000000000000010000010000000300000000000000000000001000000000000000000000100100000000000000000000100100000000000000000000
000000000000000000000020000000001000000000020000000000001000100300004000000050000030000010000000000003030000000002000000000030000000030000000000000300000000000003000000
000000000000000000200660000011010000000200160400000000001110100100000300000005000000011106000003000000000000000166000000000000000000000000030010000003000066000600000000
000000000002000000000660000000000000100101360000100000000000000000001100002000000000000000000302000000000000000066000000000000000020000000000000040030003060000000000300
000000000000000000000660000000000000000000660000000000000000100000000000000003060000000000000000003000000000000160000000000000000010030000000000000003000066010000000003
000000000000000000000660000000000000000000660000000000200000000000100001000000000021030004000000000000003000000060000000000000000000000300003000600000001066000000000000
333300000000033303333333003300000001313303333000310330000000000000000000000030001000000000000000060506000005000033300301002000000010300000001303003000000030303021033000
