303300000000000000000000000300000001000000000000000003000000030000000000000001000050000000600300030000000000000430330000000033000000030000001030000000000000000100000300
100000000000000000000000000000003500000000000000000030001030100000200000000000000000000000000000000002000000000010030000010060000000000000001000000600000000000010000000
000000000000000000000000000000000003000000000000040000500300000000000000000005000000400000000000000000010000000000000000001000030100600060000001000000000000000000000030
000000000000000000000000000000000000000000000033000020000000030030000000000000000000000010000000030000000000000000000000000005000003010000000000000000500000000000300330
000000003000000000000000000030000001000000000003050010000000330300000000000000000000001000000000000000040030000010000000000000030000000000000000000030003000000000000300
000000000000000000000000000000000000000000000033000000000000330000003000000000000003000000000101000000000000000000100020000000000000000000000000000000000000000000000333
000000000000200000000000000000000000000100001330310333003001333030000000000005133033305330310000003333333000000000000000000300010002004010330100000000002035333303330303
000000000000000000000000000000000000000010003000300000000001000303000000000003000000000000000000000000000000000000200000000000000000000000000000000010000300050200005000
000000000000000000000000000030000000000000500000000000000000000100000000000000000000000000000000000000000000001000000000000000100000100500000000000003000000030000000000
000000040000000000000000000003000000000000000000003000000000000001000000000030002006000000000000010000000010000000000000000000000000030000000000001004000050000004000000
000000000000000000330000000000300000040005000000000000000000000000000500631000000000000000000010000010000000030003000000000000000000000001000100000000000000000000100000
000000000000000000330000000040000300010000300000000000000000000000000000000000300000000003001000000000000000330000000030000000000000000003300000000000301000000000060000
000000000000000000330000000000000600000000030030000041000000000000000003000000000030006004000000000000000300033000000300030000000000000003300000003000000000110000000000
333333330333333333333333333333333300000000002000033333333303333300000000333330000020333033300000000000050333030300000000030333333031033303330000000000000033333033000303
