000000000000000000000000000000000000000000300000000000001000000000030000000000000000000000000000000000600003000000000000000000000000000000000000000000000000000000000030
000000000000000000000000003001000000000000010000000000300000330000300000100000000000000000030100000000030000000000000040000000000000010000000000000100010000000000000000
000000000000000000000000000000000105001000000000000001000000000000060000030000000000000000000000000000000000000000000001000002000000000000000000000000000000000000060400
000000000000000000000000000001000000100000000006600000001000000001000030000000100300000000000000000000100000000000000000000060300000000100000000012000100000005000000000
000000000000000000000000000000000000000000000006600000000000006300100001000000000000000000000000000400000000000000001000000136000000000000000000066000000200100000100000
000000000000000000000000000000000000000000000006603000300010000000000000000000000000000030000000000010300000000000000000006066000000000000000000000000000000003000000000
000000000000000000000000000000000000000603333030300000000000000330333003000000000000000001000000200000000000000000000030333333033000000000003333330000000000000003151330
000000000000000000000000000000000000000000000000000000030030003000000000000000000000000000000000030000010000000000000000000000000000000000000001020000000060000000000000
000000000000000000000000000300000350500000000100000000030000000000000100000010000000000000000000130010000000000000000000300003000000000000000000030000000000000004300003
000000000000020000000000000000000000103003000050000000000000010000003000000000000002000000001000010000030000000205000000000000000000003000000000000000001260000000000300
000000200000660000000000000000000005000002000000000100000000000003000200003000030001000000200000000000000000001600000000000000000000000030000000000030046600000000000000
000006600000660000000000000000300000000060000000000010000000000000300600000000003066000036000000100000000000006600600660010000000000000000000000000000006000100000000000
000006600000660000000000000000003000000066000000000000000010000000006600000050000066000000100000000000000000006600000600300000500000000001000000000000036600300000000001
333333333333333333330000000033331310333330000000000000000000000003033300000000330333333303300000103003033033330333033330000000333333000100000000000033303000000000030000
