000000000000000000000000000003010000000000000000000000040000000000100000004005000000060000010010030000000000000000300000000000000000000000000000000000000000000000000000
000000000000000000000000000000000000000000050000001000000000000000000000000000000003000000010000000000000000100000033600000000000600000001004000030000000000000000600060
000000000000000000000000000000000000000500100000000000000000000300000000000000000300000030000000000000000000000001000000006000000300000030000040000000000000500020030003
000000000000000000000000000000000000000000000000000400000000000000000000000000000000100000000000000000030000000000030000001000000000000000000000000000000000000001000000
000000000000000000000000000000000000000000000001000000000000000060000000000000600000000000000300000000000000000000000000000000000000500000000000000000000300000003000000
000000000000000000000000000000000000000000003000000000000000000200300001000000001010300000000000000000000000000000000030000220000100000000000000000000002020001002100000
000000000000000000000000000000000043333033000000000000000000300333333003300031000000300003300000000000010000000003300000033333000010000004003333303303330310300033333100
000000000000000000000000000000000000000000000000000000003000000000000000000003001000000000000000000030000000000006003000000600000000000000000000000000000001000000000000
000000000000000000000000000030000000000000000000000000000000000000000000000000000000000000000000001000000000000060000000000000003000000003000000000000000000000000000000
000000000000000050000000000000000000050000000000000000000001003000000000000000000300003003300000000003000000000000000000000000000000000000000010000020000000000030003000
000000000000000000000000000000000000000000000000000000000000000010000000000000100050000000000100100000000000000000000000000030000000000006000003000000000000000000000000
000000000000000000000000000000001000000030000030000000000000000000000000000000000000000000000000000000000000060000000000000000000000300001050000000000000000001000030000
000022020000000000000000000020000000000000000000100002006000300000000000002200000000000000000000002000013000022020001000000000060000100000100000000000000000000000000000
333333333333000330003333333313030000330000000000030003363333333200003030033000100000033000300010003303300303330033303000033333000000000000000000000010000000000000000000
