000300000000000000000000000000010000000000000000000000040000000100000000000001000010000000000030000000050000000000300000000000100000000000000000000000300000000000000000
000000000000000000000000000000035000000000000000000000001001000000000000000000000000000000000000000000000000100130000000000000000000000000000000000000630000000000000000
000000000000000000000000000000220000000002000000010000000000000000004000000000000000000000000010000000000000000000020000000000000000000000000001002003000000002000030000
000000000000000000000000000000660100000006000200010003000000000040000600100000000000000000000100000003000000000000000000300000000200000000000003006011000000000000030000
550500000000000000000000000000260000000006006600100000000000000006000000000003000002100100005010000000000000000000661000000000306600000000000000060050000000006000000010
000000000110000000000000000000030000000060100662010000000000000022000250000000001000001300000000000000000001003000060600010000046610000000000000066003000000000100000000
000000000000000000000000000003333333300003330333600000000000000303330300000000003300000003000000000000000003030030331036003200333333100000003100033000000000000000003000
000000000000000000000000000000100000001000050000000000000013000000000000000010003000000000033000300000000000000003000010003030000000000000000000000000000000000000000000
000000000000000000000000000030000000000000000003000010000000000000000000000000000503000000100000000000003000000000000000000000000000000000000000001000000000000000300000
000444000000020000000000200000600600000001000444000000000000000000000200020003000000000200001044400011000000000000000000000000000000100000000000000000414000000000002000
000000000000660002000006600000000000000300000000000000010050002000006600060000000060006300000000200000063000200030000000000003000006630000001002000000000000000000361030
000000000000660066000006600050000030000000000000555150000060000300006600664005505060006200005000000000000000000000000005305000000006610000000006000000100000003000000000
022020200000660066020006600000010000000000020000200030000066020000006600600001000000006600002205020000066306102002002020000000000006600000010016120026020000000000066000
333333333000333333333333333300000000000000113330300000000333333030003333333335100001100030133003333330003300333313330330000000300000030000033033350331333000000003333330
