000000000000000000000000000000000000000000010000000000000000100000000000000000000000003000010500000000000001004000000000030000000001000000013000000000000010001000001000
300000000000300000000000000000310003130000010000000300100000000060000000000300201300000203030000000000000020000006000300200000000000000000000000300020000000000003030003
000000003000100000001111110001011000000000000020000000100000200111113003000146600010000001000000000000000111150310010100600010001110300000000000200660331000002300000300
000000000000000000000000000000000000000001000000066000000000400000000000001000500000500300000010000300000030000000000013000000030000000000000120600600000600000000000000
000000000000000000000000000000000000000000000000006000400000300000000000000006000003000100000000100000000000000000000006000000030000000000100006600660000000000000000000
000000000000000000000000000000000000000100000000016001000000000000000000000006000230300001000000000000000000000000000006000200000001003400000006600660020000030000004000
000000000000000000000000000000060000000000031333313333331033310060000010000003333003000100003000003333350000000500000003300031500000000000003003303313330303333300000000
000000000000000000000000000001000000000000000100000000006000000000030000000000000000000000000000000000000000000101000000000000000000000000000000300000000000003000000000
000000000000000000000020000000000300000000000000000000300000310000000030100000003000020000000000000000000000000000000030000000000300001000000000000000000000000010000330
000000000002000000200660001030000000000000000020033300100000000000000400002000000000060000000000000000240000000100002000000011000020000000000001001110110000000000300000
000000000066000000000660000000030200000000000060000000000000200000500000030000005000660000000000000000606000000000000000000000005600000000000000000000300300030000000000
000000000066000000000660000000000000000000000660300100000113000015000000060000005000600000000000000006600000000000060000000000000060030000100005000000100005000000000000
000000000066000000000660020000000000002000000660000001000000000000000000000600060000360000000000100006001000000000000000000300000260000010000000000000000000003000000000
333333000033333333333333333300303300000000000100300000003033330000000000003330000000333330333333330403333000000033033330000000000333331303300000300000101003031000000000
