000000000003000000000000003306000330000300000000000000000053000000000000000330003000030010000000000000033010000000000000000000005330000000000001300003000015003000000033
000000000000000000000000000000000000000000000600000000300010030000000000000000000301000003000000300000000000000000000450300000000000000000003001001000004000000000000000
000000000000000000000000000000000000000000000001000003330000336100000000000000000000000000000003000300000000100000003330000000000001000000010000300000000000000000000010
000000000000000000000000000000002000000000000000000030330000300000000000000000000001100000000030030000000006020000033330000000000000003630000003333000300000001000000000
000000000000000000000000000000000000006100000000000013300033300000006000000000000005000000003333100000000000060000033330000000000000000000060033330040000000000000000000
000000000000000000000000000000000000000005000200003330300333330000100000000000000000000000003330300000000000660003333300603000000000000000000033330000000030000000100000
000000000000000000000000000010010000003000000000033300300103333000000000000300340030000000003333003005003000433130333130000000010000003033030030360000000033033000000000
000000000000000000000000000000000000000000000000000003000000030000001100000000000300000000000003000000000000000000003330003000000000050000000000000000000030003000050300
000000000000000000030000000000000000000000000000000100000000000000000000000000001000000003000300000100000030000000000000300000000000000000000000000000000001000000000000
000000000000000000333000000000000000000000100000000000000000610000000100200000000030000003060000000030000000000100000000600350000000000000000000000000000000000000000001
000000000002000003333000300000030000000200000000000330000000200010030000000000000000000300000000000030000000100000000000000000100000000002000003000000000000002000300030
000000000066000033330000000000100100006000000000000500000006600000000000000300000000000000000003000000000000010050000000000000002000000066000000000000000000006000000000
000000000066000333330000000000000000006600000000001000010000005100000000000000000030400000000000000000000000000000000000000000000000000006000000000000000000036000000000
333330000033333333333030033300003330003033000000133300000003333000000003303000010000030000300000003333300000000003000000000100333310000033330300303000000000003336000000
