300000000000000000000000000000000000000000000300010000000000000300000040400000000000000000000001103500000500000000000000000000000000000000003000001000000000000000000000
000000000000300000000000000000000001010110000005000000000000030100010000003550000000000005060000550000000030000100000030020000000000000000503400000000005000000550000000
000000000000000000000000000000000003000000000024003005000000000300000011000100000000020014111000100000033000000000000000000000000000300000410000000010010001100100000000
000000000000000000000000000000002000000000003000000000000000000000000000030000000000000000000010000000001001021000002000005003000000000000000000000000000000100100000000
020000000000000000000000000000000020000000200000401000000000006000000000030005000000000000000000100000000000230200000020000000000000020010000000001200000000000000000000
000000000000000000000110000060000100000000000000000000000000000020000000000001000000000000000000001600000000001000000001000000000000000000000000000000000000000000000000
000000000000000000000000000000330000330330000033300000000000000303331333003333000001000033363333030000000333030036035000000000000000530303330000000000003333333360000000
000000000000000000000000000000000000001000000503000010000000000000000010000001000000000000000600000000000000000000000100301000300000006003000100030000000000000000000000
111011000000000000050000005503000500000013000000000000000000050000100000000000000000000003000005001000110000000000000050000000000000013101100000000000010100000301110111
300000000000000000141110001011000300001200000000000000000000041003000000000001000010000000000000103000000010000110010000000006003600030000000000000000000000000000000000
000000000002000000000000000000000003050000000000000000000000000000000004000000000200000000000000006000000000000000000000000000100000000000101000200030000000300000000000
000000000000022000000000000000500000400000000100030000002000000000000002000000000002001000002100300000000000000000000000000000020000000000000000302000000000000000000000
000000000000000000000000000010000000000000110100000000000000000110000330000000000000000100000000000000000000000000000000000000000000000000000000000100000610110000000000
333333333333000000333333333360333300000110000000000000000000033000000000000000300100000003000000003333333000030000000030000000001000033033303003300000000000000000333030
