000000000000000000000000000010000000000000000000000000000003000000030000000000000000013100000200000000000000000000003000130000050000000000000000302000000000000000000003
100000000000000000000000000000000040300000000000000001000000000000000030000000000000000000000000000000000023000002000000000000000000000000600000003000000000000010000000
000000000000000000000000000000000010000000000000000003000000000000000066300000020000000000030000301300000600000166000000000000000000000000000000000100000014101000000000
000000000000000000000000000000000000000000000000000000000000101000000006000000000000000000004000000000000300000066000000000000000000000000000030000000000000000000000000
000000000000000000000000000000300006000000300000101000003030000300000006000000000000000100000000000000000160001060100000000030011000000000000000000300000005000000000000
000000000002000000000000000000000000010000000000000000000001000000000066000000010000060000013000000000000260000060000000000300001000000300000000000000003000030000000000
000000000000000000000000000011000000000001000000030330333333333303333333300004000000000000003330310003033330103603300000000000303300033332330033333000010033335303000000
000000000000000000000000000000000000001000000000000000000000000000000030000300500000650000000030000005000000000000000001000000000000000000000000000000000000000100000000
000000000000000000000020000000000000000000010013000000000030000000010000030000060000000000000000000000000100000000000000000101100003300000000000000100100000000000200000
000000000000001400000660000014000040000000000000006000300000000030010000000100400000000000000000000000000000000014000600000005100030100000000000000000000000000016600000
000000000000000000000660000000000400000003000000060000000000000000000000000000000000100000000000000000000000000000000000010000000000000000003000000500060000000001000000
000000000000000000000660000000000000000003000000066000001000000000000000000300000100000000000000001000003510000000010000000000000000000000000000000001000000000306600000
000000000000000200000660000002010000000030001320066000600000000010063000002000200000000000000002000000000000000000000000000000000000030000000000000000000000002006600000
333333330333333333333333000000033330003303000000033300010301000000000000000000336033303333300000005000000000030033333330000000000000000000003033303000000000000033330000
