000000000000000000000000000000000000330000004000100000000000000040000000000100000000003000033300000000000000000003300000000000000000060000100000000000000000010000000000
000000000000000000000000000000000013301000000000300000000000000100000030000001000000000000533300000001000000000003310000000000000000000000000100000000000000000000000000
000000000000000000000000000000000003330000000054000000000060000000100000002000000000000000033206000000003000000033300100000000000020000000335000200000020000100000010000
000000000000000000000000000000001003330001000000050066030010000000000600066000000000060100013300000003003000000033000010000000000666000030033000000000060000000030000000
000000000000000000000000000003000003330001000000000060100000000000000000066000000000000001033000000000003000000033006003000000001660000000030000000300360000000000000000
000000000000000000000033000000000603330000000000000311000000000030000000060000330000330000033000000000500000001003300003000000000660001000030000000000060003300000000000
000000000000055000000333000000000003300131033303000033315000000000000000033630130000033000033000333333030000000033300330000000000333330303100000005000333003000000006000
000000000000000000000333000030000000000000000000000000006000000020000000000000300000030000000000000100000000000040000000000000000000000000000030000000000000031003330000
000000000000000000000333000000000000000000030000000000000000100000000000005000330000000000000000000300003000000000000000000000000011000000001000004000600000000003330000
000020000000000000033333000003000300400002600001000000000000033000000000000003330000000000000000000000000010000000000010000000000000000000000000000000301000030033330000
000660000000000003003333000000030030000000000000000000000003003010000000000303300000000001000006000000100000000003000000000000303003000000000000300000030330000033330000
000660000000000000003333000000000030000000000030000000500000003001000000000003330000000000000061000000001000000000000000000000030000000000300000000000100000000030330000
000660000000000000003333000000000033330000050000000000300000003000000000010003330100500000000060000010000003006003300000000000000000000005001000000003000000014033330000
000333333333333333333333003303033333330000530000030000050303334000300533333303330033000000000033030323303500000033300003000000000000533003133033333503001033333333030033
