000000000000000000000000000000000000000000000000000000600000101000200000000000001000003000000000000000000000000000030020000003000000300000000000000000000000000000000000
000000000000000000000000000000300000000000600000000000000000000000000000000000000000000000000000000000000000000030500010000000000000100000500040011000000030000300000000
000000000000000000000000000000000000000000000010000000000000600000000000100000002000000000000000000000001000000030000000000000000000000000000000000000000001000000000130
000000000000000000000000000000030000000000003000000000001000010000000010000000001000400010000001000000000000000000000000000000000000060310000000000000030000330000000000
000000000000000000000000000000000000000000000000100000000000000600000000000000000000000000000000000000000000000000000001000000000000000000000000000000000000000003000010
000000000011110000000000000031320000020220000000000000000001003000000000000000202000000000000000000001111000000000000000000000002022000050000202300000010000000050000100
000000000000000000000000000033300332033303333333000000000006000330000300000003303313000000000000000000000000010000100000000000333333333000033333033000000033300003003033
000000000000000000000000000060000000000001000000000000000000000030000000000000000000600000000000000000001000030000300000100000000000000000000000500600010000000000000003
000000000000000000000000000000000000001000010010000000101000000003000000000000000000000000000000000000000003000000000000000000000000000000001000000000000000000000000000
000000000001100000000000000000000000000000000000000000000000300000000000001000000010000000400002100000000000030000000000000100000000000000000000000000000000000010000100
003300000000000000000000000000330000006000000000000300000000000000100000000000000000300000000006060000000003300060000000000000000000000000000000600000000000000000030000
000000000000000000000000000000000000003000000000000000000000000000300000000000000000003000000300000000000000000000000000010000000000000030000000000100000300000000000600
000000000000000020220220200000000000000000000000003001110020220000000000010001000000012022000000002202000002010022020000000000000000001011100000000000000006012200001111
333000333333333333333333333333300030000000000000000200603030300000000000000003003333033303353330333303310330000333030333333330020000000000000000006000000003333330000000
