000000000000000000000000000000000000010000000000001000000000000000003000100000005000000000000000000300000000000001000000000000000000000000300030000000000000000000000000
000000000000000000000000000000000300300000000000001000000101100000000004000000000002004111311030000000000000000000000000000000011111000000000010000000000000000000600300
000000000000000000000000000003000003003000330000300000000060003000000000000000000000030000300003000000000300000300000000000000001000300000000000000000200000030000000000
000000000000000000000000000000600000000006000000600000000000001010005000000100000000010000000000000050000000000000000000000003000001000000001000000000100000350000030000
000000000000000000000000000000000000000000000033500000001000000000000000000010000030100000000000000000000000033500000000000000000000000000000000000000000000000000000010
000003330000000000110100000002000003000000000034301000000000000000003300000001000100000000000000000004030000100300011100200400000000100030330000110000000000000303000000
000000000000000000000000000033033000100000003333000000030333330000000300000000360000003033000030000000000000100300000000003300033333000000000000000000003101001000000000
000000000000000000000000000000000000100000000000003001000006000000000000300006000000000000000000000030000000000000000003005000000001000000000110000000000100000000000000
030002000000000111110000000000003000000000030002000111100000000030012000300000000000030002040000000000000000000000000000000000030102000000100300000000000000005000101150
333000000000000000003330000300010000006000313100003000131000500333000033010030300000333000000000000000000000000030000010010000333000000000003330000030000300000000000103
000000000000000000000000003300000000000000500000100000000010000000000003000330005000000000000000000000000003000000000000000000000000000000000000000000003350000000000000
000000000000000000000000033500000000000000000000000000000000310000000001003350000000000100000000000000001300000030003050000000000030100100000000000000033500000000000000
000000002000000000000000033300000330000110000000000000000000010015000000003030201002000000010000000103110020000000003330003000000006011000010400001000003002200000000000
330333333333000333330003333300000000000000300333303330600000000310033000333333303300330333300000000000000333335000010330000000330330300000003303333043033303333000103330
