000000000000000000000000000000000000000000000101000000000000000000003000000000000000000306000000000000000000000000000000000000000101000000000003000000000000000303000000
000000000000000000000000000000000000000000300000000000000000000000000000000303003000006000000033000000000000050000000000000000000000000000000000000000000003000030000000
000000000000000000000000000000000000033053000000000000000000000000444000001000000000000444020000000000000000000000044300030003000300000000000100000000000400000000001000
000000000000000000000000000000020000103003000000000000000000000000000000000030000000000000010000020030000000000100000003003003000200000000000000000000000000000020000000
000000000000000000000000000000060303333001000000000000000000000000000001000600000000000000000000660000000000000000000003330000006600000000000066033000000000000060000000
000000000000000000000000000000060333333210000000000000010000500200000000000660000000200000000010660003000000000020000013333000106633300020000066030000000000003000000000
000000000000000000000000000313331333300033030000000000030000000303333013303330000000330033300330300000003000000023031333300303133330300000030033033000000033333300000000
000000000000000000000000000000010000000030000000000010000300000000000050000000000000000000000000000000000000000000030000000000300000000300000000010010000000000000000000
000000000000000000000000000300000000000000000000000000020000000000000000000000000000000000000000030000000300000300000000000000000000000300001000000000000300000000001000
000444000000000000000003300300044400000300010000010000000400000003300000000000000000000000101330030000000000000200000005000000000100000000100104040006000310000000003000
000000000000020002000333300300000000000002000000000000001002000303000300000003000030000000033330000000000000000000000000000000000010000000000000300330300000000000300003
000000000000660066033333300310000060000060000000000000000065133033300300000000000000006603333000030000003000000000000010000003000000000000000000000330000300000000000000
200000000000660066333333300020000000000066000000000010000066303033300000000000000000006633330330000000000000000000000060000000000000000000002000400333000000040000000000
333333333333333333333330000330333533033333000000003000003303333330100100100030000000333003330000030000000000000000320030000000000000000500003332332336300300000000000003
