000000000000000000000000000010000000000000000000000000000006000000000000000000000000500000000000000000000000000000003001000000000000003000000000006000000000300000000000
000000000000000000000000000000000000000000000000000000000000033000000000005000000000000000000000000000000000010000050000000000000000000000000000000100000000000000000000
000000000000000000000000000000000000000000000300000000034000000000000000044500000010005000000000005000000000000000500000000000000000100000030000000350000000000003200003
000000000000000000000000000000000005200000000000000000000003000000000000000003000000000000000000000000000003000000000000000000000000002000000200000616010005100000030000
000000000000000000000000000000000006600000000000000000130000000000000000510000000100200000000000000003013200000000000000000003000000666000006000000000000100000000000000
211100000010000000000000000000000000600200020210000100000000220201010000010000202200011100000010000000000000000053005000202200010000066002006600200020200001110000000000
000000000000000000000000000030033303103330303030300000003000033010000000000003001333000040000000000000000300030333033333303303000000033333033033333333133000000000230300
000000000000000000000000000000000000010010000000000000000000000000000100000100001050000010000000000000000000000000003000001000000000000000000000000001000000000000000000
000000000000000000000000000000000000000000000000000030000000000000000000000000300000003000000016000030000000000000003001000040000020001000000000000000000000000000000000
440000000000000000000000000000000000000001000000044300000000000000000600000000030000001000000000000000000440000000000000000000041030000000000000000440000000000000000000
000000000000000000000020000000000001000030000000030000300000000000030002000001040000000000000300000000000000000000000010000000000000020100000500000000000050033001000000
000000000000000000000660000010000000000000000100000000000005000001000060500000001000360000003000000100130000000000000000000000000000000000000000001000000000000000003000
000222000000000202200660020021010000000000003300000000206000000000000066002000000100060020002022001000030010022600000000000000000002020100003000500000222000010000000000
333333333033333333333333333300000000000000000000031030335001000000100033303030303333303300033333330000000333031000000003000000333013300000003603333333303300000201010000
