000000000000000000000000000000000006000000000000000000000000000003000000000030010000000600000000030000000000001010000000600060000000000000003300000000010000000000000000
000000000000000000000000000000000000000000000000000000004000000000000000000000000000000000000000000000000000000000000000000000005000005000001000000000000000000000000000
000000000000000000000000000040000000000005000000000000000000000300000000000050000000500003040000000100000000000000000004000000000000000000000001000000000000100000000000
000000000000000000000000000000000000000000000100000000010100000000000000000100000100000001630000000000006000003001000000000000000000000000000000000000000000000000000040
000000000000000000000000000000000000000000000000000000000000000000000000100000000000000000000000030100000000000000000000000000000000000030000100005300000000000000000000
011110000000000000000000000000002000000000000000000000300000000000000103000310000000000003000022160000000000010000000000002200000100000030000000000000000010000000000000
000000000000000000000000005533330030330333010005510000000000000000330130330300000055333303333033330000000000000000003053333033300001000001300000055110000030333033333333
000000000000000000000000000000000000000030000000000000000000000000000000000000000000000000000000000000000000000000000000000000010000000003000000030000000600000000000000
000000000000000000000000000000000000000000000000000000000000100000100000000000000000000000000000000000036000040003000000000000000000000000000000101000010000003030000000
400000000000055000000000000000000000003030500000000000004000001000001000000000000000000000000300000000005000000000000005000000000000300000010000005000600000000000000000
000000000000000000000000000000000000000000000010000060004000030000000000000000000000000000000000000300000000000001030000000030000000000000003000003000000000000000000000
000000000000000000000000000000001000300000000000000000050000000000000001000000000005000000000000000000010000010000000000000000000300000000000000000000000000020000000000
000220000000000000000000000000000000000000013000001001000000000000000003103000000030000000100000000000000031110001110000000000000000300000001000000000000001111000000203
333333333333333333333303333330333330000000333333330000003330003303333300000000333330303033300000153333333000000000000023300003303330300303363303033003000000000000033353
