000000000000000000000000000000300000000000000100000000000000000000000100300000000001000000000200000000000000000000000003000010300000000000000030000000050000000030000000
400000000000000000000000000000000000000000000000000000000500000000010000000000000000000000000000300000000000000000000000000000000000500000004000000000000000030500303000
000000000000000000000000000000100330033033000000000000000000600000000000000003330000333000000000005300100000010060000005030033000500000000050000001003003300010000000000
050000002000200000000000000000600000000000000000005000000000000120002000000100000000010000050000100202020000000000000030001001000000000000000500000000010000001002001000
000000000330333302000000000000000000300000000000000100000000000000300033020010000000000000000500005033003000003000000000000000000000030000010000000000000300020000100000
000000000100000000000000000000000000010000003202100000000000000001001000000001000000000000300010201010000000000010000000100000000202000000000000000005000100000000000060
000000000000000033330000000033333330030300330303000030000000000400000030333000000113100103330033330006300010000000000003033300033330000333330000000303000000313300000010
000000000000000000000000000003000000005005000000000000000000000000000000000001000003100000000000000000000033000000300000000000000001000014000000003030000000000000000000
000000000000000000000000000000000000000000100010010500000000000000000000000204000000400000000000000000000000000053000000000500000000101000000000000000000000340000000000
003003333300000000000000003300000000000600333003000003000000040000003300100300000001000000000100300030003000000000300003300020000003300000003330000000000040000330030030
000000000000000000000000000002010200006000000000060000000000100000031000100000500000050030000050030010000000010002000200000000000000030000000000030020002000000000003000
000000000000000000000000000000330330000001000050033000020000000000000000000000000000000000000000000000000000200506330330000000000000000003000030130003013200000000100000
000000000000000002020000000000100000000010000000001000000002120000000000000000100000300000000000000000000000000000100000000000010400000000003000000001000000300000002600
303330000003333333333333333300000000011000000000300033303130303000330033333300000000000000030333003331333003333003000050000330033330300000000050030000000333333333303033
