000000000000000000000000000000000000010000000000000333330000000000000000000000300000010300000333300000100000000000000000000003333300000000003330000000003000333330100000
000000000000000000000000000000000000000000000000000000000000000000000000000000010010000000000000000000010000000030000000000603000000000000000001000001000000000000000030
000006000000000000000000000000300003060000000000000000000003060100000011000000000000000000000000010000000000000000000003030000000000030000600000102000000000000000000000
000066000000000000000000000010300000000000000000000004000000600000000000000000001010000000000000000600300000000000000003000000000000010006600000006000003010000010000000
020066000000000200000000000030000600300003030023333330000000060000300002000000000300000000033413010200000000000000000003000000001000100306000000062001000030330100333330
333333000000000000000000000000000000000000000000000000053033030000000000000000000000600000000000000030000040000000000000000030000006610303000000063300010000000000300130
000000000000000000200000000000000000000000300000000000530030000000000000002000000000000000000000030000200100000006000000000000033030300000003333333030005003000030000000
000000000000000033333333000000000100000000100000033060000033300030000000300000001000000003033300030000000000000000003300030002000000000000100000000000000000000000000000
000000000000000000000000000030000000000600000000000000000003000000000010000000000000000000000000000000030100100000004020000000000000000003000000000000000000000000000010
303000000000000000000000000200000300000060000000000000030000000000001000000020000005300000000000020000000000300000000030000000000000000000060000000010300000000603000000
000000000000000000000000006600100000100660000000000000300005001000000000000660000000000000000100660000600000001000000000002000000000000000000000000400000000000000000000
000000003333333333000000006602000000200660000010000000663333005013330300000060000000000000000000660200661033333333130000200000000100003033303000010000030102006603000000
000003003000000000000000006600000003033333000000000000060100000030000000000660500030000003000000600330330030000000000000000001000000103000000000000100000003306000000030
000000000000000000003333333300002000050000000000030333000000003000000033330300000000000001033303300000003100000000000031000200000000600000000000200000000600000000000000
