300000000000000000000000000000000050000000000000000000000000000000000000000000000000000000000000000000000310000000500003000000000000000000000100300000003010000000010300
000000000000000000000000000011000100000040015000000061000000000000001000000000000000000000000000000000600000000000030101000000000002010000000000000000000002100000000100
111111111340150000001111111100000001104005406104100001110101011100000011310034414040101011015000010000001110110110010000151111011100111043054004000000000100000036600101
110000000000000000000000000010000000000000000000000000000000000100000000000031100000000010010000000010000000000000000001003000000000000000000000000000000000000000000040
000000000000000000000000000000000000000000000030000000030000000000000000020000000000050000000000000000000000000000000000000000000000000000030000300000164001000000000030
000005050000000000000000000060000005030000001000000000000000000600003050000000000000300000000000000000000000005060010030000150000000050300000000000031000000000000000000
000000000000000000000000000003033330000000003330303030330000000330330300000000030533000000003033330000000000000033330330000000000000000000000333001000000030333333333331
000000010000000000000000000000300001114000000000000001001000001000000000000003003000000000010000000000000000000000000001000000000000000000300000000000000000000003000000
000001000000000000100000000000000000000100000003000000000000000000000000001000000000000000000000000010100400000000000000000000001010000000000000060000000000000100000010
100000000000010000111440404000000000000000101111111111100000061000000000000131111101110400000000010300111400400044040000000001000011100000011111111110401501011111000000
100000000000000000000000000000000300104000010000000001000000000000000100000001101030000000000000000000000000000000000301000000000000000010000000000000000010000001000000
000000000000000000000000000000000000010300000000000000006000000000000000000003000000000000000000000010000000000000000000000003000000300000001000001000000000500000310000
600000000000000000000000000030000000000000100005000000000100000000000000010000003050100000000100030000000000000000000000000000000000000000010030000500600000100006100000
333333333333333333333333333340140003333333000000000500000305333010000003333330130000000100003303000333333313060033333333333031333331300000000000000000000001005000130003
