000000000000000000000000000000000003300000000000100000000000000030000033000000000000000000000000003000000000000000000113300060000000300100000000000000000000000000000000
000000000000000000000000000000003000310000000000000000000000030000000033030000000000000000000000003300000000000301000003300000000000300000000000000004000010000060000000
000000000000000000000000000030000003300000600000010000000000030000020033000000000000000020000000003000030000033300000003310600000003300000000000030000000010010000060003
000000000000000000000000000000000003300500000030000166010000000005060333000000000000100660000000003000000000333300000003300000000303300000000030000000000000000000300000
000000000000000000000000000000003600030000000000000030000000132000610301000100010000000660000000003000000000333300000000030003000330300000000000000000000000000000000000
000000000000000000000030000000000003300000000000100066000000000000100033000000000000000000000000003300000033000303003003300000030133300010300000000000000000000000000001
000000000000000000000333000000000000003333330000000033333333033003303300033330100000003330300000000003333330333133300000000300333303300000003030333000000000000000000000
000000000000000000000330000000000000000060000100000000006000000000000001000003000000000000000000000000000000001000000100030000000000000000000000000000000033000000003000
000000000000000000003330000000000000030000000500100000000000003000000000000000000000000000000000000000000000000000000000000000020000000000000000003001300030000000050000
000000000002000000333330000000000130100300000030400000010000333000000000000000000000030000000000000000000000000000002000000000000000000000000000333000020030005000000000
000000000066000003333330000000003300000000000000000000000003333000000600200000400000000000000000000000000000010000066000000000006000000000000513303000000003000000000000
000000200066000003333333000000030331000000003003200000000003333050010000101000000000000000000000010400000000003000066600030000000000051000000000033000600013000100000000
000000000066000333333330000000330030000000000000000000000333030000000003000000000010000000000000000300000010000000006000000000005000000000000333030000600030300000300000
333333300333333333333000333333303330000100333003300600103301033000000033300000000000000000000233303030000000000000330330000000333303300300003001333003333300031033330000
