000000000000000000000000000000040300000000000000000000000100000000000001000000000000000000000000000000000000000000000100000000000000000000100000000000001300000000100000
300000000000000000000000000004000000000000000000000333000000000050000000000000300001333000000000003000300000000003000001101000000010000003003330000000300000000000000000
000000000000000000000000000000000330000101000000000000000000000000003303000100000000003000003033000000000000000033103000000000003000000000000005000000000000000000000000
000000000000000000000000000000100000000000000000000000000100010000000000000003333330331300010010000000000000030000000000000000000000000000001133330030000000000000000000
000000555500000000003300000000000000001033300000030000005050000000000000000050000000000000003000004010001000000300000000000003001000030000000030300000000030000001000065
000000333300000000000000000000000000000000000000000000003030000000020000000000000000000000000030000000003000000100000000015000000020000000000000000000000010000100000003
000000000000000000000000000033333130000310100000033330030000000330033300000010000331100033003033330000000000000033003330000000333303300000000300300330300300000000000000
000000000000000000000000000000000000000000000000000001000010000003000000300000000000100000000020010010000000000300000003000000000000000000000000000000000000000000000000
333000000000000033300000000030011000000000000000033300000033300000110100600000030303003303000000000200000100000003033000000000333000030610000000000000000000000000000000
000000003333000000000000003300000003033300000010000000000000000330300000001000000000000100000000000000100000303000000003000030001000050050000000000000113303333000000000
333333000000000000000000000000510004000000000000036333300000000000000000000000000000000000000000000000000000000000003000000100333335000000003000000000000000000000100000
000000000000000000000000000000000000000000550000000030000030000000000000001133001000000000003000005550100000000000160105550000000000003030050000003000005000000000150000
000000000000000000000000020000000000200000033300000000000000000000000000000000000000001000000000003030003000020000000003330000000600013000030000000000020040000003130000
330033333333333333033333333300000003303330000300033003633013033153153300000000000000333603300000000000010303333333330330000000300033300000000000000030303130333330000000
