003000000000000000000000000000000000000000000000000300000000000000003000000510000000000000000000000005000030000000001000000000000500000000050000000010000000000000000000
000000000000000000000000000000000000000030000000000000000100000000000000105000000000103000030000000000000100000000000300000000000000500000000000000000000010100000000000
000000000000000000000000000030000000000000000000002031000000000020000030000000030000003000000000000030000020400000000010200300100000000000000204000003000000000000010000
000000000000000000000000000003000005000340000000006001000000060660000000000000000300000003100003100000000660000000000506000000000160000000006000000001010010000000000000
000000000000000000000000000000000000000000000000000000000000010160000000000000000000000050000300000005000160300000000006600000000060000500006000000010000000000000100000
000000000000000000001111111010011100000001000000433000003000000300000000000000000000000000100000050000000330003011111103300300300000000000003300010000030100001000000000
000000000000000000000000000000000000000000000000033033330433333300333300000003313331000000030000000330333333330000000000330303333003300300003033333000000000000000300313
000000000000000000000000000000000030000000300000000010000000000003030000000000050000030000000300010030000000000300003003000010000000000300000000100003000000000000000000
000000000000000000000000000000000000000000000005000000010000000000000000000000000000000000000200000000000000000000000000000000000000000000130000000000100000000100000000
000000000000000204100001000010000000000000001000030000000003000001000000000000000300000000120300000000000000000011100000000000000000010000000000100000000000011001000000
000000000000006600000000000000300003000000100000000000000000000000000000000000000000000000000000000100000000000503000000000000000000000000000000000000000000010000100100
000000000000006600000000000000000000000000000000000000000000000000000000000500000100000000000000005000000000000000000000000000000300000030000000000100000000100000000001
300000000000003300000000000003001003000000000000010000001110010000000000000010000000001000000010001111110000000000000000100000000000100000000000000000000011131103000000
333333330000003333333333333300300013033313130103330000000000600000000301100103000000333301000000000000000000000030335333000000003000010000003006000000000000000003330303
