003002000003000000000000000020000000000000000030005000000030000000030000000000030120000000000300200000000003000000000000000000003002000000000000300333330030300200300000
000000000000000000000000000000000000000000000030000000000000030000000000300003000000000000000000000000000000000000030000010000000000000000000000000000000000000350000000
000066000000000000000000000030000000000000300010300000600000000000000030001000000660300000000006600300000003033300000330000000000016000000006010000000006000000003000300
000063000000000000000000000000000000000100000000010406003001000000000000000000010600000000000006300000000000000000000000000000150663000000000000000000100000006010000000
020066000000000000000005550003333001001503000000002006600000000000000000330000200660033330000600600000000000000000000000333300520066000000000000000000000002000600005300
333333333333300000000033333300050000233333003011000333330000000330130000000003331303000000033330030000030000003000300303030000333333301040003333330000000033003330036000
000000000000000055000000000000000000606001000000000000000153010000000100000000000000000000000000000055000000000003000000000300000000100530000100300000000000000000000000
000000000000003333330000000000003003333330003050000010100013000333033000000000003000000100000000003330000000030000000003033330000030000000000000000000000000000000000000
000000000000000000000000000000000000000000000000000001000000000000000300000000100430000010000000000300030100000000000306000000000000000000000000000000000000000000000000
300033330000000000000000000000000000006006000010000000000000000000000030003330000003000000000000000000000000000000000000000000001000000003000010000000000000000003000000
000000000000000000000000000000000000000000005030000000000002000000000000000000000000000000000001000400300000000000000000000000000000000000000000000000300000020000000000
000000003333000000000000000005530000030000000000000000000050500000000020010000000000000000000503000000000000000000000010000000001000000015000000000000000000555000330300
003003000000000000000000000033333040100400030000000000000333033000000000300300000000000000003033330000000013303000000000000000333100003333330000000000000000033300050000
000000000000000000000000003300000000100000000000300500000000000011000000003000000030000000303000000000060000000000000330000000000000000000000010033000000000000000000000
