000300000000000000000000000000000000000000000300003001000001000000000000000300003000000000000000000000004030000000000000000000000000000000000003000000300000001000000000
000000000030000000000000000000060000000000000000000000000000000000000000000000000000010000000000000000000100000500030000000000000000000000001000000000000000003000003000
000000000000000000000000000000000000000000000010200000400000000100000030003000000000011000001000000000100000000000000000000000000000000000000000000050010000000300000000
000000000000000000000000000000000000000000000000001030000050000000000000000000000000000000000400000000000000000030000000000000000000000000001000000000000000000000000000
000000000000000000000000000000000000000000001000000050003000000000000000000000000000003000000000000000000000000004000000000000000300000000000003000000000000000000000000
000000000000000000001410000020000000100000000000300000000000000410000000000002200000000000100000000010000220000000000000000000220010010000000000000031030020000010000000
000000000000000000000000000003343030000000300033330000300300010000000333333333333033000030033303333333333330333300001000000000333332300003330000000033333333333130000000
000000000000000000000000000000000000000000001000000030003000000000000000030000000000000000000000000003000000000000100000003030000100000000000000000300000000000000000110
000000000000000000000000000000001000000000000000000030000000005000303000000100010003000300000000000000000000000030000000000000004100000000000000000000000000000000000000
000000000000000000000000010000000000000000003300000000000000000000000000000100030000000000300000000000000001000000000000000000000000002001000000000000000000000000000000
000000000000000000000000000000000000000000000000000000000000000003000000000000000000300000300000000001000000000000000000000000000000000000000000000000000030000000100000
000000000000000000000000000000300400000000000000000000000000000000005000000005000005100000020000000000000000005010000000000000000000000000600000000000000000550000000000
220000000000000000000000000000000000000001000000000000000003003000000000000010000000000000041000000000000000000041300000000000040000000000000000000000000131000000000100
333333330000333333333333333300000020000050330303000000000000533000000000000003330333000000000000000000003330000300000000100010100001333100333000033000000000130003333333
