000000000000000000000000000000003000000300010033000000005001332000000000000000000000000000003000000000000000001000000000000000000000000433000000011000001000000003300000
000300000000000000000000000000000000000010000030000000000000004010000000000000000000000000000050000000000000600600030000003000000000010000000000000001300000003000000000
000006000000000000000000000033300000660000000000000001000000000000000003000000000002001000000000020000000333000000000000000060000000000000300000006000506003330001300000
000066000000000000000000000000000000001300000000000001000000000000000000000000000066000000000000660010000000300000000000000600000020100020001010050000066010000000000066
020066000000000000000000000000000000002000300000000333333000000000100000000400000066003333000000660300010000000000000000200660000000032000300033003020006000000000000060
333333330000000000000000000000000300000000103000303000000000000300000010000000000066300100000000660000000000003030000303000033000000000000003000000333030000000000030066
000000000000000005200000000000000010000000000100300300000000003000000000003003333030000000033030330000200000000000600100300000000520000000030000000000060000000003033313
000000000000000033330330000001000003301000000000000000000100000000000000000000010000000001000030300000000600000030000000000000000000000000000030101000000000000000000000
000000000000000000000000000000030000000040006000000000000000000000300000300000001000000000000000000003000000000000001000000000002000060000000000000000000000300000000000
333300000000000000000000000200000600000000000000000000000333000000000000000000000050000000000330000000000000000001000020000033303000000050010000000000000000300100000004
000000000000000000000000006600006600000006000000006100000000000010000000003000000600001000000000000000000000003000600600000000000000000001000000000005000330000000001000
000000000333333000000000006600006600000066000000000000000000000000000000333330200660000000000000000200660000000000000600003330010030000000301000000000100000000000000000
000003000000000000000000006630033330000066000000030000000000031000003000000303330353000000010000003031310300000000000660030000000023000000000000001000000000000000030000
000000000000000000003333333300003003333303000500300000030000000000120000000010000000000000000100030000013000000033036330000000300000000000000000000100520000000000000000
