000000000000000000000000003300000300000000000000000000300000000600000000000005000030000003310000006000000000000000000000000000000003300000500300000003300000000000003000
000000000000000000000000000000000000000000000000100000000100000000000100000000300000000010000000000000000060000000010000100000000100330000010030001000000000000005000000
000000000000000000000000000044400000000000000000000000400000000000004044400000000000000000010000000000000000004060000000000000000000001000000000040100000000000000000000
000000000000000000000000000031000000000000005000000000006000000000000004000000000000500100003000000000300003000000000600000000000003000000000000010000003001001400010000
000000000000000000000000000000000000000000000000000000003000000000000000000000000000000010000000300000000000000000000000000000000000000050600000000000000000000000000000
111100004444000000000000000003020000022000000000000030001111000000001000020000301000000000300220001110000000000104200000202000000000011100500000030020200000220000444400
000000000000000000000000000063333006033303050000031030300000010333333030333030001000300100033031300000000313303033333303333333000000000000003333633333333333303330000000
000000000000000000000000000000120600000010300001300003000000000000000000000000000000000000000000030000000000000010020000000000000003000000003500033000000000000000050000
000000000000000000000000000000000000000000000000000000030003000000000000004000000000000000000100000000000000010300000000000000100000000000000000300031000000000600000000
444000000000400000000000000000000033000000000001000000000000000006030000000000000000010000044400000000000030000000010104445000000000030000000000000000000000000004410000
000000000000000000000000000020000003000000000000000000001000010000000000000000000020000003000000000000000000000000000000000000000000000000005100000000000000000300000000
000000000000000000000000000010000000000000030000000000003000000000000000000103000030000000000000000000000000001030000000000000010000000500000000030000000000000000000000
000200000000000202000002200011110050104400000000002020000000000040440002006600020000004440000020000000000621000000000000002000000000004404003000000010000011110000102000
333330033333333333333333333300300000000000000000033300030000000000000033333033333033000300233130600000001300333300303013033300000000000000040000300000000000000005330300
