000000000000000000000000000000000000000000000030001000100000000000000000000000000000000000000000000000000000000000000000000000000000000000000000000000000200600000000000
000000000030000000000000000030000000140000000000000300000000000000001000000200603000300000000000000000000000000200000200000102000000000000000000000000000010000000000060
000000000000000000000000000000000000000000001000000000006000000000034100300000000000000000000100000000000000001633330000006001000000000050300000000000000000000000130000
000000000000000000030000000000000000000000000003000000000030000030000000000000000000000003000000000000030000006000000000000006000000010000030000000000000000000000100000
000000000000000000000000000000000003300000000000000000000003330030000000001000000004000000000033300000300030006000000000000060003303300000003000000000101000000000000000
004111000000000000000000000000000000000000000000300411000003330000000000000000000003004111000030000003030001000600060003000066000333000000000000000100000000411106000000
000000000000000000000000000050000000000000000000000000003000010031000030033330030000000001033030030000000000033333030330033333330006000000000000034000000000010003300033
000000000000000000000000000000000003010056000000000000000000000000000000000000030000000000010005000000000100000000000000000000000000500000000000000000000000001000000000
000002000000000000000000000200000210003000000000000000120000000000000030000120000000000000000001000030000000300000600000003000000000000000000000000000300000000003000000
333300000000000000000000006630030000000000000000000000660000000000000000000660000000000300000000003303000010100000000000010000000000003000000000000003100060000660003000
000000000000000000000000006600000000000000000000000030660100000000000030000660000060001000000000000010150600000000000000060060000000000000000000010000000000000060001130
000000000033333300000000006600000000000000000333300000630000000000000000000660000000000000003000000000000000300000000000000010300000033000600003333000000000000160000000
000000000033300000000000006600000000100000000323000000000020300004001000000600000000000000000000000000000300001000411100000000000000000000000003330000000000000061000000
330333333000000000000003333333333300000000330000000003330000010000001000033300000000000050000000003303303003000000000000000000000000000003003006000030000000331330000000
