000000000000000000000000000000000000000000000000000000000000000000000000000000005000000000000000000001000000000300003000000300000000000000000000000000000300000000000000
000400000000000000000000000001000000000000000000000000000000000500000030500000000000000000000340000001000000005000000000000000000000000000300104006000000000000000000000
000000000000000000000000000000000000000000000000000500010006000000000000000000000000000000000000030000000000000040000000000000300000060000000000030000000000000000003000
000000000000000000000000000000000001100000000000000000000000001040031500230000000000000000000000000000010000000000000000000000000000000000000000000000000000000000000150
000000000000000000000000000000001000000003110000000000000000000000000006603000000000000000000000000300000000000000000000003000000101000000000010000000300000000000000000
000000000000000000000000000000001000022220200000200000000000020000000006600000021220000002500000002000000002122000222200000000200000000000000000000000000300222200003020
000000000000000000000000000000003000313413030333300000003303333000100033330033333033300323300010201333133133003300333333300033330333300000000300300000010033033313333333
000000000000000000000000000000000000000000000000000000000000000100000300600000300010000000000000000000000000000000000300000000000000000000000000000000000000000000000000
000000000000000000000000000000000030000000000000030000000000030500000000000030000000000000000000000000000003000000000004100000001000000000000100000000000000000000000000
000000000000000000000000000010000000000000600000000600000003001000000010000000000000000000000000100000000000000000000001002000100000000000000000000000000000000000000000
002000000000000000000000000010200000000000000300000005000000000000300000000000000000000000000030000000300002000000200060001000000300030000001000000000100000200100001000
066000000000000000000000000006610000500000000000000000000000000000000000000000000000000000000000000000001000100006600000000000000000000300000000000000000006000000000000
066000020000020000020002222006600100000000000002000000000003000000000000000020000000000000000000000000000063000003000000000000001300030000000000000200000006600000000000
333300333333333333333333333303300030000000330330000000000000000000000003000300000000000000000000000000000003300003330030000000000013000000020000600033300333333003500000
