000000000000000000000000000030000030000300000003000100000000000100000001000000001000000000000000000000000000000000000000000000000000040000000000020300000300000000000000
000000000000000000000000000000000060000001000000000000000000000000000000000000003001000000000000000000000001000003030100000000500001000003000050000030000000000000000004
000000000000000000000000000000000000000000000000000400000006000000000000006000000000000000000010000000000000300030000000000001000300000000000000000000000000000000000100
000000000000000000000000000000602000000000000000600016300000000300660000000040000000000000000000020000000000000000000000000220000000000000000000400000000001002000000000
000000000000000000000000000000000000000000000000000060000000020000000000000000000000000660100000000000100000000000001000000000000000030000000000000000000000000000000000
000000000000000000000000000023020000000000000000002366000010000001660000000005000000020061003000000000000200200000000003002500001003000000060000000000300020020000000000
000000000000000000000000000030300300000000000000030303300000000303630030333331000000003333060000000000000133330200000003303031003333000000000000030000000030313300000060
000000000000000000000000000000030000000000000000005000000000000000000000000000000000000000000000000000000000000003050010030010000000030000000000000000000010000000003000
000000000000000000000020000002000000603000015000000000000000000020000000004010040000100000000000000100000020001000000000000000014000000010000210000000030030013000000000
000000000000000000000660000006000000000000000000000000000000000660000000043300000000000100000000000000000660000000000100000310000001004001006600100000000000000000000100
000020000000000006600660000006000020000000000000000000000050000630000001002000050000000100000000000000000660000560000000006000000050066000003600000000000000000000006600
000000000000000006600660000063000300000000000040000000010030500600000000000000000001060000500000000003000000000000000040006000000060066000000600000000000003000030006000
200200000000000206600660000065000001000000000023000031000000000030000000020000000000300000000000000030000600000030000000206333000000066000306600000000000000000000000600
333333000333333333330333333303330100003030000000000000000000010330333333333000001000003333003000000300000333333300003003130330000000030033333303330001000000033303330333
