000000000000000000000000000000013000000000000000000000010001000000000000000050030000000000000000000040000100000000000001000000000000000010100000003000000000000000000060
000000000000000000000000000000000060000000600000000000000000000300000000100001000300010000000000030000000000000000000000000000000000100040100110000000000000060600000000
000000000000000000000000000030303031000000000000011100000005200000000000000000610100660000000020000030000030000000000000000000001110000400001000200100000001511000300000
000000000000000000000000000000000000000011000000000000000006000000000000000000000000660000200000000000000000410000000000000005000000000000000006601000000003000000003000
000000000000000000000000000000060000000000100000000000000006000000300000000000100000064000000000000000000000000000100000000000004010000000000006600000000000000000301000
000000000000000000000000000000050000000000010004000000220460000000000050000000000032660000003000000000000000000000000000000000000005230000002006100000000000000220030000
000000000000000000000000000000030000000000000000033013333033300000000001033313333303303000000000000000000000050000010000030303033330100000000303030000000033333300000000
000000000000000000000000000000003100000001000000000000030000000000000000050010000000000000000000000000000000000000000000000000000600000000000000000000000000000000000000
000000000000000200000000000000000000000000020000000000000000000000000000000000200600000000000000006000000000000000010000600000004000060000000210030000000000010000010000
011110000002006600000000000000002000000000600310000002003000000000000000000006600000000000000002000030000011100000000001300000000000000002006110000000000000030000000000
000000000066006600002000000000000001000000660000201016000000001000000000000006600002000000000066200000000000000100000006600002000000000066006000102000000000000000000003
000000000066006600000000000000000000006000260000000066040000000000000100000006000000000000000006000000000000000000010006600000000000000060006600000030000000000000000000
000002220066006600000000000000000000500000000000020010000000000100000300000006600000000000000066000000000000002000000046010000000000020006010600033000000000000000000100
333333333333303333330003333300000001013433300333033630310000000000000000000003333330000000030330300033303033301300000000303330000000033003303033335000000000000000033331
