000000000000000000000000000000030030000000000000060000040000000100000000000000000000000000000000300000010130000000030000000000000001000000000600000006000001000000000010
000000000000000000000000000000000000000000000000000000000000060000030000000000000000000000000010000000000000004000020000000000000000000000003010000033005000000000060000
000000000000000000000000000000005011116110000000000000000000000000000002000030000000000000000000000000000000000000000010000000000000000000000000000000000000000020000000
000000000000000000000000000001000001100101000001010000001000030000000000020000000000100006000000001000000400100000000000000100000000000010000030000000000110020660000020
000000030000000100000000000000000001300111300010000000000000000003000001000100000000100606600000003001000010000000000310000000000000001000300100100000000010600603000000
002000000000011111111110000003111001000100000000010000001160000000000031110010010000006606600200000500001110111100000000020000110000011110110110101000000000600060000050
066000001000000000000000000033333333333300010000100000000000000333330300000000000000003333306600000100000130100053333330660000010000100000060000000333303333333330100000
066000000000000000000000000030001010060400100000000000030000000036000000000000600030000000000600503000000000400000000003000300010000000000200000000000000100000500000000
033305000000000000000000000001000000300050000000000000000000000030305000001000000000000000003030503400000000010000000000330000000000000000001000000000000000000000000000
000000000000011111110000000200000020003000100100100000000000000000000011011003000000000010100000000000040111111000000000000010111011000000021011100000000000000000000001
000000000000001100111100206600020140003000013300000000001002066000000011021010110100000050000002000000000110011000000304000010110011610020601000111000000000000000500000
000000000000001100111106606601600660000000000000001000001066066000000011001110030000003000000000000000000010011000000030000000110011110163060000111000000000000000000003
000000000000001100110006606600600600000000000030000111110060066000000111000103000000000000000000003000000110011000000010000006010010050600661100111002000011000000000300
333333333333333333333333333331033333333313066500000000003133303330133330333030010003330303331333330000000300303301000003333333333303333333033303333006000000000003333313
