000000000000000000000000000000000000000000000000000003000000000000000000000000000000000500000000000000030000000000300000030000001000100000500400000100003000000030000000
000066000000000000000000000000000000000660043300000000000000300000000000000000000330000066000000003003000000000105000000001000010000050106300000030000000000006600330000
000063000000000005500000000000050000000630001000003000000000600303000001050000000000000000000000000010000000010000000000000000000000000006300030000000000000006500000000
000066000000000000000000000000000200000660000000000300100000600000000000000002000020000066300000000000010000000000000000001000000000000006600000000000000000000000100000
000066000000000000000000000000010000000660000000000330000000660030000000050000033000000060010000050000003050000001000000000030003000000001600000000003300000006000000000
333333330000030000000000000000332003233135000000033304003303333003000000000303003000334333300000000010300300000100010003000013330030030300333500003303330033033300000000
000000000000000000000000000000000000000000000000000000000000000000000000005000000100000000000000000000000000000000000500000000000000000000000000000000200030000000000000
000000000000000000000000000000000000100000000000000000000000300000000000001000000000000000000000000000000000003000000000000000300000000001000000001000010000000000003000
000000000000003333000000000000000000010000000000000000000000000300000033330000000000000000001000001000000003000000000003333000000000000000000000000000000003030002000000
333000000000000000000000006600000663330000000000000000000000000000000001000000000006000006603005300000300000050000055000000000000006633300003330000000550000030000000004
000000000000000000000000006600000600300000000000000500001000000000000000000000000006000000000000000000000033001000000030000000000006600000000000000000000000000000000166
000000000330000000000000336603003600000000006000000000000000060000030000000000003306011336000000000030000000000000000000000000000303600010000000000003000000000000023366
000000033333000000000003336600333660300000300000300000003003003000000000000000033366003336600000003333300000000000000030100000003331000000000000000000000000000010030160
000000000000000000000333333333333030060000000300000000030030000000001000000003303303333033300000000000000000000000000000000000033330300000000000000060001000000003000333
