300300000003000000000000000300030000000500000010000200000000063000000000000000000000000000000000000000000030000000030000000000350000000000000000000000000000030100000000
000000000000000000000000000000300000000301000000000000000000000000000050000000000000300100000000000000000100000030010010000000003000000000000000600000300000000000000000
300000000000000000000000000003330000005000000000000000000060000400440000000000333000133300000010000003000000000030000000100000046440000340004444400000100030000000000000
000000000000000000000000000000003004000000000000000000000600000050010000000000000000001000000000000000030000000000000000000033000000000000000000000000000000100000000000
000000000000000000000000000000000030000010000000000000000000000003000000000000000003000000300000000000040000000000005000003031001000000000030000000000000000000000000000
000000044404000000000000000000000001400001000000000300001000000001000000000000000003000001344401000000006000305000000000002033000030000000030010000000000000000300000600
000000000000000000000000000000000000000000033031100000000000000033000330331330000000000300000000000000000000000000000000333310033030300000003330330003303300000000000000
000000000000000000000000000030030000000000000600301000003000000300000000000000100000000000000000600000000300300000100000000000000000000000103000000000000001000030000300
000000000000000000000000000000000001000000000000000000101000000000000000000000000000000000000000000000020000000200010000000000000003010000060003000000000000000000000000
000000044444000000000033300031030004040400000004000000000000000300003000000000003000000000000000304400400300000000000000000000316000300001000303000000000000000002000060
000000000000000000030000000000000000000030000000000000300000000000000000000300050000000003030000030001000000100000000000000000000000100010000000060000100000000360000001
000000000000000000030000003300000000000000000000000000300000000000000000000300000000400003000000000000000000000000000000000000000000030000000000033000000000003300000000
000000000000000000030000000300000003000000000000000030300000000000000000000304440400000060000000050000000000000010000004340400000000000000000000013000000003000304440000
333333333303333333330000000000000003330031100000033330300000000000300030333500000100003033033303330030030000000000000000030000333333300000010000010000000033333001000000
