000000000000000000000000000000000000000000000000000000000000000000000000000010030003000001000000030000000000000000000000000000060030000000000001033000000001000100000000
000000000000000000000000000000500000001000000003000004000003000600000210000000000105100505500000030003000100000302000000000000000000000000000001003000000010000450000000
100000000000000000000000000006021101000000000003010000000000000150030200000000000000100030000000001000000000040000021100000000050000001060000000000000000000000000000306
000000000000000000000000000003630001010010000000300300000003000000000000300000000300100000001000300000000000400000060000000030003010000000000300100000000000000361000040
000000000000000000000000000000000000010000000000000000000000040000000000000500030300000000000313330500000000030003000000000000400000000003000033033010000000000000000000
000000000000000000000010000000000110100001000000000000000100000000003000000000010000600000000000300000000050050000000000000000000000000000000000000000000000033000000000
000000000000000000000000000000333330030500333333300000000000003000000003333033030333333343330303130000000303303003333300000000000000033333303153331000000033333331330333
000001000000000000000000000306300100000400300000100000030000010000006000000000000000000000000000000001000000000000000000000003000000000000000000000000006000000300000000
100505500000000000000000000300050550000060000000000250001005055001000000000000300000050000000000000000000000000000000000000003000000010000500000000000000000000000000003
100000000000000002110000000033000000000000600001000000001000000000211006010001000000000000000000000000000000011000000000000000000000000003000002000000000000021101300000
100000000000000066000000030000010000000000000000000003001001000006600000030000000001300030000000010001000006600000000000000300000000000000100006000000000003660000000000
000000000000000000000003333300000300100000000000000051030100000000000030000100000000000010060003000000000000000100050000033303006000010000000000000000000000000000000000
600000000000000000000000000000010000000001013100000000000100000000000000000000000000010000003000000000600040000050100000000000000300000000000000000010000000000000000000
333333333333333333333333333333333300003000000001030033333333333033333300000006000000100001000301000000000313033000000003333033000100030030330100000000000533330030000000
