000000000000000000000000000000000000000000000300000000000010600000002000000000000000005300006004000030000000000000000040001000000300000000600030000000000000000000003000
000000000000000000000000000030000000000001000300000000000000001000300000000000000002000300000000600000000000000000300000010001000300000000000030000000000000000000000002
000000000000000000000000000000000000000066000330410000000000000000300011011000000060000000000000000500066000000000000000030000000300300001303000000000000000000000003066
000000000000000000000000000006000000060016033000000030000000000033300000000000000006033300000500000000061000000000030000000000033330000000000003000000000000000000000066
000000000000000000000000000003010000000066403000000000000010000033300300000000000060033300010000000005066000003000100000000000033300000000000005010000000000000003000066
000000000000000000000000111113000400000066003300000011000011111033300006000000100006033300000013110000066030000001002200001000003330000000000000003000000100002200210066
000000000000000000000000000031030333330333333003000000010000000503333533330330335303003333003000003033300000000013333330000000330001300000000000000000000033303333333303
000300000000000000000000000000000100002000000010000000000000000000010000010000000000000000000003000000000000000000000000000000000301000001003000200050300000000003000000
000300000000020000000000000000100000000010000000000000000000000000000000000000000010060101000000000200030000000000000010000000000000000000000000000001300000000000000000
000300000000660000000111110011111004000000000000000000000000000050000000000000000000000000000000001113000000000030000660100000000000010101000001030030300001101000000000
033300000000660000000000000000001000000000000000001000000300000000000001000000103000002000000000000000000000000005010010000030000000000000000000000033300000000400000000
033300000000660000000000000000000600000000110000000000000030000000020000000000020000000000000000000000000000100000000660000003000000000000000000001003300000000300010003
033300000000660000220000000000000000000300030030020000000000220050000000000000001000000000000002000000000000000010000600000000000000000000000000303033300010001000000000
333333333333333333333333333333330630000000000000000000003313033000033000000000000000000010000003330333333000000003330310000010000000033033330000000033330333333330000100
