000000000000000000000000000000000000000000000000000000000000005300050000000000000000000000000000000000000000010003000000003000000030000000000000000010000000000000000000
000000000000000000000000000000000003000030000000000000000000000000000000300000000105000000000000000000000000000000001000000000000000000000300000000000000000000000000000
000000000000000000000000000000000000010000000000000400400444040000000000000000000000010000400100000300000000600010000000030000100000004441440000000000001400003200000000
000000000000000000000000000000000000000000000300000000000002000030000000030000000000000000000000000000000000000001000000000000000003010001000000010000000300000000000000
000000000000000000000550000005000000300000001000000000000000000550000100000000000000000000000000000010000000000000000000000000600000000000000000000000100000000000000000
010000011111000000000000000000000000000003000000000000000000000300000000000000100000220000000000001111100020000001000000250500111110050000000103000020003000000000030000
000000000000000000000000000000000000010500001000033003305301330003000000000000000000103310300000100000000033003000003000333333000000033013310000010003303330000010000000
000000000000000000000000000000600000000000000000000000000000103003000000010000000003000310000000030000000030000000000000000006000000010000300600000000000000003010000003
000000000000000000000000000000000000000001000040006000000000001000000000000000000000100000000000000000000300000006000100000000000000000000000000000400000000000000000000
000000404444400000000000000001000000000000000000400000000000001005010000000000000004000003000000000404440000000000000000010000004000000300050400440000000400006000000000
000000000000000000000000000000000000000000000000000000000000000000000001000000000010000000000000000011150000000000000000000000000000000000000003000000000000101000000000
000000000000000000000000000000000030000000005000000000000001040300100030000000061000050000100000000000000000000000000005500004000000000000010000000000000000000003400000
220000000000000000000020000032000300000000200000001111003200000000000011111002200000010003000000500100000011001000000000000000000000030001000600000320000013031000000000
333333333003333333333033333303323303333000333333000000000330330033303300000303330333000000000033330300300010000000000000000000301133033033333300333333333300000000000000
