000000000000000000000000000050000000000001000000000000160000000033000030000000000000000030000000000000010000000000000000000000000000000000000000000000000000000020001000
000400000000000000000000000000000003000100000000000000000000000000000106000000000000000000000000000000000000000000000000000000000000000000000000000000000000100000000000
000000000000000000000000000000000000050000001000060000000000000000010000000000000000000000000010001000000000000003060000000003000000001000000000000000000000000000000000
000000000000000000000000000000003003000000000000000000000000600000000000200000000001000000000003000100000000000000000000000000020000000000000000000000000000000000000000
000000000000005500000000000300100000000003000000100000000030000050050006000000000000030000000000030300300006000000000000000100000000000000000000000000000000000000000000
000000000000000000000000000030000000000003000030000000110000010000000000000000020000000000000000000000000003000000000000102201002000000000000000000000000000200000000000
000000000000000000000000000033333330000006333330350000011000101000000033330333330333000000001000000001000013033003133303363330303001033033303333303000000035333333333333
000000000000000000000000000000000000000000000000000000000003000000000000000000100000000000000010000000000000000000000030060000600000000040000000020030000000030050000000
000000000000000000000000000000000000000000020000000000300000000000400000000000000000000000000000001000000000000000000000000000000330003000000004000000060000000000000010
000000000000000000000000000300000000000000000000000000030000000000000000000000000003000000000000100000003000000040000000000000000000000000000003000005000000000030000000
000000000000000000000000000000000010000310030020000050000004040000000000000000000003000003000000000000000106010000000000001000001000000000000010000000000000010000000000
000000000000000000000000000005000000100050000000000000000000003000000000000000000100000000000000000000000010000000303605500000000000000000030000000550000000000000400600
000000000000000020000000220000000010050000000000000062000000010000000000000000002200000000000000100002060000000000030000000010000000000000504000000300000000001000000400
333333333333333333333333333300003000000200330303303333330030000000000003333330333313343333033033003033030000000000000000000001000000000030000010000030000030330134000000
