000000000000000000300000000000003000050000000013000530000000000000000010033060000001001000000035500000300000000000000000000301000000300000000000000050000100000000000000
000000000000300033300000000000033000000100000000000000000000030000030000000000000000000000000000100033300000000000000000033300000000000000001000000000000000000100000000
000000000000000000000000000000000010000000001000000000100000000000001000000000000000000000000003030000030000030000000000060000001000000000000001000000000000000030000000
000000000000000000000000000000000000000100000300000000000010000010100000000000000000000005000000000006002000000000010000000000000000103000400000030300000000000000000000
000000000000000000000000000000001000000000000000000000000000000010000000000000000001100000000000300000000000000300000000003000000000000000000000000000000001000000000000
000000000000000000333334000000003330000000311000000300000005000301000000000330600000100000001003000000333000000000000000000333034000000000000000000200030000000000200000
000000000000000000000000000000000003003300331030300000000100000333330300000000303300330300330000000000000100000030333000000000000000030000000310300000000300000600303000
000000000000000000000000000000100000003000030100000000300000000000000000001000000000000010000000003001000000410000000000000000100000000000000006000010000000000000000000
000000000000000000000000000000000000000000000000000000000000000000000000003000003000400000000000000000030000000001000000000001000000000000010000000033330000001050000000
000000000003030000000000000000000100000000000000300000000000000000010000006000300300000000100100000200000000000000000000400300000000000000000000000000000000000000000000
000000000000000000000000000001010030305000000000030000003003100000000001000000000030100000000000000000300000000000050001000000000000040000000000000000000000000000000000
000000000000000000000000000000000000000100000010000000000000000000000000000000000000000000000000106100000030000001000000500000000000000000000000000000000000000100000001
311100000000000000000000000040000000000000000051033400000000000334000000000000000000000000031110000000000332000000000003111000000000000000000010000000033303000003611000
333333330000033333300033330000000000003300000003300000000303305000005000000003000003030130030333330060000200000000005000303303333300000000000000000000000000000000330333
