000000000000000000000000000030001000000000000000000030000000000000004000000000000300000000010000000000000000000000000006000000000000000000000100000100000030000000100000
000000000000000000000000000000001130000000000000010555010000001000000100000001000000000000000000000000011000010000001546000030000000055550335555500000000000000000000011
000000000000300000301111111100001111000000111111111101503111113000000000600000000000300000030011000000030000001100001000000000100000010110101160100000001300013310000000
100000000000000000101111111100001001000503101110100000300111106000000010001000000000600130011111110053101003101100000000000000000040000000010000000000000000062010001000
100000000000000000101111111110000001003000111115100000001111111000000000001000000000110030011110110000000000000200000000030000000000000000010000000000000060001030000030
000000000000011000111111100100000002000000111000100000001011301000100000205060000001000000011100111000030000000000000000000000000000100301000000000000000100011110000000
000000000000000000010000000030000030001000300010033003533300000333333330000000000000000000000100000000000330133330000033303033000100030333335300333000000000000100033333
000000000000000000100000000000000000000000300000000000000000000010000000000001000000000000000001000000000000030000000000010150000000000300000000000000001000000000000000
000001100000000000154555550100601300000011000000000000000030154000010055155010000000000000000000540000011505550100000000000000001001100000000000000000015400000000000030
000000000000110000111111111000010110006000000013010003010000111000130111110110030011000030100001010000000111111000300301111111000000000010010000001000410100000001011101
000000000000000000000000000000000000000000010000000000010000000010010100000000000000005010101000000000300000000010000001111011000100000001010000000000003010030001111110
000000000000020000000000000000000000000010010000000030000000000000010100030000000005010000100000000000000000000010100001111011000010000001010030305000000010000001110150
000000000000000000000000000000010000000001000000110000110000300100001000000000000000100011600000000000000000000000000000111051400000010000110000000000400000000001011000
333333333033333000033333333333033330333303040300000000103000033030000033030033500303000001030001335333301333033000000000000000033333300000103303033630000300000000104000
