000000000000000000000000000000000000000000000003300000000000000000000010010000000005000000000000000000000000000000001000000003000000000000000000000000001010000000005000
000000000000000000000000000005110000000000000000000000300000000000003100003000030000000000005100000000000050000003001000005000000000000000001000000151000000000000030000
000000000000000000000000000000000000000003000000301010140001000110100001100140000000000000000000001111100000300000000000000000000000000000000001000000000006100100003000
000000000000000000000000000000000000000010000030000000000000000000010000000003000000000060000330000000000000000000033000000000006000000000000000000000000000000000000001
000000000000000000000000000000000000000000000003000000000000000000000000000000000060000000006000000000300000000000001000003000000000000000003000000005000000000010000000
111004414100000000000000000000000001010044000000020000000000000005100020000004000000031000000000000000000000010000000000000000500000001100440303000000000020000000410000
000000000000000000000000000001330030000000000000033331330000000333303303303330000000330010003533036333333000000000050003033050000000103000000000000033361033333330000010
000000000000000000000000000010000000000000000012000300000000000000000000030001000030010000000000000003000000000000001000000000000000000000000000000000000001000000000004
000000000000000000005551000000000000003000001000000000003000000551000050003000000005000000500000000000000010001000000050000000001010055100000000000000000000000010000000
011001411111000200000000000002001000000000011110000000000000000000000000050000000000020000000000000011014000100032000000111001001500000000001111100000000002000000000000
000000000000006600000000000066101400000001000000030000500000000000000000000010600000060000000300000000000000000066000000000000000000000000000000000003000030000000100000
000000000000006600000000000006000000100000000000000000000000000000000000000006600003600030000000000100000000000066000000000000000000001000030000000000000060000000000000
200000000000006600000000000016000000000040000300004130011110044000000004100006600000060000000000002000000110000066003000000000141000500000000000000115504463000000000000
333333333333333333300033333303303000000003333333300000000000000033601300000003003300330331000000003333303000000033003003333033000010003303333303336000000003003100000000
