000000000000000000000000000000000300100000000000000000002003000000000000400000000000000000300000000000000000000000000000010000000000000000003000000000000000000000000010
000000000000000000000000000000000060050300000000000000000000000000003000100106550000000000000000000000000055020135500000000000600000100000000000010000000000000000000050
000000000000000000000000000000006000000000000000000020001000000000000000000000010000000030000001000000000001010000000100002000000000050000000030000000000000000000002000
000000000000000000000000000000000000000000000000000100000000060000020030100000000000000000000000000000000000000000000000066000100000000000000000000000000000000000106300
000000000000000000000000000000000000000003000000000600300600000000000000000030000000000000000000000000000000000000010000066000000300000000001000000000000000000000066000
000001100000000000000000000000000110000000011300000600000000030000000000000000000000000000600000000000010000000000060130061000000000000000001005100000000000022030064000
000000000000000000000000005000000003033313000305033333300000000000000000033300333333313333300000000000050331333033333333333333000000000030010000600003000033333330333030
000000000000000000000000000000000000000001000000003000001000000100000000000000000000000000000000003000000005030000000001000000000000000000000000001000000000300000100000
000000000000000550000000000006300000050400000000000000000000000000000005000000000000000000000200000103030000000000000000000000000330000000000000000030000000100000550000
000000000020000010000000000000000300010000300000100000000000000000200000005300000000000000000000000000100000000000000000000000000000000000030000000000000000000000011030
000000000660000000000000000000000000010003000000000000000030010006600000000000001050006603000000001000000000000000300000300000010000000000000000100030003000100000000000
000000000660000000000000000300000060060000000001000000010000000006000000000000000000000000000003000000000000000010000010000000000000000003000000000000000000000030000000
000220200660000000000000000600022000000030000000000000000000000006600000000000002200306610000122000000011000000000000000000011000200200000000005011000000006000060000000
333333333333333333333333333303333033333333000000000000000000000333033300000003333303333033013033300000000000016000333300100000030033000000500300000000000030333331333033
