000000000000000000000000000000000100000000000000000005000000000000050000000000000000000000000005500000502001010000000000005000000000000000000100000000055000000000000000
000000000000000000000000000000000005300000000000500001000000000000003000000000000000500000003002300000005000000000000000000030000000000000050000000000003002000000000003
000000000000000000000000000000000000000000000000000111100001003001111000000000000031000003000101100000000000500200000100000000000000000000000500300000101000000000003000
000000000000000000000000000000000000000000000030000000000333100000000000000000030000030000000000003000000000000000000005000000000600000000000000000000005000010000063000
000000000000000000000000000000000000000000000000000000000000000000140000000302000000003000000000000000000000000000000000000501001300000000000000000000000006300000000100
000000111111100000000000000000000002202000001000000600000000030000300000000000000000220020000300000000000000000111111500000000000000101000001111010000000000300300000000
000000000000000000000000000030000000003353303333303303333330303303333303000000000100003330330333333303333000000000501000000000000000033130030030000333303300400003033333
000000000005500000000000000000000000003000000000000000000000000000000000000000000000100000000000000000000000000000000000000003000000000005000003000010000000000000003000
000000000000000000005500000000000000000000000000000000000000005000000000000600000000000000000015000000300000000050000030030000000300000000000000000000000050000000000005
000000000111100000000000000000030000000030005000000000000000100000010000000000000000000000000000000003000000001000000003000300000000000001100000000030300000000000000000
033300000000000000000000000033030001003000002000010000000005000000000000000000000001100000000000000000010003300000000030000000030300000000000000003003000030000000000000
000000000000000000000000000000000000000000000000000000000000000000003000000000005000000000000000000000000000000000000000300000000000000006000000100000000000000000000500
000000000000000000000220220000001001100110000300003000010010300110220000000311044110300000000000101011110000000020023001000000000000000003000000000000100122022000000000
333333333333333333333333333303333330600000000000000000003003003003003300001000101000300001000000000000000333033333330330000000333333003333330000001000300033333010030003
