000000000000000000000000000000000000000000000000000000000000000000000001000000011000000000000001000000000000000003000000006001000000000000000000000000300000000000000003
000000000000000000000000000000000003000000000000000000010000006000000000000000010000000000000000000000000000000000000100000000000023000000000000100000000000000000000000
000000000000000000000000000000000000000000000010000000000000000000000000010000000000000000000000000000000000000000030000000300000000014400010000000000000110000000005000
000000000000000000000000000000020300000000020000000000000003000000200300106030200010000000000000000000005000003000020000000001000000000000000000000031000000000000000000
000000000000000000000000000000160000000000000000000000033000000006000300010000000000030000000000000066000000000001660000000000000000000000003000000001000000000000066000
111111111111100000000000000000661000000000000030000000000000000006600233111100002000003000061113100000005000100000660000000000111110000120021111310000101004010000060000
000000000000000000000000000000303330000000003300003333031000000033300000000003313330000000000000000032336000000003310310000000000000031313300000003060000000000000333333
000000000000000000000000000000000000000000000000000000000600000000100000300000000000000350000000000000000000000000000000100000000000000000000000000030001000000000000000
000000000000000000000000000000000200000000100000000000000000000300000000000000001000000000100010000000200000000000000000000000000000000030100001000000000050000002001000
044000100000000000000000000004000013000000103000000000000000400000000000000000440000000030004400000000000000000010200000000000000000000000000000000044100100000010000000
000000000000000200000000200000000000000000000003000000000000000000000000000000000000000000000000000200000000000000510000000000300000002000000200000100040000000000100300
000000000000000000000006600000030000000000000000000000000000000000000000000000030000300000000000000000000000000000000010000000000000000033000000000000000000000000000000
000202200000000002000006600201020221001100010000011101010010000011100000000000000022110001103020210002300000000010111110000000000000000010000002100040202300000000000000
333333003333333333330033333333303310000000000000000001003000000000000003333333303330000000013300303330330000330300000000033330000000033330003303330333331300100000033333
