000000000000000000000000000000000110005000600000000000000000000000000000000000030000000001000000000005000000000000023000000000000100000000130000000000020001000000100010
000000000000000000000000000000055000000000030000000000031000003000000000000000000000003550000000006000010000000000000100000000000000000055200000003000030100000000005500
000000000000000000000000000020014111100000000000000000000000000000600000000001100000201140101000031000000005304000001000000000000000020604010000000000100000000000000401
000000000000000000000000000000030000040100000000000000000003000306000300000000030200600000000060000000000300000000000030000002000000000000100000000000000000000000000000
000000000000000000000000000060000000000010000600000030000000003006000060000030010000000000000000000000006000100000000010000000101000060001000000000000000000000006000000
000000000000000000000000000000000000000000032000000031000000000006600000130000000000600000000000000000000000030000000000000000000000160000000000000000001020000006000000
000000000000000000000000000033333333030333000000000000003333000033000001000103333333303033300000003633303000000040100000000000000000035030330050000000001010300003033233
000001000050000000000000000000000000000400000000000010000000000000300000000000000010003000000000001000003000000000000100000000000000000050000003000030000000000000000000
000550000000000000000000000300030100000000060000000000030000000000000100000000105000000000030000000000000000000000000000000003004000000010100500003030000300000000000000
200141111000000066000000000000000000000000006000100000000000000000000000001002001411000000000000000066000000000000000000000000006600100000010000000000000005060030050000
600000000000000066000000000000000000000000001600000000000000100001000000000006000300003000000300006066000000600000000003000000006601000000001010600000000000660030001000
600000000000000066000000000300000000030000006600000000030300030005000010000000000000000000000000000066000000000300000000000030006600000001000000000000000300660000000000
600000000000000066000000000000000005000000006600010000000000300000000000006000060000000000001000000066000010000000000005000000006000000000000010000000000300660000305000
333333333333333333333333330046000000000000333033333133000000000000000306000003030333000000001200000303333133030000000003301300333333333330333333330013330033330330000000
