003000000000300000000000000000000000000030003000300000300000000000003000000000003000000000000000040000000000003000300000000000300000000300000001030033001000000200000000
000000000000000000000000000040000000000000000000000000010001000000000000000000000000000000400000000003000010000000050000000000000000000000003003000000060000000000000000
000000000000000000000000000003010000000000000000000000000000003000000003000003333003300000000000003333003000000000000000000000033300303000010000030333000300000100400000
000000000000000000000000000003000000000000000000001000010000000000030030000001000000000000000000000000000000000040040013000031000010033000000000000000000000000000000035
000000000000000000000000000003000000005000003001000000000000000000600001000000000000000000000000001000000000000000030000000000000000000001010100000000000010000000000000
014444003000000000000111110003000000300600513044003000100000030030000003000100000000111100030000000000000000000001464400001100000000000000000000000000000001440400000000
000000000000000000000000000000333033000000000000000000003000000000000001333333003333000000030030003033333110000000000000000600333333000303335000000003000300001003000330
000000000000000000000000000000000003000000000000000000200000000003000000000300300000060000000000000030000000000000000000000000000000300000300000010100000000030000500000
000000000000000000000000000000000000000000000000000000000000000000000000000000000000003000000010000000000000000000003000100050000000000000000001000001000000000000000000
333300300000000300000000000010400000000000333300300000000000000000006006000000000000000000303001000006000000000000100010030000000500010000000300000000000000501000000000
000000000000003300000000000000000000000000000000000000003100000000010000000000000100000000033000000000000000000000000000005000000300000500003300000000001000003000000000
000000000000000300000000000000000000010000000000001000000000000000000061001000000050001000003010000000000000003000000003000000000000000000000000000000000000000010001300
000000000000000300000000000000000000010050100000001101600000000014144000111000001000300010000003001100000000000000000000000000010002003000000300000000000011100000000000
333333330000000333333300033330003300000300333333300000000000000010000000000006000330003000000130330001000000033330000103006330000300000000000333333300000001000000000000
