000000000000000000000000000003010000004000000000050630000000050010000000020040000000000001052000101000603000000000000100004010010000000000000000000000000000001000003000
000000000000000000000000000001550000030000001000100000000000000000000000000003000000100000060000000000000015600000130000000000000000000000000010000005000000000000010000
000000000000000000000000000000000000000000000000300000000000000000000000000000000003000000000000000000003000000100000000000000040000000010000003000000000000000000000000
000000000000000000000000000000100000000000004010000000000001500000000000301000060000000000000000050000003000000000000100000003000000000000000000000000001010001000330040
000000000000000000000000000010000000000000000000000003353030000000300000000000000033000000000000000000000000000001000000000032000003000060000030000000000000000000030000
000000000000000000000000000003000000000000000000000033330000000000010000001000003633000000000000000003333000000000000000003033450002000000000000030000000000000000000000
000000000000000000000000000030033300000000300003003033050000000000000033100330333333050110000000003010303101333300000003333133003333300000000000000000000000000003333030
003300000000000000000000000000000000000000000000000030000020000000000000000000000000000000000000000033000300100000000000100000000030000030000000050000000000000300000000
000000000000000155000000000000000000000000000000000100000030000000000011550000000000000202001000010000000000000000300000000000015500000000600010000000000000100000155000
000000000000000000000000000303000300300000300000000000300000000050000000000000000100000000000030000000000000000000000000000000000000000000000000300010000300000010000000
033304000000000000000000000300000000360000000000000330100000000033304000000010000000000000000000010033040010000003000000000000000000000330400000000100000000001000000000
003000000000000000000000033301000000000100000000000300000000000003000000000000000005000000000000003030000000000000003000000000000000000300000000000500000300300030000000
000000000000200000000000333300001000000120000000000000000000000000000400000000000000000000100000000000000000000000000010000000300030000000000000000000133000000001000001
333333333333333003333333333300000003103333000000003333330000000333033330033330000000333300300000003300303000000000000000000000300333333333303333333033333010000003003330
