000000000000000000000000000000000000000000000001000000000100000300000000000000000000001000000000000000000000000000000000000000001000300003000000000000000000000000000000
000000000000000000000000000000000000015500000000000000000000000001000000006000102000000010030001001002000000100030000000000000000000000000000005510000000000000000000000
000000000000000000000000001000000000001411100001000000000101411000000041000000006000000000000000000060100410000140000000006002000030000000000001010000000000000000000010
000000000000000000000000000000000003020000000000000000003000000000000000000000006000000000000000000066003000000000000000066000000000000000003000000000100000000000000000
000000000000000000000000000000000000100000000010000000000000000000400000000000030000000000000000360066000000010000000000066000000000000000000040100000000003000000001000
000000400000001000000000000000000000050000010000000000000000000000005000000000006000100000000000003060300000000000000000006031300000411000000000000000000000030040000000
000000000000000000000000000000000003333333000000000000003330030030300033033303330303000000000000003033303333330303333033333003503000033000003030333000000100000600000000
000000000000000000000000000000000000100000000000000000000010000000000000000000000030000000030030000000000000000000000000000332000000000000300000000000000000000000000000
000550000000000002000000000000000000000000000000000020000000000300000000000000000001000030300050000000005000300000000000002000000000000040000000000000200000000000030050
000141141000000066000006600046000000000000103603000660000000010000000600000000006000000003000114110066300000000000000000060500000000000000110000000006000000000000104000
300000000000000066000006600000000000000000006600030360000000000000000000000000060000100000030000000066000000300000000000066000000000033000030006000006610030000100000000
000000000000000066000006600000000000000000006600000660000000003030000100000000063000000000000600000066000000000000000000060010000000000000000000000006050000000000000000
000000000000000066000006600000000000100000000600000660000000000100000000000003066000000150000000400061010000000400000100066000000000000000000060000006600013100000000030
333333333333333333333333333333003330000000333303013033000000000000000000000603133333000000033330033333330000000000000003363033000000030133333303333333013300000003303333
