000000000000000000000000000000000000000000000000006030000000000400500000300000000000000000000000000000000000000000000000000000000000000006000000000100300000000000200000
000000000000000000000000000000000000000000000000000000000030000000000000010000000000600000000030000000000000100000000300000000000000300001004300600000001000001000000000
000000000000000000000000000000000000000000000010000000000000000300000000000000000300000000000000000000000000000100000000000000000003300000000000000300000000001003000003
000000000000000000000000000003000000000000030000000000000000000010000000000003000000000000000000000000000000000000000000000000000033310000000000300003000060000000000000
000000000000000000000000000000000000000050000000060000003000600000000000400000000000000000000000001000000000003000031010000000003000000000000000000000000000000000000000
000000000000000000000000000000000000000010000003000000100000300000100000320100000000000000013000000000000000000000220006000000010303000000000200000000200000000000000000
000333300000000000000000000000000000300000000330330000330000001000333130333330040000000000000000010000033300300133330331000030530303000000000000000330333300010003033300
000000000000000000000000000000000003601000000000000000000000000000000000000000000300000005006003000000000000000000000000001000000010000000300000300000000100000000000000
000000000000100000033000000000000330000100000601000000000400000000000040300310000000000003000000000000030000001040000000001000000000000000000060060000000005010330050000
000000000000000000033000000000000330000000000000000030000000000000000000000330000000000000306000100011000000000000100000000000000000005000001000000000000000000000100000
000000000000000000333000000000003100000000000000000000000000000000010000003330000031000033360000000000030000000000000000000000000000001000000000000050030000003330000000
000000000000000033333000000000333330000000000000030000010000000000000000030330000100003333300000000000000000000000002000000030300000000000000000000000000000033330100000
000000000020000333333000000003330330000000000200010000000000001000000303333330000000013333000000000000030003210000000000000000030030000000000000003100000003330030100030
303333033333333333333300003333033330000000333333030033006000003303333133330330000300333033000000360000000333063330333300000000000330300000003001033000003330333330000000
