000000000000000000000000000000000010000000000000000000000000000000000000060300000000010000000300000000003000000000000000001000100000030000000000000003000000000010100360
330000000000000000000000000000000000000000000000000000000000000000000030000000000000000000000000006001200010000033330000000060020000000000000000000000000000000100000200
111000000000000000000000000001004400000000000000030000000000000200000311103300000000000010060000000000000000000011000000000000000030000000000000000000000000000000050200
000000000000000000000000000000000000000000300000000000000000000000000000000000000000000000000000000000001000000000000000006100000200000000000000000000000000000000000600
000000000000000000000000000000000000000000000000000000000400000000000000060000030000000000000000000000004000000000000002006600000001000000000000003000000000000000000001
000000000000000000000000000000002000000600000000000000000000000000100000000000100001500005000000000000000000000000000000006603001100000000300000000000000050000030000600
000000000000000000000000000030333033003330000000003233300000000030130000000300000000000000300000000003330000000000000100033333030033000010000003000000000000000003333333
000000000000000000000000000000300000000000000000000000000000000300000000000011000000100000000000000000000003300000000000000000000003000000000000000000000000000000000000
000000000002000000000000000020000003300000000020100000000000000000000000002000000000000000010002003300000003000000000000000001000000000000003003000000003000030000000000
200000000002000000000000044050000031110000100020000030000000440000600000000000030000000000000002001000300300044000000300000440200000000000001010000000044120000000000000
000000000066000000000000000000000000001000000630000000000010000001000000066000000000000000300066000000000000000300030000000600000000000000000001000000000000000000000000
000000000066000000000000000000010000000000000060000000010003000030000000016000000000000030000066000000003000000000100300000000000000000000000000000000000000000000000000
000000000066000000000000020000000000000000000660000010000000210000000000066000000000000000000000001003000000023000000000000200000000000000001000000000020000003000000003
333333333333333333333333333300000000000000333303300000003133303033003330333300000000303300030003330000000333333000000003303303303130000000000000000033333033033331033303
